summary_time,moor_num,berth_num,stay_num,moor_dwt,berth_dwt,stay_dwt,total_wait_duration,total_berth_duration,total_stay_duration
2020-01-03 20:00:00+08,0,1,1,0,34162,34162,0,3.1,3.1
2020-01-04 00:00:00+08,0,1,1,0,34162,34162,0,7.1,7.1
2020-01-04 04:00:00+08,0,1,1,0,34162,34162,0,11.1,11.1
2020-01-04 08:00:00+08,0,1,1,0,34162,34162,0,15.1,15.1
2020-01-04 12:00:00+08,1,1,2,103668,34162,137830,3.24,19.1,22.34
2020-01-04 16:00:00+08,1,0,1,103668,0,103668,7.24,0,7.24
2020-01-04 20:00:00+08,1,1,2,103668,117176,220844,11.25,0.15,11.4
2020-01-05 00:00:00+08,1,1,2,103668,117176,220844,15.25,4.15,19.4
2020-01-05 04:00:00+08,1,1,2,84771,117176,201947,0.21,8.15,8.36
2020-01-05 08:00:00+08,0,4,4,0,475265,475265,21.42,16.61,38.03
2020-01-05 12:00:00+08,0,6,6,0,633391,633391,26.63,37.92,64.55
2020-01-05 16:00:00+08,0,6,6,0,633391,633391,26.63,61.92,88.55
2020-01-05 20:00:00+08,0,6,6,0,633391,633391,26.63,85.92,112.55
2020-01-06 00:00:00+08,0,7,7,0,690711,690711,26.63,110.29,136.92
2020-01-06 04:00:00+08,0,6,6,0,605940,605940,21.42,119.29,140.71
2020-01-06 08:00:00+08,0,4,4,0,413237,413237,0,60.11,60.11
2020-01-06 12:00:00+08,0,4,4,0,413237,413237,0,76.11,76.11
2020-01-06 16:00:00+08,0,3,3,0,309569,309569,0,59.92,59.92
2020-01-06 20:00:00+08,1,4,5,67717,326721,394438,0.32,72.6,72.92
2020-01-07 00:00:00+08,2,3,5,214365,269401,483766,6.38,64.22,70.6
2020-01-07 04:00:00+08,2,5,7,214365,406703,621068,14.38,81.37,95.75
2020-01-07 08:00:00+08,2,3,5,214365,238798,453163,22.37,38.23,60.6
2020-01-07 12:00:00+08,1,3,4,67717,330764,398481,16.31,44.49,60.8
2020-01-07 16:00:00+08,0,3,3,0,330764,330764,0,56.49,56.49
2020-01-07 20:00:00+08,1,2,3,50689,229268,279957,3.69,31.4,35.09
2020-01-08 00:00:00+08,0,2,2,0,229268,229268,0,39.4,39.4
2020-01-08 04:00:00+08,0,4,4,0,351070,351070,9.34,53.4,62.74
2020-01-08 08:00:00+08,0,4,4,0,271810,271810,9.34,38.03,47.37
2020-01-08 12:00:00+08,0,4,4,0,271810,271810,9.34,54.03,63.37
2020-01-08 16:00:00+08,0,4,4,0,271810,271810,9.34,70.03,79.37
2020-01-08 20:00:00+08,0,3,3,0,221121,221121,0,67.67,67.67
2020-01-09 00:00:00+08,0,3,3,0,221121,221121,0,79.67,79.67
2020-01-09 04:00:00+08,0,2,2,0,150008,150008,0,64.03,64.03
2020-01-09 08:00:00+08,1,1,2,103891,35225,139116,3.01,1.12,4.13
2020-01-09 12:00:00+08,0,1,1,0,35225,35225,0,5.12,5.12
2020-01-09 16:00:00+08,0,1,1,0,103891,103891,8.12,2.89,11.01
2020-01-09 20:00:00+08,0,2,2,0,165500,165500,8.12,7.09,15.21
2020-01-10 00:00:00+08,0,3,3,0,280896,280896,8.12,17.08,25.2
2020-01-10 04:00:00+08,0,4,4,0,353864,353864,8.12,29.41,37.53
2020-01-10 08:00:00+08,0,5,5,0,457532,457532,8.13,47.34,55.47
2020-01-10 12:00:00+08,0,4,4,0,395923,395923,8.13,51.14,59.27
2020-01-10 16:00:00+08,0,3,3,0,292032,292032,0,40.25,40.25
2020-01-10 20:00:00+08,1,5,6,103890,495683,599573,1.07,53.11,54.18
2020-01-11 00:00:00+08,0,6,6,0,639726,639726,0,74.95,74.95
2020-01-11 04:00:00+08,0,6,6,0,639726,639726,0,98.95,98.95
2020-01-11 08:00:00+08,0,6,6,0,675108,675108,0,96.25,96.25
2020-01-11 12:00:00+08,0,5,5,0,595549,595549,0,103.8,103.8
2020-01-11 16:00:00+08,0,5,5,0,595549,595549,0,123.8,123.8
2020-01-11 20:00:00+08,0,6,6,0,588806,588806,0,61.5,61.5
2020-01-12 00:00:00+08,0,6,6,0,588806,588806,0,85.5,85.5
2020-01-12 04:00:00+08,0,6,6,0,588806,588806,0,109.5,109.5
2020-01-12 08:00:00+08,0,5,5,0,464714,464714,0,97.08,97.08
2020-01-12 12:00:00+08,0,5,5,0,443982,443982,0,91.27,91.27
2020-01-12 16:00:00+08,0,6,6,0,500871,500871,0,114.86,114.86
2020-01-12 20:00:00+08,0,7,7,0,558191,558191,0,139.99,139.99
2020-01-13 00:00:00+08,0,7,7,0,558191,558191,0,167.99,167.99
2020-01-13 04:00:00+08,0,6,6,0,515108,515108,0,163.28,163.28
2020-01-13 08:00:00+08,0,5,5,0,449761,449761,0,151.17,151.17
2020-01-13 12:00:00+08,0,3,3,0,288981,288981,0,106.8,106.8
2020-01-13 20:00:00+08,1,0,1,138907,0,138907,2.12,0,2.12
2020-01-14 00:00:00+08,1,0,1,138907,0,138907,6.12,0,6.12
2020-01-14 04:00:00+08,0,1,1,0,138882,138882,0,3.77,3.77
2020-01-14 08:00:00+08,0,4,4,0,340812,340812,13.65,9.66,23.31
2020-01-14 12:00:00+08,0,4,4,0,340812,340812,13.65,25.66,39.31
2020-01-14 16:00:00+08,0,3,3,0,317148,317148,13.65,32.86,46.51
2020-01-14 20:00:00+08,0,3,3,0,317148,317148,13.65,44.86,58.51
2020-01-15 00:00:00+08,1,6,7,17191,547901,565092,15.97,60.88,76.85
2020-01-15 04:00:00+08,0,6,6,0,547901,547901,13.65,84.88,98.53
2020-01-15 08:00:00+08,0,8,8,0,706997,706997,23.1,90.55,113.65
2020-01-15 12:00:00+08,0,7,7,0,626936,626936,23.1,107.46,130.56
2020-01-15 16:00:00+08,0,7,7,0,626936,626936,23.1,135.46,158.56
2020-01-15 20:00:00+08,0,7,7,0,613479,613479,13.66,108.75,122.41
2020-01-16 00:00:00+08,0,6,6,0,562790,562790,13.66,112.68,126.34
2020-01-16 04:00:00+08,0,6,6,0,555447,555447,13.66,130.26,143.92
2020-01-16 08:00:00+08,0,6,6,0,611935,611935,20.79,115.21,136
2020-01-16 12:00:00+08,0,5,5,0,511932,511932,20.79,102.36,123.15
2020-01-16 16:00:00+08,0,6,6,0,622580,622580,20.78,111.88,132.66
2020-01-16 20:00:00+08,0,9,9,0,903909,903909,20.78,139.42,160.2
2020-01-17 00:00:00+08,0,8,8,0,765002,765002,7.12,110.96,118.08
2020-01-17 04:00:00+08,0,7,7,0,742688,742688,7.12,127.23,134.35
2020-01-17 08:00:00+08,0,7,7,0,742688,742688,7.12,155.23,162.35
2020-01-17 12:00:00+08,0,7,7,0,742688,742688,7.12,183.23,190.35
2020-01-17 16:00:00+08,0,3,3,0,342480,342480,0,66.42,66.42
2020-01-17 20:00:00+08,0,4,4,0,427168,427168,0,79.13,79.13
2020-01-18 00:00:00+08,0,4,4,0,427168,427168,0,95.13,95.13
2020-01-18 04:00:00+08,0,6,6,0,655588,655588,0,118.11,118.11
2020-01-18 08:00:00+08,0,5,5,0,538416,538416,0,105.39,105.39
2020-01-18 12:00:00+08,0,5,5,0,538416,538416,0,125.39,125.39
2020-01-18 16:00:00+08,0,3,3,0,313108,313108,0,51.71,51.71
2020-01-18 20:00:00+08,0,5,5,0,459899,459899,0,65.33,65.33
2020-01-19 00:00:00+08,0,7,7,0,595923,595923,0,87.54,87.54
2020-01-19 04:00:00+08,1,7,8,73800,595923,669723,0.79,115.54,116.33
2020-01-19 08:00:00+08,0,7,7,0,585035,585035,4.4,107.22,111.62
2020-01-19 12:00:00+08,0,5,5,0,356615,356615,4.4,64.22,68.62
2020-01-19 16:00:00+08,0,3,3,0,245185,245185,4.4,46.74,51.14
2020-01-19 20:00:00+08,0,2,2,0,177468,177468,4.4,36.69,41.09
2020-01-20 00:00:00+08,0,2,2,0,177468,177468,4.4,44.69,49.09
2020-01-20 04:00:00+08,1,2,3,18278,177468,195746,6.26,52.69,58.95
2020-01-20 08:00:00+08,1,1,2,18278,58200,76478,5.86,1.57,7.43
2020-01-20 12:00:00+08,1,1,2,18278,58200,76478,9.86,5.57,15.43
2020-01-20 16:00:00+08,0,1,1,0,58200,58200,0,9.57,9.57
2020-01-20 20:00:00+08,0,3,3,0,223126,223126,17.07,14.9,31.97
2020-01-21 00:00:00+08,0,3,3,0,223126,223126,17.07,26.9,43.97
2020-01-21 04:00:00+08,0,1,1,0,146648,146648,0,8.54,8.54
2020-01-21 08:00:00+08,0,1,1,0,146648,146648,0,12.54,12.54
2020-01-21 12:00:00+08,0,3,3,0,273868,273868,0,23.69,23.69
2020-01-21 16:00:00+08,0,3,3,0,273868,273868,0,35.69,35.69
2020-01-21 20:00:00+08,0,2,2,0,250316,250316,0,36.18,36.18
2020-01-22 00:00:00+08,0,3,3,0,273654,273654,0,45.2,45.2
2020-01-22 04:00:00+08,0,3,3,0,273654,273654,0,57.2,57.2
2020-01-22 08:00:00+08,0,4,4,0,361111,361111,0,63.22,63.22
2020-01-22 12:00:00+08,0,4,4,0,291605,291605,0,52.09,52.09
2020-01-22 16:00:00+08,0,4,4,0,291605,291605,0,68.09,68.09
2020-01-22 20:00:00+08,0,5,5,0,436805,436805,0,71.33,71.33
2020-01-23 00:00:00+08,0,4,4,0,410785,410785,0,74.11,74.11
2020-01-23 04:00:00+08,0,4,4,0,410785,410785,0,90.11,90.11
2020-01-23 08:00:00+08,0,4,4,0,478441,478441,0,87.2,87.2
2020-01-23 12:00:00+08,0,3,3,0,331793,331793,0,38.66,38.66
2020-01-23 16:00:00+08,0,3,3,0,331793,331793,0,50.66,50.66
2020-01-23 20:00:00+08,1,3,4,123625,355696,479321,1.5,38.38,39.88
2020-01-24 00:00:00+08,1,5,6,123625,443073,566698,5.5,56.94,62.44
2020-01-24 04:00:00+08,1,7,8,123625,577089,700714,9.5,84.57,94.07
2020-01-24 08:00:00+08,1,7,8,123625,646504,770129,13.52,103.63,117.15
2020-01-24 12:00:00+08,1,7,8,123625,646504,770129,17.52,131.63,149.15
2020-01-24 16:00:00+08,1,4,5,123625,423436,547061,21.51,90.63,112.14
2020-01-24 20:00:00+08,1,6,7,43114,585786,628900,1.11,108.06,109.17
2020-01-25 00:00:00+08,0,6,6,0,599676,599676,27.15,106.14,133.29
2020-01-25 04:00:00+08,0,9,9,0,850089,850089,33.57,139.83,173.4
2020-01-25 08:00:00+08,1,10,11,50088,974260,1024348,34.16,147.48,181.64
2020-01-25 12:00:00+08,1,9,10,50088,947449,997537,38.16,170.48,208.64
2020-01-25 16:00:00+08,1,6,7,50088,656524,706612,35.72,89.32,125.04
2020-01-25 20:00:00+08,1,9,10,50088,966175,1016263,39.71,116.72,156.43
2020-01-26 00:00:00+08,0,9,9,0,979020,979020,27.16,126.12,153.28
2020-01-26 04:00:00+08,1,10,11,135539,1029108,1164647,46.32,165.04,211.36
2020-01-26 08:00:00+08,1,11,12,135539,1075416,1210955,50.32,181.65,231.97
2020-01-26 12:00:00+08,1,10,11,135539,971785,1107324,54.35,190.34,244.69
2020-01-26 16:00:00+08,1,7,8,135539,634492,770031,31.16,115.53,146.69
2020-01-26 20:00:00+08,1,7,8,135539,683037,818576,35.17,130.25,165.42
2020-01-27 00:00:00+08,1,7,8,135539,764984,900523,21.52,137.46,158.98
2020-01-27 04:00:00+08,1,8,9,135539,815681,951220,25.52,168.38,193.9
2020-01-27 08:00:00+08,2,6,8,151936,651550,803486,33.4,127.14,160.54
2020-01-27 12:00:00+08,2,5,7,151936,566715,718651,41.4,121.69,163.09
2020-01-27 16:00:00+08,2,5,7,151936,566715,718651,49.4,141.69,191.09
2020-01-27 20:00:00+08,1,7,8,135539,663206,798745,41.53,114.47,156
2020-01-28 00:00:00+08,0,6,6,0,538827,538827,16.94,93.83,110.77
2020-01-28 04:00:00+08,0,6,6,0,538827,538827,16.94,117.83,134.77
2020-01-28 08:00:00+08,0,6,6,0,546094,546094,0,131.7,131.7
2020-01-28 12:00:00+08,0,4,4,0,335503,335503,0,77.21,77.21
2020-01-28 16:00:00+08,0,3,3,0,203468,203468,0,51.08,51.08
2020-01-28 20:00:00+08,1,4,5,115086,297409,412495,3.17,27.79,30.96
2020-01-29 00:00:00+08,1,7,8,115086,647833,762919,7.16,27.68,34.84
2020-01-29 04:00:00+08,1,7,8,115086,647833,762919,11.16,55.68,66.84
2020-01-29 08:00:00+08,1,7,8,115086,715080,830166,15.16,72.15,87.31
2020-01-29 12:00:00+08,1,8,9,115086,749784,864870,19.16,101.01,120.17
2020-01-29 16:00:00+08,0,6,6,0,590591,590591,0,91.48,91.48
2020-01-29 20:00:00+08,0,7,7,0,611399,611399,0,91.2,91.2
2020-01-30 00:00:00+08,0,10,10,0,841133,841133,27.75,126.76,154.51
2020-01-30 04:00:00+08,0,10,10,0,809126,809126,27.75,138.44,166.19
2020-01-30 08:00:00+08,0,10,10,0,893891,893891,34.56,124.26,158.82
2020-01-30 12:00:00+08,0,8,8,0,778119,778119,34.56,133.74,168.3
2020-01-30 16:00:00+08,0,7,7,0,692602,692602,34.56,132.82,167.38
2020-01-30 20:00:00+08,0,7,7,0,728190,728190,34.56,136.89,171.45
2020-01-31 00:00:00+08,1,7,8,102861,728190,831051,34.96,164.89,199.85
2020-01-31 04:00:00+08,0,5,5,0,541855,541855,34.56,135,169.56
2020-01-31 08:00:00+08,0,8,8,0,867198,867198,40.8,161.87,202.67
2020-01-31 12:00:00+08,0,7,7,0,805589,805589,40.8,177.52,218.32
2020-01-31 16:00:00+08,0,6,6,0,689596,689596,40.85,172.14,212.99
2020-01-31 20:00:00+08,0,6,6,0,599335,599335,34.05,91.77,125.82
2020-02-01 00:00:00+08,0,16,16,0,1367360,1367360,68.1,237.8,305.9
2020-02-01 04:00:00+08,0,14,14,0,1137188,1137188,12.56,190.96,203.52
2020-02-01 08:00:00+08,2,14,16,210014,1137188,1347202,14.84,246.96,261.8
2020-02-01 12:00:00+08,2,12,14,210014,905042,1115056,10.24,186.1,196.34
2020-02-01 16:00:00+08,2,12,14,210014,1145034,1355048,18.24,196.12,214.36
2020-02-01 20:00:00+08,2,16,18,210014,1488622,1698636,26.3,247.56,273.86
2020-02-02 00:00:00+08,2,16,18,210014,1671966,1881980,34.3,269.56,303.86
2020-02-02 04:00:00+08,2,14,16,210014,1572154,1782168,42.28,210.18,252.46
2020-02-02 08:00:00+08,2,14,16,210014,1572154,1782168,50.28,266.18,316.46
2020-02-02 12:00:00+08,2,14,16,210014,1572154,1782168,58.28,322.18,380.46
2020-02-02 16:00:00+08,0,10,10,0,1254990,1254990,0,277.48,277.48
2020-02-02 20:00:00+08,0,10,10,0,1227376,1227376,72.96,192.56,265.52
2020-02-03 00:00:00+08,0,10,10,0,1227376,1227376,72.96,232.56,305.52
2020-02-03 04:00:00+08,0,6,6,0,725998,725998,72.96,135.24,208.2
2020-02-03 08:00:00+08,0,8,8,0,1004668,1004668,72.96,164.72,237.68
2020-02-03 12:00:00+08,0,8,8,0,1004668,1004668,72.96,196.72,269.68
2020-02-03 16:00:00+08,0,10,10,0,1209704,1209704,72.96,230.02,302.98
2020-02-03 20:00:00+08,0,12,12,0,1244008,1244008,72.96,272.14,345.1
2020-02-04 00:00:00+08,0,10,10,0,1026008,1026008,72.96,224.52,297.48
2020-02-04 04:00:00+08,0,12,12,0,1073112,1073112,72.96,270.4,343.36
2020-02-04 08:00:00+08,0,12,12,0,1168062,1168062,72.96,177.84,250.8
2020-02-04 12:00:00+08,0,14,14,0,1214738,1214738,72.96,233.2,306.16
2020-02-04 16:00:00+08,0,8,8,0,910944,910944,0,154.66,154.66
2020-02-04 20:00:00+08,0,8,8,0,910944,910944,0,186.66,186.66
2020-02-05 00:00:00+08,0,10,10,0,1080354,1080354,0,223.48,223.48
2020-02-05 04:00:00+08,0,8,8,0,884768,884768,0,104.58,104.58
2020-02-05 08:00:00+08,0,10,10,0,1221794,1221794,0,90.52,90.52
2020-02-05 12:00:00+08,0,10,10,0,1221794,1221794,0,130.52,130.52
2020-02-05 16:00:00+08,0,10,10,0,1080508,1080508,0,111.32,111.32
2020-02-05 20:00:00+08,0,14,14,0,1299580,1299580,0,110.82,110.82
2020-02-06 00:00:00+08,0,14,14,0,1299580,1299580,0,166.82,166.82
2020-02-06 04:00:00+08,0,12,12,0,1230946,1230946,0,205.08,205.08
2020-02-06 08:00:00+08,0,14,14,0,1462346,1462346,0,256.66,256.66
2020-02-06 12:00:00+08,0,10,10,0,1231890,1231890,0,232.56,232.56
2020-02-06 16:00:00+08,0,12,12,0,1317078,1317078,0,277.18,277.18
2020-02-06 20:00:00+08,0,16,16,0,1388286,1388286,0,253.58,253.58
2020-02-07 00:00:00+08,2,16,18,208028,1388286,1596314,6.3,317.58,323.88
2020-02-07 04:00:00+08,2,20,22,208028,1743180,1951208,14.32,391.7,406.02
2020-02-07 08:00:00+08,4,18,22,377578,1584434,1962012,26.96,398.5,425.46
2020-02-07 12:00:00+08,2,18,20,169550,1590810,1760360,12.64,416.54,429.18
2020-02-07 16:00:00+08,0,12,12,0,1216152,1216152,34.02,231.24,265.26
2020-02-07 20:00:00+08,0,14,14,0,1501516,1501516,59.6,194.06,253.66
2020-02-08 00:00:00+08,2,16,18,293182,1532334,1825516,59.82,126.78,186.6
2020-02-08 04:00:00+08,2,18,20,293182,1692792,1985974,67.84,197.68,265.52
2020-02-08 08:00:00+08,2,18,20,293182,1692792,1985974,75.84,269.68,345.52
2020-02-08 12:00:00+08,0,18,18,0,1692792,1692792,59.72,341.68,401.4
2020-02-08 16:00:00+08,0,18,18,0,1692792,1692792,59.72,413.68,473.4
2020-02-08 20:00:00+08,0,20,20,0,1791280,1791280,59.66,439.4,499.06
2020-02-09 00:00:00+08,0,22,22,0,2341162,2341162,75.2,431.36,506.56
2020-02-09 04:00:00+08,0,18,18,0,1901840,1901840,75.24,356.16,431.4
2020-02-09 08:00:00+08,0,18,18,0,1901840,1901840,75.24,428.16,503.4
2020-02-09 12:00:00+08,0,12,12,0,1295578,1295578,41.24,235.34,276.58
2020-02-09 16:00:00+08,0,10,10,0,1213072,1213072,41.24,242.22,283.46
2020-02-09 20:00:00+08,0,6,6,0,834072,834072,41.24,139.08,180.32
2020-02-10 00:00:00+08,0,8,8,0,1053246,1053246,41.24,169.32,210.56
2020-02-10 04:00:00+08,0,8,8,0,1053246,1053246,41.24,201.32,242.56
2020-02-10 08:00:00+08,2,10,12,101064,1270786,1371850,46.48,238.38,284.86
2020-02-10 12:00:00+08,2,8,10,101064,963598,1064662,54.5,198.68,253.18
2020-02-10 16:00:00+08,0,8,8,0,963598,963598,41.26,230.68,271.94
2020-02-10 20:00:00+08,0,12,12,0,1151208,1151208,69.98,176.26,246.24
2020-02-11 00:00:00+08,0,14,14,0,1110036,1110036,28.72,127.08,155.8
2020-02-11 04:00:00+08,0,16,16,0,1157364,1157364,28.72,189.4,218.12
2020-02-11 08:00:00+08,0,22,22,0,1608974,1608974,28.74,262.42,291.16
2020-02-11 12:00:00+08,0,18,18,0,1632872,1632872,28.68,268.78,297.46
2020-02-11 16:00:00+08,0,16,16,0,1415332,1415332,28.68,271.74,300.42
2020-02-11 20:00:00+08,0,16,16,0,1712590,1712590,0,172.72,172.72
2020-02-12 00:00:00+08,0,16,16,0,1712590,1712590,0,236.72,236.72
2020-02-12 04:00:00+08,0,18,18,0,1848024,1848024,0,301.7,301.7
2020-02-12 08:00:00+08,0,20,20,0,1898616,1898616,0,356.14,356.14
2020-02-12 12:00:00+08,0,16,16,0,1495178,1495178,0,319.92,319.92
2020-02-12 16:00:00+08,0,16,16,0,1495178,1495178,0,383.92,383.92
2020-02-12 20:00:00+08,0,18,18,0,1563684,1563684,0,449.68,449.68
2020-02-13 00:00:00+08,0,14,14,0,1234530,1234530,0,362.18,362.18
2020-02-13 04:00:00+08,2,10,12,171426,736674,908100,2.64,223.04,225.68
2020-02-13 08:00:00+08,0,10,10,0,1008070,1008070,0,183.4,183.4
2020-02-13 12:00:00+08,0,12,12,0,1179496,1179496,11.84,230.2,242.04
2020-02-13 16:00:00+08,0,8,8,0,939944,939944,11.84,141,152.84
2020-02-13 20:00:00+08,0,12,12,0,1276264,1276264,11.84,175.32,187.16
2020-02-14 00:00:00+08,0,10,10,0,983082,983082,11.84,116.24,128.08
2020-02-14 04:00:00+08,0,12,12,0,1096860,1096860,11.84,163.48,175.32
2020-02-14 08:00:00+08,0,14,14,0,1166992,1166992,11.84,219.26,231.1
2020-02-14 12:00:00+08,2,14,16,159118,1166992,1326110,17,275.26,292.26
2020-02-14 16:00:00+08,2,10,12,159118,879450,1038568,25,223.62,248.62
2020-02-14 20:00:00+08,2,10,12,159118,978694,1137812,32.96,233.56,266.52
2020-02-15 00:00:00+08,4,16,20,390518,1571236,1961754,30.32,216.96,247.28
2020-02-15 04:00:00+08,2,18,20,231400,1758416,1989816,9.16,286.88,296.04
2020-02-15 08:00:00+08,2,18,20,231400,1803756,2035156,58.86,299.1,357.96
2020-02-15 12:00:00+08,2,16,18,231400,1509714,1741114,66.86,266.62,333.48
2020-02-15 16:00:00+08,2,14,16,231400,1279642,1511042,74.9,241.26,316.16
2020-02-15 20:00:00+08,2,18,20,231400,1496690,1728090,82.9,300.42,383.32
2020-02-16 00:00:00+08,4,14,18,278558,1079348,1357906,121.36,262.1,383.46
2020-02-16 04:00:00+08,4,10,14,278558,805590,1084148,95.66,218.52,314.18
2020-02-16 08:00:00+08,2,6,8,47158,404228,451386,46.46,113.02,159.48
2020-02-16 12:00:00+08,2,6,8,47158,448448,495606,124.82,69.96,194.78
2020-02-16 16:00:00+08,2,2,4,47158,231400,278558,132.82,10.84,143.66
2020-02-16 20:00:00+08,2,10,12,47158,1013610,1060768,140.82,34.1,174.92
2020-02-17 00:00:00+08,0,10,10,0,1013610,1013610,70.36,74.1,144.46
2020-02-17 04:00:00+08,0,12,12,0,1060768,1060768,148.92,122,270.92
2020-02-17 08:00:00+08,0,12,12,0,1060768,1060768,148.92,170,318.92
2020-02-17 12:00:00+08,0,12,12,0,1060768,1060768,148.92,218,366.92
2020-02-17 16:00:00+08,0,10,10,0,937860,937860,148.92,224.48,373.4
2020-02-17 20:00:00+08,0,14,14,0,1074622,1074622,148.92,266.42,415.34
2020-02-18 00:00:00+08,0,16,16,0,1405698,1405698,148.92,322.68,471.6
2020-02-18 04:00:00+08,0,12,12,0,1014834,1014834,0,178.98,178.98
2020-02-18 08:00:00+08,0,10,10,0,932196,932196,0,133.22,133.22
2020-02-18 12:00:00+08,0,8,8,0,885520,885520,0,155.66,155.66
2020-02-18 16:00:00+08,0,6,6,0,724708,724708,0,58.54,58.54
2020-02-18 20:00:00+08,0,10,10,0,1055984,1055984,0,88.6,88.6
2020-02-19 00:00:00+08,0,14,14,0,1337650,1337650,0,143.3,143.3
2020-02-19 04:00:00+08,0,16,16,0,1625912,1625912,0,205.9,205.9
2020-02-19 08:00:00+08,0,16,16,0,1678590,1678590,0,247.54,247.54
2020-02-19 12:00:00+08,0,12,12,0,1345912,1345912,0,215.08,215.08
2020-02-19 16:00:00+08,0,12,12,0,1345912,1345912,0,263.08,263.08
2020-02-19 20:00:00+08,0,14,14,0,1462434,1462434,0,261.4,261.4
2020-02-20 00:00:00+08,2,12,14,219264,1362652,1581916,3.38,283.82,287.2
2020-02-20 04:00:00+08,0,14,14,0,1581916,1581916,8.8,334.4,343.2
2020-02-20 08:00:00+08,0,14,14,0,1692352,1692352,8.8,369.16,377.96
2020-02-20 12:00:00+08,0,14,14,0,1692352,1692352,8.8,425.16,433.96
2020-02-20 16:00:00+08,0,8,8,0,896194,896194,8.8,164.12,172.92
2020-02-20 20:00:00+08,0,12,12,0,1221186,1221186,8.82,199.92,208.74
2020-02-21 00:00:00+08,0,12,12,0,1221186,1221186,8.82,247.92,256.74
2020-02-21 04:00:00+08,0,12,12,0,1221186,1221186,8.82,295.92,304.74
2020-02-21 08:00:00+08,0,10,10,0,1013404,1013404,8.8,271.92,280.72
2020-02-21 12:00:00+08,0,8,8,0,890186,890186,8.8,277.4,286.2
2020-02-21 16:00:00+08,0,6,6,0,709300,709300,8.8,242.48,251.28
2020-02-21 20:00:00+08,0,2,2,0,201774,201774,0,49.32,49.32
2020-02-22 00:00:00+08,0,2,2,0,201774,201774,0,57.32,57.32
2020-02-22 04:00:00+08,0,10,10,0,649806,649806,0,90.68,90.68
2020-02-22 08:00:00+08,2,10,12,68390,593832,662222,6.32,59.52,65.84
2020-02-22 12:00:00+08,2,12,14,68390,730446,798836,14.32,101.08,115.4
2020-02-22 16:00:00+08,2,10,12,68390,661246,729636,22.32,118.64,140.96
2020-02-22 20:00:00+08,2,8,10,68390,557370,625760,30.32,47.36,77.68
2020-02-23 00:00:00+08,0,8,8,0,557370,557370,0,79.36,79.36
2020-02-23 04:00:00+08,0,10,10,0,672166,672166,41.22,80.58,121.8
2020-02-23 08:00:00+08,0,10,10,0,672166,672166,41.22,120.58,161.8
2020-02-23 12:00:00+08,0,10,10,0,672166,672166,41.22,160.58,201.8
2020-02-23 16:00:00+08,0,8,8,0,555766,555766,41.22,158.74,199.96
2020-02-23 20:00:00+08,0,10,10,0,705894,705894,41.2,145.22,186.42
2020-02-24 00:00:00+08,0,14,14,0,1074300,1074300,41.2,188.56,229.76
2020-02-24 04:00:00+08,2,12,14,32794,993664,1026458,47.52,115.36,162.88
2020-02-24 08:00:00+08,2,14,16,32794,1060576,1093370,55.54,165.8,221.34
2020-02-24 12:00:00+08,2,12,14,32794,992186,1024980,22.32,152.7,175.02
2020-02-24 16:00:00+08,0,8,8,0,806270,806270,0,126.46,126.46
2020-02-24 20:00:00+08,2,8,10,290474,806270,1096744,1.46,158.46,159.92
2020-02-25 00:00:00+08,2,18,20,290474,1561122,1851596,51,210.8,261.8
2020-02-25 04:00:00+08,2,20,22,290474,1608450,1898924,58.94,288.9,347.84
2020-02-25 08:00:00+08,2,16,18,290474,1350096,1640570,66.94,181.7,248.64
2020-02-25 12:00:00+08,0,14,14,0,1317302,1317302,0,216.94,216.94
2020-02-25 16:00:00+08,0,12,12,0,1276408,1276408,33.96,167.64,201.6
2020-02-25 20:00:00+08,0,12,12,0,1393540,1393540,33.96,172.32,206.28
2020-02-26 00:00:00+08,2,12,14,189258,1393540,1582798,37.86,220.32,258.18
2020-02-26 04:00:00+08,0,12,12,0,1393540,1393540,33.96,268.32,302.28
2020-02-26 08:00:00+08,0,16,16,0,1719050,1719050,48.92,324.84,373.76
2020-02-26 12:00:00+08,2,16,18,220762,1531692,1752454,49.64,315.86,365.5
2020-02-26 16:00:00+08,2,14,16,220762,1360072,1580834,57.66,338.34,396
2020-02-26 20:00:00+08,2,16,18,220762,1453432,1674194,65.66,378.52,444.18
2020-02-27 00:00:00+08,0,16,16,0,1403456,1403456,93.32,362.6,455.92
2020-02-27 04:00:00+08,4,18,22,386786,1844268,2231054,127.04,420.46,547.5
2020-02-27 08:00:00+08,4,16,20,386786,1454152,1840938,94.14,192.28,286.42
2020-02-27 12:00:00+08,6,16,22,618772,1454870,2073642,110.88,226.02,336.9
2020-02-27 16:00:00+08,6,16,22,618772,1454870,2073642,134.88,290.02,424.9
2020-02-27 20:00:00+08,8,20,28,727086,1817004,2544090,162.7,359.8,522.5
2020-02-28 00:00:00+08,8,20,28,727086,1817004,2544090,194.7,439.8,634.5
2020-02-28 04:00:00+08,8,20,28,727086,1817004,2544090,226.7,519.8,746.5
2020-02-28 08:00:00+08,8,20,28,727086,1817004,2544090,258.7,599.8,858.5
2020-02-28 12:00:00+08,6,12,18,521568,1169700,1691268,150.28,314.68,464.96
2020-02-28 16:00:00+08,4,10,14,289582,1094386,1383968,189.1,257.86,446.96
2020-02-28 20:00:00+08,4,16,20,289582,1579790,1869372,205.16,229.44,434.6
2020-02-29 00:00:00+08,2,14,16,108314,1417296,1525610,131.36,211.82,343.18
2020-02-29 04:00:00+08,2,18,20,108314,1830550,1938864,302.24,283.36,585.6
2020-02-29 08:00:00+08,2,18,20,108314,1947992,2056306,310.2,332.18,642.38
2020-02-29 12:00:00+08,2,18,20,108314,1947992,2056306,318.2,404.18,722.38
2020-02-29 16:00:00+08,2,18,20,108314,1947992,2056306,326.2,476.18,802.38
2020-02-29 20:00:00+08,2,16,18,108314,1759032,1867346,334.2,496.78,830.98
2020-03-01 00:00:00+08,2,16,18,108314,1759032,1867346,342.2,560.78,902.98
2020-03-01 04:00:00+08,2,16,18,108314,1677684,1785998,350.2,481.02,831.22
2020-03-01 08:00:00+08,2,10,12,108314,995890,1104204,286.8,266.16,552.96
2020-03-01 12:00:00+08,2,4,6,108314,410972,519286,131.84,81.92,213.76
2020-03-01 16:00:00+08,2,4,6,108314,498456,606770,139.84,34.12,173.96
2020-03-01 20:00:00+08,2,10,12,108314,933022,1041336,147.86,66.92,214.78
2020-03-02 00:00:00+08,2,10,12,108314,933022,1041336,155.86,106.92,262.78
2020-03-02 04:00:00+08,2,8,10,108314,725686,834000,163.86,91.2,255.06
2020-03-02 08:00:00+08,0,10,10,0,871622,871622,0,126.22,126.22
2020-03-02 12:00:00+08,2,10,12,36556,871622,908178,7.34,166.22,173.56
2020-03-02 16:00:00+08,0,10,10,0,871622,871622,0,206.22,206.22
2020-03-02 20:00:00+08,0,14,14,0,1172474,1172474,22.1,138.7,160.8
2020-03-03 00:00:00+08,0,18,18,0,1339186,1339186,22.08,201.64,223.72
2020-03-03 04:00:00+08,0,26,26,0,2147790,2147790,22.08,296.08,318.16
2020-03-03 08:00:00+08,0,24,24,0,2111234,2111234,0,374.84,374.84
2020-03-03 12:00:00+08,0,24,24,0,2111234,2111234,0,470.84,470.84
2020-03-03 16:00:00+08,0,20,20,0,1957904,1957904,0,487.52,487.52
2020-03-03 20:00:00+08,0,22,22,0,1855462,1855462,242.4,357.52,599.92
2020-03-04 00:00:00+08,0,20,20,0,1740822,1740822,242.42,396.94,639.36
2020-03-04 04:00:00+08,0,18,18,0,1537264,1537264,242.42,421.84,664.26
2020-03-04 08:00:00+08,0,16,16,0,1280992,1280992,242.4,268.94,511.34
2020-03-04 12:00:00+08,0,20,20,0,1637616,1637616,242.4,341.84,584.24
2020-03-04 16:00:00+08,0,14,14,0,1172092,1172092,242.4,253.3,495.7
2020-03-04 20:00:00+08,0,20,20,0,1669700,1669700,242.46,317.48,559.94
2020-03-05 00:00:00+08,0,18,18,0,1561386,1561386,0,340.08,340.08
2020-03-05 04:00:00+08,0,18,18,0,1561386,1561386,0,412.08,412.08
2020-03-05 08:00:00+08,0,16,16,0,1739278,1739278,0,377.6,377.6
2020-03-05 12:00:00+08,2,16,18,189052,1739278,1928330,0.7,441.6,442.3
2020-03-05 16:00:00+08,2,12,14,189052,1427774,1616826,8.7,400.24,408.94
2020-03-05 20:00:00+08,2,16,18,189052,1848066,2037118,16.7,451.44,468.14
2020-03-06 00:00:00+08,0,16,16,0,1848066,1848066,0,515.44,515.44
2020-03-06 04:00:00+08,0,20,20,0,2119940,2119940,26.7,589.78,616.48
2020-03-06 08:00:00+08,0,18,18,0,1789598,1789598,26.7,516.16,542.86
2020-03-06 12:00:00+08,0,14,14,0,1196610,1196610,26.7,401.84,428.54
2020-03-06 16:00:00+08,0,14,14,0,1196610,1196610,26.7,457.84,484.54
2020-03-06 20:00:00+08,0,14,14,0,1182188,1182188,26.68,213.22,239.9
2020-03-07 00:00:00+08,0,18,18,0,1564766,1564766,26.7,281.92,308.62
2020-03-07 04:00:00+08,0,18,18,0,1564766,1564766,26.7,353.92,380.62
2020-03-07 08:00:00+08,2,16,18,231986,1340306,1572292,33.72,322.96,356.68
2020-03-07 12:00:00+08,2,10,12,231986,919006,1150992,15.06,247.02,262.08
2020-03-07 16:00:00+08,0,10,10,0,919006,919006,0,287.02,287.02
2020-03-07 20:00:00+08,0,10,10,0,1068170,1068170,28.24,245.5,273.74
2020-03-08 00:00:00+08,0,6,6,0,576794,576794,28.26,123.88,152.14
2020-03-08 04:00:00+08,0,8,8,0,719020,719020,28.26,154.88,183.14
2020-03-08 08:00:00+08,0,4,4,0,374212,374212,28.26,41.8,70.06
2020-03-08 12:00:00+08,0,4,4,0,374212,374212,28.26,57.8,86.06
2020-03-08 16:00:00+08,0,4,4,0,374212,374212,28.26,73.8,102.06
2020-03-08 20:00:00+08,0,4,4,0,288936,288936,0,41.88,41.88
2020-03-09 00:00:00+08,0,4,4,0,288936,288936,0,57.88,57.88
2020-03-09 04:00:00+08,0,8,8,0,609298,609298,0,81.96,81.96
2020-03-09 08:00:00+08,0,10,10,0,780332,780332,0,119.08,119.08
2020-03-09 12:00:00+08,0,8,8,0,633622,633622,0,124.18,124.18
2020-03-09 16:00:00+08,0,8,8,0,633622,633622,0,156.18,156.18
2020-03-09 20:00:00+08,0,12,12,0,980922,980922,0,194.4,194.4
2020-03-10 00:00:00+08,2,14,16,124414,1179054,1303468,3.8,246.4,250.2
2020-03-10 04:00:00+08,2,12,14,124414,1064414,1188828,11.76,250.32,262.08
2020-03-10 08:00:00+08,2,10,12,124414,858692,983106,19.78,238.36,258.14
2020-03-10 12:00:00+08,2,8,10,124414,687658,812072,27.78,217.26,245.04
2020-03-10 16:00:00+08,2,8,10,124414,687658,812072,35.78,249.26,285.04
2020-03-10 20:00:00+08,4,12,16,192940,1098234,1291174,44.42,238.76,283.18
2020-03-11 00:00:00+08,2,8,10,124414,580480,704894,56.92,36.84,93.76
2020-03-11 04:00:00+08,2,12,14,124414,697008,821422,64.94,77.76,142.7
2020-03-11 08:00:00+08,2,14,16,124414,872244,996658,72.94,129.88,202.82
2020-03-11 12:00:00+08,2,14,16,124414,970688,1095102,80.92,130.76,211.68
2020-03-11 16:00:00+08,2,14,16,124414,970688,1095102,88.92,186.76,275.68
2020-03-11 20:00:00+08,4,8,12,193614,708992,902606,93.18,98.12,191.3
2020-03-12 00:00:00+08,2,8,10,124414,708992,833406,99.76,130.12,229.88
2020-03-12 04:00:00+08,2,6,8,124414,638542,762956,107.76,143.98,251.74
2020-03-12 08:00:00+08,2,6,8,124414,655512,779926,115.76,96.7,212.46
2020-03-12 12:00:00+08,2,10,12,124414,930854,1055268,123.76,133.48,257.24
2020-03-12 16:00:00+08,0,8,8,0,755618,755618,0,105.34,105.34
2020-03-12 20:00:00+08,0,14,14,0,1472704,1472704,136.96,122.32,259.28
2020-03-13 00:00:00+08,0,16,16,0,1705584,1705584,136.96,178.94,315.9
2020-03-13 04:00:00+08,0,18,18,0,1739966,1739966,136.96,250.72,387.68
2020-03-13 08:00:00+08,0,20,20,0,1824596,1824596,136.96,245.1,382.06
2020-03-13 12:00:00+08,0,18,18,0,1755874,1755874,136.96,246.8,383.76
2020-03-13 16:00:00+08,0,18,18,0,1755874,1755874,136.96,318.8,455.76
2020-03-13 20:00:00+08,2,22,24,126790,2152428,2279218,141.5,399.66,541.16
2020-03-14 00:00:00+08,0,20,20,0,1950278,1950278,145.64,393.76,539.4
2020-03-14 04:00:00+08,2,22,24,207780,2121798,2329578,146.92,478.42,625.34
2020-03-14 08:00:00+08,4,18,22,334534,1681106,2015640,160.66,420.3,580.96
2020-03-14 12:00:00+08,4,14,18,334534,1349356,1683890,39.74,348.48,388.22
2020-03-14 16:00:00+08,2,12,14,126754,1116476,1243230,30.4,323.82,354.22
2020-03-14 20:00:00+08,2,6,8,126754,586596,713350,59.96,90.76,150.72
2020-03-15 00:00:00+08,2,10,12,126754,974774,1101528,67.96,128.7,196.66
2020-03-15 04:00:00+08,2,12,14,126754,922466,1049220,75.98,110.48,186.46
2020-03-15 08:00:00+08,0,12,12,0,922466,922466,30.24,158.48,188.72
2020-03-15 12:00:00+08,0,10,10,0,750946,750946,30.24,137.86,168.1
2020-03-15 16:00:00+08,0,10,10,0,823806,823806,94.16,152.78,246.94
2020-03-15 20:00:00+08,0,10,10,0,827604,827604,94.16,150.1,244.26
2020-03-16 00:00:00+08,0,10,10,0,801026,801026,30.24,170.1,200.34
2020-03-16 04:00:00+08,0,8,8,0,593246,593246,0,143,143
2020-03-16 08:00:00+08,0,10,10,0,790818,790818,0,115.14,115.14
2020-03-16 12:00:00+08,0,10,10,0,790818,790818,0,155.14,155.14
2020-03-16 16:00:00+08,0,8,8,0,689724,689724,0,121.18,121.18
2020-03-16 20:00:00+08,0,8,8,0,626098,626098,0,114.9,114.9
2020-03-17 00:00:00+08,0,10,10,0,740738,740738,0,149.32,149.32
2020-03-17 04:00:00+08,0,8,8,0,704188,704188,0,169.8,169.8
2020-03-17 08:00:00+08,0,8,8,0,664880,664880,0,130.42,130.42
2020-03-17 12:00:00+08,0,12,12,0,897200,897200,0,169.6,169.6
2020-03-17 16:00:00+08,0,8,8,0,518742,518742,0,79.34,79.34
2020-03-17 20:00:00+08,0,12,12,0,952188,952188,0,121.2,121.2
2020-03-18 00:00:00+08,0,10,10,0,891514,891514,0,144.96,144.96
2020-03-18 04:00:00+08,0,8,8,0,833304,833304,11.64,81.16,92.8
2020-03-18 08:00:00+08,0,8,8,0,703242,703242,11.64,50.92,62.56
2020-03-18 12:00:00+08,0,8,8,0,703242,703242,11.64,82.92,94.56
2020-03-18 16:00:00+08,0,8,8,0,703242,703242,11.64,114.92,126.56
2020-03-18 20:00:00+08,0,12,12,0,1128322,1128322,11.64,131.04,142.68
2020-03-19 00:00:00+08,0,14,14,0,1175426,1175426,11.64,180.28,191.92
2020-03-19 04:00:00+08,0,14,14,0,980710,980710,11.64,168.42,180.06
2020-03-19 08:00:00+08,0,14,14,0,1085026,1085026,11.64,201.38,213.02
2020-03-19 12:00:00+08,0,10,10,0,879002,879002,11.64,169.08,180.72
2020-03-19 16:00:00+08,0,10,10,0,879002,879002,11.64,209.08,220.72
2020-03-19 20:00:00+08,0,10,10,0,893270,893270,11.64,167.52,179.16
2020-03-20 00:00:00+08,0,14,14,0,1240754,1240754,11.64,208.94,220.58
2020-03-20 04:00:00+08,0,14,14,0,1240754,1240754,11.64,264.94,276.58
2020-03-20 08:00:00+08,2,12,14,218042,1069526,1287568,14.22,267.62,281.84
2020-03-20 12:00:00+08,2,10,12,218042,905940,1123982,22.14,201.58,223.72
2020-03-20 16:00:00+08,2,10,12,218042,905940,1123982,30.14,241.58,271.72
2020-03-20 20:00:00+08,2,16,18,218042,1271948,1489990,26.58,116,142.58
2020-03-21 00:00:00+08,4,18,22,511586,1503348,2014934,37.6,187.86,225.46
2020-03-21 04:00:00+08,4,20,24,511586,1705748,2217334,53.64,261.86,315.5
2020-03-21 08:00:00+08,2,22,24,293544,2007106,2300650,66.44,323.82,390.26
2020-03-21 12:00:00+08,2,18,20,293544,1716604,2010148,74.4,323.18,397.58
2020-03-21 16:00:00+08,0,18,18,0,1716604,1716604,47.36,395.18,442.54
2020-03-21 20:00:00+08,0,16,16,0,1422742,1422742,47.36,293.32,340.68
2020-03-22 00:00:00+08,0,10,10,0,976912,976912,92.52,131.18,223.7
2020-03-22 04:00:00+08,0,10,10,0,976912,976912,92.52,171.18,263.7
2020-03-22 08:00:00+08,0,12,12,0,1211264,1211264,92.48,217.4,309.88
2020-03-22 12:00:00+08,0,8,8,0,799560,799560,92.48,138.84,231.32
2020-03-22 16:00:00+08,0,6,6,0,745938,745938,92.48,127.28,219.76
2020-03-22 20:00:00+08,0,8,8,0,953278,953278,45.12,80.06,125.18
2020-03-23 00:00:00+08,0,10,10,0,1054672,1054672,45.12,113.74,158.86
2020-03-23 04:00:00+08,0,10,10,0,1054672,1054672,45.12,153.74,198.86
2020-03-23 08:00:00+08,0,10,10,0,1054672,1054672,45.12,193.74,238.86
2020-03-23 12:00:00+08,0,10,10,0,1054672,1054672,45.12,233.74,278.86
2020-03-23 16:00:00+08,0,8,8,0,820320,820320,45.12,203.6,248.72
2020-03-23 20:00:00+08,0,4,4,0,308776,308776,0,91.86,91.86
2020-03-24 00:00:00+08,0,10,10,0,740956,740956,0,117.06,117.06
2020-03-24 04:00:00+08,0,8,8,0,639562,639562,0,99.38,99.38
2020-03-24 08:00:00+08,2,10,12,36556,693298,729854,6.98,135,141.98
2020-03-24 12:00:00+08,2,12,14,36556,929700,966256,14.98,103.3,118.28
2020-03-24 16:00:00+08,2,10,12,36556,846632,883188,23,117.74,140.74
2020-03-24 20:00:00+08,0,12,12,0,1036744,1036744,27.68,138.64,166.32
2020-03-25 00:00:00+08,0,14,14,0,1363688,1363688,27.68,139.46,167.14
2020-03-25 04:00:00+08,0,14,14,0,1374460,1374460,0,183.32,183.32
2020-03-25 08:00:00+08,0,18,18,0,1663982,1663982,5.52,206.74,212.26
2020-03-25 12:00:00+08,0,16,16,0,1391888,1391888,5.48,167.66,173.14
2020-03-25 16:00:00+08,0,12,12,0,1299932,1299932,5.48,181.26,186.74
2020-03-25 20:00:00+08,0,18,18,0,1520784,1520784,5.48,239.64,245.12
2020-03-26 00:00:00+08,0,20,20,0,1728566,1728566,5.44,312.46,317.9
2020-03-26 04:00:00+08,0,18,18,0,1567464,1567464,5.44,335.94,341.38
2020-03-26 08:00:00+08,0,14,14,0,1329288,1329288,5.44,337.52,342.96
2020-03-26 12:00:00+08,0,12,12,0,1031304,1031304,5.44,292.72,298.16
2020-03-26 16:00:00+08,0,8,8,0,782094,782094,5.44,228.9,234.34
2020-03-26 20:00:00+08,0,16,16,0,1497598,1497598,5.44,268.94,274.38
2020-03-27 00:00:00+08,0,14,14,0,1217116,1217116,5.44,233.98,239.42
2020-03-27 04:00:00+08,0,14,14,0,1217116,1217116,5.44,289.98,295.42
2020-03-27 08:00:00+08,0,12,12,0,930220,930220,0,185.32,185.32
2020-03-27 12:00:00+08,0,8,8,0,739950,739950,0,116.18,116.18
2020-03-27 16:00:00+08,0,8,8,0,739950,739950,0,148.18,148.18
2020-03-27 20:00:00+08,0,16,16,0,1597932,1597932,0,197.44,197.44
2020-03-28 00:00:00+08,0,16,16,0,1597932,1597932,0,261.44,261.44
2020-03-28 04:00:00+08,0,16,16,0,1587614,1587614,0,261.84,261.84
2020-03-28 08:00:00+08,0,18,18,0,1794876,1794876,0,331.7,331.7
2020-03-28 12:00:00+08,0,14,14,0,1496830,1496830,0,284.8,284.8
2020-03-28 16:00:00+08,0,10,10,0,1158844,1158844,0,182.26,182.26
2020-03-28 20:00:00+08,0,12,12,0,1152162,1152162,0,194.48,194.48
2020-03-29 00:00:00+08,0,8,8,0,713426,713426,0,122.82,122.82
2020-03-29 04:00:00+08,0,8,8,0,713426,713426,0,154.82,154.82
2020-03-29 08:00:00+08,0,8,8,0,851766,851766,0,164.36,164.36
2020-03-29 12:00:00+08,0,8,8,0,851766,851766,0,196.36,196.36
2020-03-29 16:00:00+08,0,8,8,0,851766,851766,0,228.36,228.36
2020-03-29 20:00:00+08,0,8,8,0,690442,690442,0,112.18,112.18
2020-03-30 00:00:00+08,0,8,8,0,690442,690442,0,144.18,144.18
2020-03-30 04:00:00+08,0,8,8,0,658416,658416,0,87.58,87.58
2020-03-30 08:00:00+08,0,10,10,0,759480,759480,0,127.38,127.38
2020-03-30 12:00:00+08,0,10,10,0,759480,759480,0,167.38,167.38
2020-03-30 16:00:00+08,0,10,10,0,759480,759480,0,207.38,207.38
2020-03-30 20:00:00+08,0,12,12,0,793862,793862,0,251.22,251.22
2020-03-31 00:00:00+08,0,12,12,0,877468,877468,0,243.88,243.88
2020-03-31 04:00:00+08,2,8,10,277814,700316,978130,2.74,133.02,135.76
2020-03-31 08:00:00+08,2,10,12,277814,767634,1045448,10.74,118.7,129.44
2020-03-31 12:00:00+08,2,10,12,277814,767634,1045448,18.74,158.7,177.44
2020-03-31 16:00:00+08,2,12,14,277814,984232,1262046,26.74,202.82,229.56
2020-03-31 20:00:00+08,2,14,16,277814,1142520,1420334,34.74,132.18,166.92
2020-04-01 00:00:00+08,0,12,12,0,942514,942514,0,137.98,137.98
2020-04-01 04:00:00+08,0,14,14,0,1256798,1256798,50.72,144.12,194.84
2020-04-01 08:00:00+08,0,16,16,0,1228208,1228208,50.72,147.62,198.34
2020-04-01 12:00:00+08,0,14,14,0,1011610,1011610,50.72,167.5,218.22
2020-04-01 16:00:00+08,0,14,14,0,1011610,1011610,50.72,223.5,274.22
2020-04-01 20:00:00+08,0,12,12,0,931182,931182,50.72,179.58,230.3
2020-04-02 00:00:00+08,0,14,14,0,983224,983224,50.72,228.4,279.12
2020-04-02 04:00:00+08,0,12,12,0,846972,846972,50.72,231.92,282.64
2020-04-02 08:00:00+08,2,12,14,254894,997772,1252666,52.18,208.92,261.1
2020-04-02 12:00:00+08,0,8,8,0,875706,875706,8.1,107.46,115.56
2020-04-02 16:00:00+08,0,6,6,0,713212,713212,8.1,70.92,79.02
2020-04-02 20:00:00+08,0,4,4,0,474894,474894,8.12,45.16,53.28
2020-04-03 00:00:00+08,0,8,8,0,665494,665494,8.12,64.16,72.28
2020-04-03 04:00:00+08,0,8,8,0,665494,665494,8.12,96.16,104.28
2020-04-03 08:00:00+08,0,10,10,0,811294,811294,8.12,133.66,141.78
2020-04-03 12:00:00+08,0,12,12,0,1018630,1018630,8.1,176.7,184.8
2020-04-03 16:00:00+08,0,12,12,0,1018630,1018630,8.1,224.7,232.8
2020-04-03 20:00:00+08,2,16,18,126800,1201380,1328180,9.84,165.26,175.1
2020-04-04 00:00:00+08,0,18,18,0,1328180,1328180,15.1,232,247.1
2020-04-04 04:00:00+08,0,20,20,0,1533526,1533526,15.12,297.38,312.5
2020-04-04 08:00:00+08,0,20,20,0,1533526,1533526,15.12,377.38,392.5
2020-04-04 12:00:00+08,0,18,18,0,1387726,1387726,15.1,395.88,410.98
2020-04-04 16:00:00+08,0,14,14,0,1279504,1279504,8.12,296.98,305.1
2020-04-04 20:00:00+08,0,14,14,0,1276410,1276410,0,190.68,190.68
2020-04-05 00:00:00+08,0,12,12,0,1193904,1193904,0,189.26,189.26
2020-04-05 04:00:00+08,0,10,10,0,1079264,1079264,0,181.84,181.84
2020-04-05 08:00:00+08,0,8,8,0,875628,875628,0,147.48,147.48
2020-04-05 12:00:00+08,0,8,8,0,875628,875628,0,179.48,179.48
2020-04-05 16:00:00+08,0,10,10,0,1105946,1105946,0,212.92,212.92
2020-04-05 20:00:00+08,0,12,12,0,916026,916026,0,202.1,202.1
2020-04-06 00:00:00+08,0,14,14,0,1096802,1096802,0,251.3,251.3
2020-04-06 04:00:00+08,0,8,8,0,832270,832270,0,166.64,166.64
2020-04-06 08:00:00+08,0,4,4,0,411094,411094,0,50.64,50.64
2020-04-06 12:00:00+08,0,4,4,0,411094,411094,0,66.64,66.64
2020-04-06 16:00:00+08,0,4,4,0,411094,411094,0,82.64,82.64
2020-04-06 20:00:00+08,0,6,6,0,631094,631094,0,103.56,103.56
2020-04-07 00:00:00+08,4,8,12,354294,732158,1086452,9.6,129.32,138.92
2020-04-07 04:00:00+08,2,8,10,136252,732158,868410,15.08,161.32,176.4
2020-04-07 08:00:00+08,2,10,12,136252,950200,1086452,37.32,197.52,234.84
2020-04-07 12:00:00+08,2,10,12,136252,766558,902810,45.36,148.94,194.3
2020-04-07 16:00:00+08,2,8,10,136252,585782,722034,53.36,107.74,161.1
2020-04-07 20:00:00+08,2,10,12,136252,720392,856644,61.36,52.6,113.96
2020-04-08 00:00:00+08,2,14,16,136252,852908,989160,69.34,98.98,168.32
2020-04-08 04:00:00+08,2,14,16,136252,852908,989160,77.34,154.98,232.32
2020-04-08 08:00:00+08,2,18,20,136252,1259296,1395548,85.34,219.38,304.72
2020-04-08 12:00:00+08,2,14,16,136252,1042418,1178670,93.34,230.74,324.08
2020-04-08 16:00:00+08,2,12,14,136252,918004,1054256,101.34,243.24,344.58
2020-04-08 20:00:00+08,2,18,20,136252,1375420,1511672,109.34,300.6,409.94
2020-04-09 00:00:00+08,2,14,16,136252,995668,1131920,103.06,228.94,332
2020-04-09 04:00:00+08,4,14,18,339316,1190824,1530140,118.68,272.1,390.78
2020-04-09 08:00:00+08,4,12,16,339316,1296384,1635700,146.14,175.04,321.18
2020-04-09 12:00:00+08,4,10,14,339316,1137550,1476866,162.14,162.88,325.02
2020-04-09 16:00:00+08,2,10,12,203064,1137550,1340614,43.08,202.88,245.96
2020-04-09 20:00:00+08,2,14,16,203064,1493802,1696866,189.6,252.02,441.62
2020-04-10 00:00:00+08,2,14,16,131780,1615942,1747722,156.06,253.98,410.04
2020-04-10 04:00:00+08,4,12,16,323986,1351982,1675968,226.24,151.22,377.46
2020-04-10 08:00:00+08,4,12,16,323986,1351982,1675968,242.24,199.22,441.46
2020-04-10 12:00:00+08,4,10,14,323986,1089914,1413900,258.16,176.12,434.28
2020-04-10 16:00:00+08,4,12,16,323986,1225348,1549334,274.16,221.26,495.42
2020-04-10 20:00:00+08,2,16,18,131780,1649170,1780950,250.9,276.58,527.48
2020-04-11 00:00:00+08,0,16,16,0,1498592,1498592,237.3,204.16,441.46
2020-04-11 04:00:00+08,0,18,18,0,1766954,1766954,98.7,207.98,306.68
2020-04-11 08:00:00+08,0,20,20,0,1898734,1898734,160.78,287.9,448.68
2020-04-11 12:00:00+08,0,22,22,0,2105868,2105868,160.76,372.48,533.24
2020-04-11 16:00:00+08,0,22,22,0,2157516,2157516,160.8,411.84,572.64
2020-04-11 20:00:00+08,0,18,18,0,1896440,1896440,117.06,372.42,489.48
2020-04-12 00:00:00+08,0,20,20,0,2211074,2211074,117.04,343.8,460.84
2020-04-12 04:00:00+08,2,20,22,53622,2211074,2264696,118.82,423.8,542.62
2020-04-12 08:00:00+08,2,18,20,53622,2079294,2132916,64.68,447.9,512.58
2020-04-12 12:00:00+08,4,16,20,285022,1786120,2071142,73.7,395.76,469.46
2020-04-12 16:00:00+08,4,16,20,285022,1786120,2071142,89.7,459.76,549.46
2020-04-12 20:00:00+08,4,10,14,285022,1188638,1473660,50.84,293.42,344.26
2020-04-13 00:00:00+08,4,8,12,285022,910824,1195846,66.84,239.1,305.94
2020-04-13 04:00:00+08,4,8,12,285022,910824,1195846,82.84,271.1,353.94
2020-04-13 08:00:00+08,4,8,12,285022,910824,1195846,98.84,303.1,401.94
2020-04-13 12:00:00+08,6,8,14,321578,910824,1232402,121.78,335.1,456.88
2020-04-13 16:00:00+08,2,8,10,231400,910824,1142224,57.06,367.1,424.16
2020-04-13 20:00:00+08,2,16,18,231400,1204110,1435510,162.08,412.18,574.26
2020-04-14 00:00:00+08,0,16,16,0,1204110,1204110,97.02,476.18,573.2
2020-04-14 04:00:00+08,0,16,16,0,1204110,1204110,97.02,540.18,637.2
2020-04-14 08:00:00+08,0,16,16,0,1204110,1204110,97.02,604.18,701.2
2020-04-14 12:00:00+08,0,12,12,0,874068,874068,97.02,485.5,582.52
2020-04-14 16:00:00+08,0,10,10,0,837512,837512,78.52,489.08,567.6
2020-04-14 20:00:00+08,0,18,18,0,1294718,1294718,78.48,390.66,469.14
2020-04-15 00:00:00+08,0,20,20,0,1526118,1526118,193.68,468.52,662.2
2020-04-15 04:00:00+08,0,16,16,0,1392296,1392296,115.2,413.96,529.16
2020-04-15 08:00:00+08,2,18,20,293296,1443616,1736912,119.32,317.8,437.12
2020-04-15 12:00:00+08,2,16,18,293296,1383344,1676640,127.32,356.5,483.82
2020-04-15 16:00:00+08,2,14,16,293296,1211724,1505020,135.32,379.44,514.76
2020-04-15 20:00:00+08,2,18,20,293296,1371114,1664410,143.32,391.94,535.26
2020-04-16 00:00:00+08,0,16,16,0,1076318,1076318,115.2,215.96,331.16
2020-04-16 04:00:00+08,2,16,18,210014,1138214,1348228,38.26,224.86,263.12
2020-04-16 08:00:00+08,2,12,14,210014,1128462,1338476,46.28,122.14,168.42
2020-04-16 12:00:00+08,2,10,12,210014,965308,1175322,54.28,110.26,164.54
2020-04-16 16:00:00+08,2,10,12,210014,965308,1175322,62.28,150.26,212.54
2020-04-16 20:00:00+08,2,8,10,210014,765724,975738,70.28,123.92,194.2
2020-04-17 00:00:00+08,4,6,10,334428,605266,939694,83.7,96.86,180.56
2020-04-17 04:00:00+08,4,10,14,334428,946884,1281312,99.72,132.54,232.26
2020-04-17 08:00:00+08,4,14,18,334428,1452204,1786632,115.7,182.08,297.78
2020-04-17 12:00:00+08,6,12,18,490320,1345956,1836276,139.48,201.2,340.68
2020-04-17 16:00:00+08,6,12,18,490320,1345956,1836276,163.48,249.2,412.68
2020-04-17 20:00:00+08,8,16,24,573500,1826336,2399836,194.42,232.98,427.4
2020-04-18 00:00:00+08,8,18,26,573500,2114622,2688122,226.46,297.9,524.36
2020-04-18 04:00:00+08,8,18,26,573500,2114622,2688122,258.46,369.9,628.36
2020-04-18 08:00:00+08,10,16,26,657472,1857246,2514718,293.52,333.06,626.58
2020-04-18 12:00:00+08,10,16,26,657472,1821560,2479032,333.54,366.5,700.04
2020-04-18 16:00:00+08,10,16,26,657472,1819304,2476776,336.18,305.7,641.88
2020-04-18 20:00:00+08,10,12,22,657472,1437078,2094550,376.2,206.7,582.9
2020-04-19 00:00:00+08,8,12,20,533058,1437078,1970136,314.82,254.7,569.52
2020-04-19 04:00:00+08,6,14,20,323044,1561492,1884536,307.1,306.9,614
2020-04-19 08:00:00+08,6,18,24,323044,1969472,2292516,483.14,299.24,782.38
2020-04-19 12:00:00+08,6,16,22,323044,1762136,2085180,507.18,309.76,816.94
2020-04-19 16:00:00+08,6,16,22,323044,1762136,2085180,531.18,373.76,904.94
2020-04-19 20:00:00+08,4,20,24,167152,2040164,2207316,435.44,380.82,816.26
2020-04-20 00:00:00+08,4,24,28,167152,2244194,2411346,573.66,406.92,980.58
2020-04-20 04:00:00+08,2,24,26,83972,2244194,2328166,470.74,502.92,973.66
2020-04-20 08:00:00+08,2,20,22,83972,1778676,1862648,498,387.88,885.88
2020-04-20 12:00:00+08,2,20,22,83972,1778676,1862648,506,467.88,973.88
2020-04-20 16:00:00+08,2,14,16,83972,1175652,1259624,391.64,312.72,704.36
2020-04-20 20:00:00+08,2,10,12,83972,783204,867176,399.62,201.08,600.7
2020-04-21 00:00:00+08,4,10,14,168338,747352,915690,284.28,206.84,491.12
2020-04-21 04:00:00+08,4,14,18,168338,1048538,1216876,300.32,259.28,559.6
2020-04-21 08:00:00+08,4,12,16,168338,850104,1018442,316.28,214.38,530.66
2020-04-21 12:00:00+08,2,12,14,83972,850104,934076,307.18,262.38,569.56
2020-04-21 16:00:00+08,2,8,10,83972,402462,486434,163.14,112.8,275.94
2020-04-21 20:00:00+08,2,14,16,83972,869328,953300,204.66,125.88,330.54
2020-04-22 00:00:00+08,2,14,16,83972,1095672,1179644,212.66,153.22,365.88
2020-04-22 04:00:00+08,4,14,18,167138,1095672,1262810,221.56,209.22,430.78
2020-04-22 08:00:00+08,4,12,16,167138,932052,1099190,237.56,181.16,418.72
2020-04-22 12:00:00+08,4,10,14,167138,847686,1014824,220.04,189.58,409.62
2020-04-22 16:00:00+08,2,6,8,83166,587268,670434,24.9,139.82,164.72
2020-04-22 20:00:00+08,2,12,14,83166,1061950,1145116,248.24,174.08,422.32
2020-04-23 00:00:00+08,2,12,14,83166,1061950,1145116,256.24,222.08,478.32
2020-04-23 04:00:00+08,4,12,16,311094,1061950,1373044,269.22,270.08,539.3
2020-04-23 08:00:00+08,6,10,16,505576,992750,1498326,293.14,206.74,499.88
2020-04-23 12:00:00+08,6,14,20,505576,1471454,1977030,317.14,258.8,575.94
2020-04-23 16:00:00+08,4,10,14,277648,1200392,1478040,96.82,228.34,325.16
2020-04-23 20:00:00+08,4,16,20,277648,1646368,1924016,146.36,205.66,352.02
2020-04-24 00:00:00+08,2,16,18,83166,1646368,1729534,122.42,269.66,392.08
2020-04-24 04:00:00+08,2,16,18,83166,1560558,1643724,172.34,228.32,400.66
2020-04-24 08:00:00+08,2,16,18,83166,1560558,1643724,180.34,292.32,472.66
2020-04-24 12:00:00+08,2,14,16,83166,1442244,1525410,188.34,240.66,429
2020-04-24 16:00:00+08,0,12,12,0,1319336,1319336,75.46,254.1,329.56
2020-04-24 20:00:00+08,0,14,14,0,1300684,1300684,202.86,165.14,368
2020-04-25 00:00:00+08,0,16,16,0,1354306,1354306,202.88,224.44,427.32
2020-04-25 04:00:00+08,0,16,16,0,1354306,1354306,202.88,288.44,491.32
2020-04-25 08:00:00+08,0,18,18,0,1435254,1435254,202.92,285.58,488.5
2020-04-25 12:00:00+08,0,18,18,0,1435254,1435254,202.92,357.58,560.5
2020-04-25 16:00:00+08,0,16,16,0,1232504,1232504,169.38,280.48,449.86
2020-04-25 20:00:00+08,0,12,12,0,1029652,1029652,41.88,162.94,204.82
2020-04-26 00:00:00+08,0,10,10,0,897752,897752,41.88,174.82,216.7
2020-04-26 04:00:00+08,0,8,8,0,703270,703270,0,112.8,112.8
2020-04-26 08:00:00+08,0,6,6,0,668088,668088,0,69.96,69.96
2020-04-26 12:00:00+08,0,6,6,0,668088,668088,0,93.96,93.96
2020-04-26 16:00:00+08,0,6,6,0,668088,668088,0,117.96,117.96
2020-04-26 20:00:00+08,0,18,18,0,1688096,1688096,0,162,162
2020-04-27 00:00:00+08,0,18,18,0,1688096,1688096,0,234,234
2020-04-27 04:00:00+08,0,16,16,0,1456110,1456110,0,236.54,236.54
2020-04-27 08:00:00+08,0,12,12,0,1185858,1185858,0,191.14,191.14
2020-04-27 12:00:00+08,0,10,10,0,983458,983458,0,177.88,177.88
2020-04-27 16:00:00+08,0,8,8,0,882200,882200,0,174.9,174.9
2020-04-27 20:00:00+08,0,8,8,0,882200,882200,0,206.9,206.9
2020-04-28 00:00:00+08,0,12,12,0,1414766,1414766,0,248.02,248.02
2020-04-28 04:00:00+08,0,14,14,0,1540754,1540754,0,301.4,301.4
2020-04-28 08:00:00+08,0,12,12,0,1232122,1232122,0,208.98,208.98
2020-04-28 12:00:00+08,0,12,12,0,1170626,1170626,0,178.82,178.82
2020-04-28 16:00:00+08,0,10,10,0,1044638,1044638,0,197.46,197.46
2020-04-28 20:00:00+08,0,16,16,0,1616064,1616064,0,217.6,217.6
2020-04-29 00:00:00+08,0,18,18,0,1904184,1904184,0,287.48,287.48
2020-04-29 04:00:00+08,0,20,20,0,1838120,1838120,0,304.08,304.08
2020-04-29 08:00:00+08,0,14,14,0,1304072,1304072,0,210.58,210.58
2020-04-29 12:00:00+08,0,10,10,0,919748,919748,0,139.02,139.02
2020-04-29 16:00:00+08,0,12,12,0,1210788,1210788,0,182.36,182.36
2020-04-29 20:00:00+08,0,10,10,0,859210,859210,0,133,133
2020-04-30 00:00:00+08,2,10,12,171426,859210,1030636,0.4,173,173.4
2020-04-30 04:00:00+08,0,12,12,0,1090610,1090610,0,219.04,219.04
2020-04-30 08:00:00+08,0,12,12,0,1397314,1397314,10.64,133.22,143.86
2020-04-30 12:00:00+08,0,12,12,0,1397314,1397314,10.64,181.22,191.86
2020-04-30 16:00:00+08,0,12,12,0,1397314,1397314,10.64,229.22,239.86
2020-04-30 20:00:00+08,0,16,16,0,1639226,1639226,10.64,285.22,295.86
2020-05-01 00:00:00+08,0,16,16,0,1639226,1639226,10.64,349.22,359.86
2020-05-01 04:00:00+08,2,16,18,67382,1639226,1706608,16.44,413.22,429.66
2020-05-01 08:00:00+08,2,16,18,67382,1639226,1706608,24.44,477.22,501.66
2020-05-01 12:00:00+08,2,12,14,67382,1323130,1390512,32.44,443.52,475.96
2020-05-01 16:00:00+08,2,8,10,67382,743970,811352,40.44,258.32,298.76
2020-05-01 20:00:00+08,2,10,12,67382,869958,937340,48.44,294.64,343.08
2020-05-02 00:00:00+08,2,10,12,67382,707084,774466,56.46,243.2,299.66
2020-05-02 04:00:00+08,2,8,10,67382,499538,566920,64.46,192.42,256.88
2020-05-02 08:00:00+08,2,10,12,198132,845548,1043680,12.54,157.58,170.12
2020-05-02 12:00:00+08,2,8,10,198132,615516,813648,73.78,57.42,131.2
2020-05-02 16:00:00+08,2,8,10,198132,615516,813648,81.78,89.42,171.2
2020-05-02 20:00:00+08,2,8,10,198132,716366,914498,89.8,84.38,174.18
2020-05-03 00:00:00+08,2,10,12,198132,925566,1123698,97.8,117.84,215.64
2020-05-03 04:00:00+08,2,8,10,198132,858184,1056316,41.9,119.94,161.84
2020-05-03 08:00:00+08,2,8,10,198132,634386,832518,49.9,106.28,156.18
2020-05-03 12:00:00+08,2,4,6,198132,277830,475962,57.88,40.36,98.24
2020-05-03 16:00:00+08,0,4,4,0,277830,277830,0,56.36,56.36
2020-05-03 20:00:00+08,0,10,10,0,771378,771378,70.76,57.8,128.56
2020-05-04 00:00:00+08,0,10,10,0,771378,771378,70.76,97.8,168.56
2020-05-04 04:00:00+08,0,10,10,0,855360,855360,70.76,87.58,158.34
2020-05-04 08:00:00+08,0,10,10,0,1050790,1050790,70.76,104.08,174.84
2020-05-04 12:00:00+08,0,12,12,0,1258126,1258126,70.76,149.26,220.02
2020-05-04 16:00:00+08,0,12,12,0,1258126,1258126,70.76,197.26,268.02
2020-05-04 20:00:00+08,0,12,12,0,1277978,1277978,70.76,198,268.76
2020-05-05 00:00:00+08,0,8,8,0,868756,868756,0,124.46,124.46
2020-05-05 04:00:00+08,0,12,12,0,1148070,1148070,0,171.68,171.68
2020-05-05 08:00:00+08,0,14,14,0,1202120,1202120,0,223.3,223.3
2020-05-05 12:00:00+08,0,12,12,0,1154792,1154792,0,255.68,255.68
2020-05-05 16:00:00+08,0,8,8,0,811204,811204,0,198.9,198.9
2020-05-05 20:00:00+08,0,6,6,0,702506,702506,0,131.04,131.04
2020-05-06 00:00:00+08,0,10,10,0,1064746,1064746,0,170.34,170.34
2020-05-06 04:00:00+08,0,12,12,0,1357928,1357928,0,214.1,214.1
2020-05-06 08:00:00+08,0,12,12,0,1139328,1139328,0,92.2,92.2
2020-05-06 12:00:00+08,0,10,10,0,930532,930532,0,75.18,75.18
2020-05-06 16:00:00+08,0,10,10,0,930532,930532,0,115.18,115.18
2020-05-06 20:00:00+08,0,10,10,0,930532,930532,0,155.18,155.18
2020-05-07 00:00:00+08,2,10,12,219264,930532,1149796,4.72,195.18,199.9
2020-05-07 04:00:00+08,0,12,12,0,1089780,1089780,0,205.14,205.14
2020-05-07 08:00:00+08,0,16,16,0,1435134,1435134,25.2,214.8,240
2020-05-07 12:00:00+08,0,12,12,0,1010182,1010182,25.2,140.74,165.94
2020-05-07 16:00:00+08,0,12,12,0,1010182,1010182,25.2,188.74,213.94
2020-05-07 20:00:00+08,0,14,14,0,1116430,1116430,25.2,241.32,266.52
2020-05-08 00:00:00+08,0,12,12,0,1047840,1047840,25.2,252.84,278.04
2020-05-08 04:00:00+08,0,10,10,0,888858,888858,25.2,252.22,277.42
2020-05-08 08:00:00+08,0,14,14,0,1325132,1325132,25.2,304.04,329.24
2020-05-08 12:00:00+08,0,10,10,0,1150494,1150494,17.96,262.22,280.18
2020-05-08 16:00:00+08,0,8,8,0,857312,857312,17.96,178.46,196.42
2020-05-08 20:00:00+08,0,14,14,0,1447164,1447164,17.96,222.66,240.62
2020-05-09 00:00:00+08,0,16,16,0,1561804,1561804,17.96,281.26,299.22
2020-05-09 04:00:00+08,0,16,16,0,1427412,1427412,17.98,258.04,276.02
2020-05-09 08:00:00+08,0,16,16,0,1415484,1415484,0,226.38,226.38
2020-05-09 12:00:00+08,0,14,14,0,1242582,1242582,0,219.46,219.46
2020-05-09 16:00:00+08,2,14,16,53622,1242582,1296204,3.26,275.46,278.72
2020-05-09 20:00:00+08,2,16,18,53622,1474568,1528190,11.26,338.08,349.34
2020-05-10 00:00:00+08,2,10,12,53622,1146746,1200368,19.24,220.36,239.6
2020-05-10 04:00:00+08,2,14,16,53622,1451750,1505372,27.24,268.96,296.2
2020-05-10 08:00:00+08,2,14,16,53622,1451750,1505372,35.24,324.96,360.2
2020-05-10 12:00:00+08,2,10,12,53622,1121506,1175128,43.24,271.02,314.26
2020-05-10 16:00:00+08,2,8,10,53622,831032,884654,51.24,193.66,244.9
2020-05-10 20:00:00+08,2,12,14,53622,1285124,1338746,59.24,144.9,204.14
2020-05-11 00:00:00+08,2,14,16,53622,1549194,1602816,67.24,194.82,262.06
2020-05-11 04:00:00+08,2,14,16,53622,1520730,1574352,75.24,138.76,214
2020-05-11 08:00:00+08,2,12,14,53622,1486348,1539970,83.24,166.96,250.2
2020-05-11 12:00:00+08,2,12,14,53622,1486348,1539970,91.24,214.96,306.2
2020-05-11 16:00:00+08,0,12,12,0,1678600,1678600,0,226.14,226.14
2020-05-11 20:00:00+08,0,10,10,0,1457838,1457838,0,193.2,193.2
2020-05-12 00:00:00+08,0,14,14,0,1635874,1635874,107.64,244.28,351.92
2020-05-12 04:00:00+08,0,12,12,0,1371804,1371804,107.64,242.4,350.04
2020-05-12 08:00:00+08,0,10,10,0,1067118,1067118,107.64,214.32,321.96
2020-05-12 12:00:00+08,0,8,8,0,942704,942704,107.64,226.84,334.48
2020-05-12 16:00:00+08,0,6,6,0,889082,889082,0,219.24,219.24
2020-05-12 20:00:00+08,0,10,10,0,1090198,1090198,0,167.9,167.9
2020-05-13 00:00:00+08,0,14,14,0,1352650,1352650,0,113.86,113.86
2020-05-13 04:00:00+08,0,14,14,0,1352650,1352650,0,169.86,169.86
2020-05-13 08:00:00+08,2,18,20,207218,1719474,1926692,5.4,235.84,241.24
2020-05-13 12:00:00+08,2,16,18,207218,1549908,1757126,13.4,275.68,289.08
2020-05-13 16:00:00+08,0,14,14,0,1403198,1403198,0,305.48,305.48
2020-05-13 20:00:00+08,0,18,18,0,1539958,1539958,25.92,297.08,323
2020-05-14 00:00:00+08,0,18,18,0,1539958,1539958,25.92,369.08,395
2020-05-14 04:00:00+08,0,16,16,0,1312030,1312030,25.92,373.68,399.6
2020-05-14 08:00:00+08,0,12,12,0,1368300,1368300,25.92,312.32,338.24
2020-05-14 12:00:00+08,0,10,10,0,1075872,1075872,25.92,220.82,246.74
2020-05-14 16:00:00+08,0,12,12,0,1307858,1307858,25.92,263.52,289.44
2020-05-14 20:00:00+08,0,14,14,0,1235844,1235844,25.92,151.74,177.66
2020-05-15 00:00:00+08,0,14,14,0,1235844,1235844,25.92,207.74,233.66
2020-05-15 04:00:00+08,0,10,10,0,857592,857592,0,129.96,129.96
2020-05-15 08:00:00+08,0,14,14,0,1453400,1453400,0,181.6,181.6
2020-05-15 12:00:00+08,0,12,12,0,1330182,1330182,0,201.52,201.52
2020-05-15 16:00:00+08,0,8,8,0,961944,961944,0,154.66,154.66
2020-05-15 20:00:00+08,0,14,14,0,1475142,1475142,0,125.42,125.42
2020-05-16 00:00:00+08,0,14,14,0,1605656,1605656,0,126.94,126.94
2020-05-16 04:00:00+08,0,14,14,0,1605656,1605656,0,182.94,182.94
2020-05-16 08:00:00+08,0,12,12,0,1395918,1395918,0,161.28,161.28
2020-05-16 12:00:00+08,0,10,10,0,1206958,1206958,0,173.54,173.54
2020-05-16 16:00:00+08,0,8,8,0,902270,902270,0,143.02,143.02
2020-05-16 20:00:00+08,0,8,8,0,902270,902270,0,175.02,175.02
2020-05-17 00:00:00+08,0,4,4,0,500396,500396,0,89.56,89.56
2020-05-17 04:00:00+08,0,6,6,0,791762,791762,0,112.32,112.32
2020-05-17 08:00:00+08,0,8,8,0,915734,915734,0,141.08,141.08
2020-05-17 12:00:00+08,0,8,8,0,915734,915734,0,173.08,173.08
2020-05-17 16:00:00+08,0,8,8,0,915734,915734,0,205.08,205.08
2020-05-17 20:00:00+08,0,10,10,0,914712,914712,0,143.88,143.88
2020-05-18 00:00:00+08,0,12,12,0,957564,957564,0,87.54,87.54
2020-05-18 04:00:00+08,0,12,12,0,957564,957564,0,135.54,135.54
2020-05-18 08:00:00+08,0,10,10,0,921014,921014,0,155.76,155.76
2020-05-18 12:00:00+08,0,10,10,0,921014,921014,0,195.76,195.76
2020-05-18 16:00:00+08,0,8,8,0,854188,854188,0,192.66,192.66
2020-05-18 20:00:00+08,0,2,2,0,234472,234472,0,42.14,42.14
2020-05-19 00:00:00+08,0,4,4,0,260594,260594,0,50.54,50.54
2020-05-19 04:00:00+08,0,6,6,0,538358,538358,0,74.08,74.08
2020-05-19 08:00:00+08,0,12,12,0,810804,810804,0,109.22,109.22
2020-05-19 12:00:00+08,0,12,12,0,1075156,1075156,0,139.44,139.44
2020-05-19 16:00:00+08,0,10,10,0,840684,840684,0,105.3,105.3
2020-05-19 20:00:00+08,0,18,18,0,1574848,1574848,0,129.08,129.08
2020-05-20 00:00:00+08,2,16,18,171612,1455602,1627214,0.36,164.64,165
2020-05-20 04:00:00+08,0,18,18,0,1627214,1627214,7.2,229.88,237.08
2020-05-20 08:00:00+08,0,20,20,0,1773178,1773178,7.2,306.88,314.08
2020-05-20 12:00:00+08,0,16,16,0,1500852,1500852,7.2,293.08,300.28
2020-05-20 16:00:00+08,0,12,12,0,1053352,1053352,7.14,237.24,244.38
2020-05-20 20:00:00+08,0,16,16,0,1243172,1243172,7.14,293.12,300.26
2020-05-21 00:00:00+08,0,14,14,0,1039078,1039078,7.14,291.96,299.1
2020-05-21 04:00:00+08,0,12,12,0,880512,880512,7.16,281.28,288.44
2020-05-21 08:00:00+08,0,8,8,0,775166,775166,7.16,180.66,187.82
2020-05-21 12:00:00+08,0,4,4,0,313080,313080,0,44.84,44.84
2020-05-21 16:00:00+08,0,2,2,0,232880,232880,0,22.4,22.4
2020-05-21 20:00:00+08,0,8,8,0,623598,623598,0,40.42,40.42
2020-05-22 00:00:00+08,0,8,8,0,623598,623598,0,72.42,72.42
2020-05-22 04:00:00+08,0,8,8,0,623598,623598,0,104.42,104.42
2020-05-22 08:00:00+08,0,6,6,0,479350,479350,0,61.38,61.38
2020-05-22 12:00:00+08,0,8,8,0,772742,772742,0,88.8,88.8
2020-05-22 16:00:00+08,0,4,4,0,500728,500728,0,34.4,34.4
2020-05-22 20:00:00+08,0,6,6,0,627518,627518,0,53.48,53.48
2020-05-23 00:00:00+08,0,10,10,0,795780,795780,0,83.58,83.58
2020-05-23 04:00:00+08,0,16,16,0,1212684,1212684,0,134.04,134.04
2020-05-23 08:00:00+08,0,20,20,0,1542928,1542928,0,208.58,208.58
2020-05-23 12:00:00+08,0,14,14,0,1155180,1155180,0,163.72,163.72
2020-05-23 16:00:00+08,0,14,14,0,1155180,1155180,0,219.72,219.72
2020-05-23 20:00:00+08,0,16,16,0,1485522,1485522,0,281.74,281.74
2020-05-24 00:00:00+08,0,12,12,0,1077490,1077490,0,219.08,219.08
2020-05-24 04:00:00+08,2,8,10,36556,996088,1032644,2.58,122.54,125.12
2020-05-24 08:00:00+08,2,8,10,36556,996088,1032644,10.58,154.54,165.12
2020-05-24 12:00:00+08,2,4,6,36556,556766,593322,18.58,58.74,77.32
2020-05-24 16:00:00+08,0,4,4,0,556766,556766,0,74.74,74.74
2020-05-24 20:00:00+08,0,10,10,0,865324,865324,30.52,102.32,132.84
2020-05-25 00:00:00+08,0,12,12,0,1073014,1073014,30.52,145.18,175.7
2020-05-25 04:00:00+08,0,12,12,0,1073014,1073014,30.52,193.18,223.7
2020-05-25 08:00:00+08,0,12,12,0,1250572,1250572,30.5,217.64,248.14
2020-05-25 12:00:00+08,0,10,10,0,1214016,1214016,0,229.56,229.56
2020-05-25 16:00:00+08,0,8,8,0,987592,987592,0,192.86,192.86
2020-05-25 20:00:00+08,0,12,12,0,1237406,1237406,0,232.06,232.06
2020-05-26 00:00:00+08,0,8,8,0,699374,699374,0,119.16,119.16
2020-05-26 04:00:00+08,0,6,6,0,495738,495738,0,82.76,82.76
2020-05-26 08:00:00+08,2,6,8,161102,417060,578162,1.1,82.74,83.84
2020-05-26 12:00:00+08,2,6,8,161102,417060,578162,9.1,106.74,115.84
2020-05-26 16:00:00+08,2,8,10,161102,708180,869282,17.1,136.42,153.52
2020-05-26 20:00:00+08,0,8,8,0,708180,708180,0,168.42,168.42
2020-05-27 00:00:00+08,0,6,6,0,563170,563170,0,105.82,105.82
2020-05-27 04:00:00+08,0,10,10,0,708382,708382,37.56,56.48,94.04
2020-05-27 08:00:00+08,0,12,12,0,879610,879610,37.56,101.08,138.64
2020-05-27 12:00:00+08,0,12,12,0,879610,879610,37.56,149.08,186.64
2020-05-27 16:00:00+08,0,10,10,0,853484,853484,37.56,164.5,202.06
2020-05-27 20:00:00+08,0,10,10,0,853484,853484,37.56,204.5,242.06
2020-05-28 00:00:00+08,0,10,10,0,863414,863414,37.56,199.44,237
2020-05-28 04:00:00+08,0,12,12,0,1151714,1151714,37.56,245.16,282.72
2020-05-28 08:00:00+08,0,16,16,0,1666082,1666082,37.56,243.9,281.46
2020-05-28 12:00:00+08,0,14,14,0,1494854,1494854,37.6,247.28,284.88
2020-05-28 16:00:00+08,0,12,12,0,1333752,1333752,0,227.78,227.78
2020-05-28 20:00:00+08,0,14,14,0,1544392,1544392,0,278.8,278.8
2020-05-29 00:00:00+08,0,14,14,0,1310788,1310788,0,171,171
2020-05-29 04:00:00+08,0,16,16,0,1516300,1516300,0,230.18,230.18
2020-05-29 08:00:00+08,0,18,18,0,1722164,1722164,0,251.84,251.84
2020-05-29 12:00:00+08,0,18,18,0,1870912,1870912,0,268.66,268.66
2020-05-29 16:00:00+08,0,16,16,0,1823556,1823556,0,242.88,242.88
2020-05-29 20:00:00+08,0,18,18,0,2021214,2021214,0,273.32,273.32
2020-05-30 00:00:00+08,0,18,18,0,2021214,2021214,0,345.32,345.32
2020-05-30 04:00:00+08,0,20,20,0,2147202,2147202,0,421.78,421.78
2020-05-30 08:00:00+08,0,18,18,0,1936562,1936562,0,426.76,426.76
2020-05-30 12:00:00+08,0,16,16,0,1648262,1648262,0,381.04,381.04
2020-05-30 16:00:00+08,0,10,10,0,1052990,1052990,0,295.1,295.1
2020-05-30 20:00:00+08,0,10,10,0,981140,981140,0,109.74,109.74
2020-05-31 00:00:00+08,0,12,12,0,1064306,1064306,0,151.84,151.84
2020-05-31 04:00:00+08,0,10,10,0,938318,938318,0,147.38,147.38
2020-05-31 08:00:00+08,2,10,12,34382,938318,972700,0.34,187.38,187.72
2020-05-31 12:00:00+08,2,6,8,34382,732286,766668,8.32,163.62,171.94
2020-05-31 16:00:00+08,0,6,6,0,732286,732286,0,187.62,187.62
2020-05-31 20:00:00+08,0,10,10,0,982498,982498,22.66,170.4,193.06
2020-06-01 00:00:00+08,0,14,14,0,1275768,1275768,22.66,212.16,234.82
2020-06-01 04:00:00+08,2,12,14,53300,994494,1047794,25.62,144.26,169.88
2020-06-01 08:00:00+08,2,10,12,53300,960112,1013412,10.94,166.6,177.54
2020-06-01 12:00:00+08,2,8,10,53300,718404,771704,18.94,121.44,140.38
2020-06-01 16:00:00+08,2,8,10,53300,718404,771704,26.94,153.44,180.38
2020-06-01 20:00:00+08,2,8,10,53300,763140,816440,34.94,149.18,184.12
2020-06-02 00:00:00+08,0,12,12,0,842562,842562,42.28,182.1,224.38
2020-06-02 04:00:00+08,0,10,10,0,650356,650356,42.28,173.02,215.3
2020-06-02 08:00:00+08,0,12,12,0,710668,710668,42.24,217.78,260.02
2020-06-02 12:00:00+08,0,8,8,0,346868,346868,42.24,145.06,187.3
2020-06-02 16:00:00+08,0,4,4,0,267446,267446,0,112.12,112.12
2020-06-02 20:00:00+08,0,10,10,0,737084,737084,0,12.08,12.08
2020-06-03 00:00:00+08,0,14,14,0,1179486,1179486,0,61.74,61.74
2020-06-03 04:00:00+08,0,16,16,0,1407698,1407698,0,118.76,118.76
2020-06-03 08:00:00+08,0,18,18,0,1553662,1553662,0,187.16,187.16
2020-06-03 12:00:00+08,0,16,16,0,1382042,1382042,0,225.7,225.7
2020-06-03 16:00:00+08,0,12,12,0,1085790,1085790,0,202.94,202.94
2020-06-03 20:00:00+08,0,12,12,0,1085790,1085790,0,250.94,250.94
2020-06-04 00:00:00+08,0,12,12,0,1085790,1085790,0,298.94,298.94
2020-06-04 04:00:00+08,0,12,12,0,1168180,1168180,0,295.98,295.98
2020-06-04 08:00:00+08,0,10,10,0,984156,984156,0,202.18,202.18
2020-06-04 12:00:00+08,0,8,8,0,817580,817580,0,123.38,123.38
2020-06-04 16:00:00+08,0,8,8,0,817580,817580,0,155.38,155.38
2020-06-04 20:00:00+08,0,10,10,0,1004360,1004360,0,165.44,165.44
2020-06-05 00:00:00+08,0,10,10,0,1004360,1004360,0,205.44,205.44
2020-06-05 04:00:00+08,0,8,8,0,710968,710968,0,134.24,134.24
2020-06-05 08:00:00+08,0,10,10,0,754286,754286,0,114.28,114.28
2020-06-05 12:00:00+08,0,8,8,0,631068,631068,0,118.48,118.48
2020-06-05 16:00:00+08,0,10,10,0,924612,924612,0,151.1,151.1
2020-06-05 20:00:00+08,0,8,8,0,897738,897738,0,114.62,114.62
2020-06-06 00:00:00+08,0,8,8,0,897738,897738,0,146.62,146.62
2020-06-06 04:00:00+08,0,6,6,0,690138,690138,0,92.04,92.04
2020-06-06 08:00:00+08,0,8,8,0,871144,871144,0,74.46,74.46
2020-06-06 12:00:00+08,0,8,8,0,871144,871144,0,106.46,106.46
2020-06-06 16:00:00+08,0,6,6,0,681886,681886,0,92.3,92.3
2020-06-06 20:00:00+08,0,8,8,0,798286,798286,0,119.88,119.88
2020-06-07 00:00:00+08,0,8,8,0,893288,893288,0,115.42,115.42
2020-06-07 04:00:00+08,0,8,8,0,893288,893288,0,147.42,147.42
2020-06-07 08:00:00+08,0,8,8,0,835236,835236,0,131.94,131.94
2020-06-07 12:00:00+08,0,8,8,0,835236,835236,0,163.94,163.94
2020-06-07 16:00:00+08,0,8,8,0,835236,835236,0,195.94,195.94
2020-06-07 20:00:00+08,0,12,12,0,1193358,1193358,0,191.1,191.1
2020-06-08 00:00:00+08,0,14,14,0,1210190,1210190,0,128.08,128.08
2020-06-08 04:00:00+08,0,12,12,0,992190,992190,0,126.5,126.5
2020-06-08 08:00:00+08,0,10,10,0,955640,955640,0,145.7,145.7
2020-06-08 12:00:00+08,0,10,10,0,955640,955640,0,185.7,185.7
2020-06-08 16:00:00+08,0,10,10,0,955640,955640,0,225.7,225.7
2020-06-08 20:00:00+08,0,10,10,0,959728,959728,0,176.62,176.62
2020-06-09 00:00:00+08,2,8,10,47328,752436,799764,0.2,130.44,130.64
2020-06-09 04:00:00+08,2,8,10,47328,752436,799764,8.2,162.44,170.64
2020-06-09 08:00:00+08,2,10,12,47328,680928,728256,16.22,66.66,82.88
2020-06-09 12:00:00+08,2,8,10,47328,544676,592004,24.22,71.8,96.02
2020-06-09 16:00:00+08,2,8,10,47328,544676,592004,32.22,103.8,136.02
2020-06-09 20:00:00+08,2,8,10,47328,782300,829628,40.2,108.04,148.24
2020-06-10 00:00:00+08,2,8,10,47328,824752,872080,48.2,110.36,158.56
2020-06-10 04:00:00+08,2,12,14,47328,1327734,1375062,56.2,150.56,206.76
2020-06-10 08:00:00+08,2,12,14,47328,1287828,1335156,64.2,127.8,192
2020-06-10 12:00:00+08,2,12,14,47328,1287828,1335156,72.2,175.8,248
2020-06-10 16:00:00+08,0,10,10,0,1025420,1025420,0,154.76,154.76
2020-06-10 20:00:00+08,0,12,12,0,1072748,1072748,83.96,199,282.96
2020-06-11 00:00:00+08,0,12,12,0,1072748,1072748,83.96,247,330.96
2020-06-11 04:00:00+08,4,10,14,271294,1025420,1296714,9.6,274.76,284.36
2020-06-11 08:00:00+08,2,10,12,53622,1174514,1228136,24.84,244.84,269.68
2020-06-11 12:00:00+08,2,8,10,53622,1012020,1065642,32.84,225,257.84
2020-06-11 16:00:00+08,2,6,8,53622,720654,774276,40.84,168.92,209.76
2020-06-11 20:00:00+08,2,10,12,53622,891750,945372,48.84,123.76,172.6
2020-06-12 00:00:00+08,2,12,14,53622,1027184,1080806,56.84,165.48,222.32
2020-06-12 04:00:00+08,2,14,16,53622,1258584,1312206,64.84,220.04,284.88
2020-06-12 08:00:00+08,2,14,16,53622,1345598,1399220,62.16,227.66,289.82
2020-06-12 12:00:00+08,2,16,18,53622,1636374,1689996,70.16,287.58,357.74
2020-06-12 16:00:00+08,0,10,10,0,1108096,1108096,0,137.02,137.02
2020-06-12 20:00:00+08,0,8,8,0,880484,880484,82.36,86.66,169.02
2020-06-13 00:00:00+08,2,10,12,231400,1056570,1287970,85.3,82.28,167.58
2020-06-13 04:00:00+08,2,10,12,231400,1056570,1287970,93.3,122.28,215.58
2020-06-13 08:00:00+08,4,14,18,357800,1417148,1774948,114.82,172.06,286.88
2020-06-13 12:00:00+08,4,14,18,357800,1570862,1928662,48.42,197.22,245.64
2020-06-13 16:00:00+08,4,14,18,357800,1570862,1928662,64.42,253.22,317.64
2020-06-13 20:00:00+08,4,10,14,357800,1157178,1514978,80.46,211.22,291.68
2020-06-14 00:00:00+08,4,8,12,357800,1042538,1400338,96.44,200.24,296.68
2020-06-14 04:00:00+08,2,10,12,231400,1109920,1341320,70.8,232.58,303.38
2020-06-14 08:00:00+08,2,8,10,231400,724298,955698,121.24,138.48,259.72
2020-06-14 12:00:00+08,2,8,10,231400,724298,955698,129.24,170.48,299.72
2020-06-14 16:00:00+08,2,4,6,231400,419246,650646,125.34,110.46,235.8
2020-06-14 20:00:00+08,2,12,14,231400,945952,1177352,133.32,141.04,274.36
2020-06-15 00:00:00+08,2,14,16,231400,1133042,1364442,141.32,190.32,331.64
2020-06-15 04:00:00+08,2,12,14,231400,840196,1071596,149.32,135.1,284.42
2020-06-15 08:00:00+08,2,14,16,231400,966996,1198396,157.34,187.3,344.64
2020-06-15 12:00:00+08,2,12,14,231400,930440,1161840,165.34,208.12,373.46
2020-06-15 16:00:00+08,0,12,12,0,930440,930440,42.42,256.12,298.54
2020-06-15 20:00:00+08,0,16,16,0,1139146,1139146,173.48,269.02,442.5
2020-06-16 00:00:00+08,0,18,18,0,1164918,1164918,173.56,276.44,450
2020-06-16 04:00:00+08,0,16,16,0,977828,977828,173.56,291.16,464.72
2020-06-16 08:00:00+08,0,12,12,0,815258,815258,173.52,201.5,375.02
2020-06-16 12:00:00+08,0,10,10,0,690844,690844,173.56,213.66,387.22
2020-06-16 16:00:00+08,0,8,8,0,664722,664722,173.56,220.64,394.2
2020-06-16 20:00:00+08,0,10,10,0,1000530,1000530,173.56,217.86,391.42
2020-06-17 00:00:00+08,0,12,12,0,1117936,1117936,42.4,201.28,243.68
2020-06-17 04:00:00+08,0,12,12,0,1117936,1117936,42.4,249.28,291.68
2020-06-17 08:00:00+08,0,18,18,0,1665430,1665430,42.4,314.04,356.44
2020-06-17 12:00:00+08,0,18,18,0,1665430,1665430,42.4,386.04,428.44
2020-06-17 16:00:00+08,0,20,20,0,1872726,1872726,42.4,464.16,506.56
2020-06-17 20:00:00+08,0,20,20,0,1836236,1836236,42.4,421.88,464.28
2020-06-18 00:00:00+08,0,20,20,0,1836236,1836236,42.4,501.88,544.28
2020-06-18 04:00:00+08,0,22,22,0,2067636,2067636,42.4,589.16,631.56
2020-06-18 08:00:00+08,0,20,20,0,1996576,1996576,42.4,533.02,575.42
2020-06-18 12:00:00+08,0,16,16,0,1608002,1608002,42.4,489.04,531.44
2020-06-18 16:00:00+08,0,12,12,0,1277562,1277562,42.4,440.44,482.84
2020-06-18 20:00:00+08,0,16,16,0,1533352,1533352,42.4,448.7,491.1
2020-06-19 00:00:00+08,0,14,14,0,1252870,1252870,42.4,415.16,457.56
2020-06-19 04:00:00+08,0,12,12,0,1045574,1045574,42.4,393,435.4
2020-06-19 08:00:00+08,0,12,12,0,1118862,1118862,42.4,380.42,422.82
2020-06-19 12:00:00+08,0,14,14,0,1349180,1349180,42.4,432.68,475.08
2020-06-19 16:00:00+08,2,14,16,281218,1349180,1630398,49.18,488.68,537.86
2020-06-19 20:00:00+08,0,8,8,0,924014,924014,42.4,390.9,433.3
2020-06-20 00:00:00+08,0,12,12,0,1332032,1332032,59.24,434.28,493.52
2020-06-20 04:00:00+08,0,10,10,0,1069424,1069424,59.24,393.6,452.84
2020-06-20 08:00:00+08,0,16,16,0,1515372,1515372,59.28,448.88,508.16
2020-06-20 12:00:00+08,0,14,14,0,1285054,1285054,59.28,460.58,519.86
2020-06-20 16:00:00+08,0,14,14,0,1285054,1285054,59.28,516.58,575.86
2020-06-20 20:00:00+08,0,12,12,0,980366,980366,59.3,497.88,557.18
2020-06-21 00:00:00+08,0,8,8,0,729594,729594,59.3,455.72,515.02
2020-06-21 04:00:00+08,0,8,8,0,784496,784496,59.3,444.2,503.5
2020-06-21 08:00:00+08,0,8,8,0,757936,757936,59.3,425.16,484.46
2020-06-21 12:00:00+08,0,8,8,0,757936,757936,59.3,457.16,516.46
2020-06-21 16:00:00+08,0,8,8,0,757936,757936,59.3,489.16,548.46
2020-06-21 20:00:00+08,0,12,12,0,842530,842530,42.36,439.62,481.98
2020-06-22 00:00:00+08,0,10,10,0,672988,672988,42.36,447.1,489.46
2020-06-22 04:00:00+08,0,10,10,0,672988,672988,42.36,487.1,529.46
2020-06-22 08:00:00+08,0,14,14,0,1128028,1128028,42.36,514.96,557.32
2020-06-22 12:00:00+08,0,14,14,0,1128028,1128028,42.36,570.96,613.32
2020-06-22 16:00:00+08,0,12,12,0,1026770,1026770,42.4,583.72,626.12
2020-06-22 20:00:00+08,0,12,12,0,968902,968902,42.36,557.88,600.24
2020-06-23 00:00:00+08,0,10,10,0,842502,842502,0,182.62,182.62
2020-06-23 04:00:00+08,0,12,12,0,1073902,1073902,0,223.1,223.1
2020-06-23 08:00:00+08,0,10,10,0,1070800,1070800,0,196.6,196.6
2020-06-23 12:00:00+08,0,8,8,0,859710,859710,0,173.28,173.28
2020-06-23 16:00:00+08,0,6,6,0,661578,661578,0,137.4,137.4
2020-06-23 20:00:00+08,0,10,10,0,1103156,1103156,0,66.46,66.46
2020-06-24 00:00:00+08,0,14,14,0,1469782,1469782,0,109.26,109.26
2020-06-24 04:00:00+08,0,18,18,0,1767232,1767232,10.2,174.16,184.36
2020-06-24 08:00:00+08,0,24,24,0,2138714,2138714,10.2,261.02,271.22
2020-06-24 12:00:00+08,0,24,24,0,2138714,2138714,10.2,357.02,367.22
2020-06-24 16:00:00+08,0,18,18,0,1529970,1529970,10.2,269.42,279.62
2020-06-24 20:00:00+08,0,16,16,0,1478158,1478158,10.2,275.68,285.88
2020-06-25 00:00:00+08,0,16,16,0,1478158,1478158,10.2,339.68,349.88
2020-06-25 04:00:00+08,0,14,14,0,1407708,1407708,10.2,383.48,393.68
2020-06-25 08:00:00+08,0,14,14,0,1584314,1584314,10.2,311.96,322.16
2020-06-25 12:00:00+08,0,14,14,0,1584314,1584314,10.2,367.96,378.16
2020-06-25 16:00:00+08,0,8,8,0,1038318,1038318,0,211.96,211.96
2020-06-25 20:00:00+08,0,14,14,0,1505420,1505420,0,255.78,255.78
2020-06-26 00:00:00+08,0,12,12,0,1214644,1214644,0,206.8,206.8
2020-06-26 04:00:00+08,0,12,12,0,1214644,1214644,0,254.8,254.8
2020-06-26 08:00:00+08,0,12,12,0,999724,999724,0,192.68,192.68
2020-06-26 12:00:00+08,0,10,10,0,840942,840942,0,96.76,96.76
2020-06-26 16:00:00+08,0,6,6,0,498254,498254,0,47.46,47.46
2020-06-26 20:00:00+08,0,8,8,0,760838,760838,0,74.4,74.4
2020-06-27 00:00:00+08,0,10,10,0,875478,875478,0,109.38,109.38
2020-06-27 04:00:00+08,0,10,10,0,875478,875478,0,149.38,149.38
2020-06-27 08:00:00+08,0,8,8,0,707914,707914,0,96.68,96.68
2020-06-27 12:00:00+08,0,6,6,0,500132,500132,0,74.48,74.48
2020-06-27 16:00:00+08,0,6,6,0,500132,500132,0,98.48,98.48
2020-06-27 20:00:00+08,0,6,6,0,592828,592828,0,83.34,83.34
2020-06-28 00:00:00+08,0,8,8,0,810828,810828,0,109.08,109.08
2020-06-28 04:00:00+08,0,6,6,0,687920,687920,0,96.54,96.54
2020-06-28 08:00:00+08,0,4,4,0,425336,425336,0,45.6,45.6
2020-06-28 12:00:00+08,0,4,4,0,425336,425336,0,61.6,61.6
2020-06-28 16:00:00+08,0,2,2,0,218000,218000,0,33.78,33.78
2020-06-28 20:00:00+08,0,6,6,0,355928,355928,0,50.72,50.72
2020-06-29 00:00:00+08,0,8,8,0,619998,619998,0,76.86,76.86
2020-06-29 04:00:00+08,0,6,6,0,583448,583448,0,88.32,88.32
2020-06-29 08:00:00+08,0,6,6,0,657540,657540,0,51.66,51.66
2020-06-29 12:00:00+08,0,6,6,0,657540,657540,0,75.66,75.66
2020-06-29 16:00:00+08,0,6,6,0,787562,787562,0,56.24,56.24
2020-06-29 20:00:00+08,0,12,12,0,1361076,1361076,0,90.64,90.64
2020-06-30 00:00:00+08,0,16,16,0,1559054,1559054,0,143.16,143.16
2020-06-30 04:00:00+08,2,16,18,68600,1559054,1627654,1.2,207.16,208.36
2020-06-30 08:00:00+08,2,16,18,68600,1525056,1593656,9.2,209.32,218.52
2020-06-30 12:00:00+08,2,14,16,68600,1376306,1444906,17.2,237.56,254.76
2020-06-30 16:00:00+08,2,10,12,68600,1178328,1246928,25.2,225.04,250.24
2020-06-30 20:00:00+08,2,14,16,68600,1391926,1460526,33.2,274.76,307.96
2020-07-01 00:00:00+08,2,18,20,68600,1678866,1747466,41.2,277.5,318.7
2020-07-01 04:00:00+08,0,16,16,0,1447466,1447466,0,276.5,276.5
2020-07-01 08:00:00+08,0,20,20,0,1611800,1611800,51.36,250.56,301.92
2020-07-01 12:00:00+08,0,18,18,0,1404418,1404418,51.36,246.78,298.14
2020-07-01 16:00:00+08,0,18,18,0,1404418,1404418,51.36,318.78,370.14
2020-07-01 20:00:00+08,0,22,22,0,1632082,1632082,0,301.46,301.46
2020-07-02 00:00:00+08,2,22,24,203064,1721498,1924562,4.84,339.64,344.48
2020-07-02 04:00:00+08,0,20,20,0,1587480,1587480,0,357.8,357.8
2020-07-02 08:00:00+08,0,16,16,0,1575474,1575474,17.16,269.94,287.1
2020-07-02 12:00:00+08,0,16,16,0,1728532,1728532,29.12,305.2,334.32
2020-07-02 16:00:00+08,0,14,14,0,1557304,1557304,29.12,302.38,331.5
2020-07-02 20:00:00+08,0,18,18,0,1635940,1635940,29.12,295.16,324.28
2020-07-03 00:00:00+08,2,18,20,83166,1635940,1719106,33.16,367.16,400.32
2020-07-03 04:00:00+08,2,18,20,83166,1635940,1719106,41.16,439.16,480.32
2020-07-03 08:00:00+08,2,18,20,83166,1612478,1695644,49.16,453.08,502.24
2020-07-03 12:00:00+08,0,18,18,0,1612478,1612478,29.12,525.08,554.2
2020-07-03 16:00:00+08,0,12,12,0,964458,964458,51,307.18,358.18
2020-07-03 20:00:00+08,0,12,12,0,1048378,1048378,51.02,131.28,182.3
2020-07-04 00:00:00+08,0,16,16,0,1340620,1340620,57.44,191.76,249.2
2020-07-04 04:00:00+08,0,16,16,0,1340620,1340620,57.44,255.76,313.2
2020-07-04 08:00:00+08,0,10,10,0,928402,928402,6.36,158.76,165.12
2020-07-04 12:00:00+08,2,6,8,207336,636160,843496,1.44,138.24,139.68
2020-07-04 16:00:00+08,2,4,6,207336,427636,634972,9.44,92.2,101.64
2020-07-04 20:00:00+08,0,2,2,0,293296,293296,0,55.98,55.98
2020-07-05 00:00:00+08,0,4,4,0,500632,500632,24.08,65.34,89.42
2020-07-05 04:00:00+08,0,4,4,0,500632,500632,24.08,81.34,105.42
2020-07-05 08:00:00+08,0,4,4,0,500632,500632,24.08,97.34,121.42
2020-07-05 12:00:00+08,0,4,4,0,500632,500632,24.08,113.34,137.42
2020-07-05 16:00:00+08,0,6,6,0,732032,732032,24.08,131.14,155.22
2020-07-05 20:00:00+08,0,12,12,0,1068862,1068862,24.08,168.66,192.74
2020-07-06 00:00:00+08,0,16,16,0,1464970,1464970,24.08,225.54,249.62
2020-07-06 04:00:00+08,0,16,16,0,1464970,1464970,24.08,289.54,313.62
2020-07-06 08:00:00+08,0,14,14,0,1428272,1428272,24.08,324.88,348.96
2020-07-06 12:00:00+08,0,12,12,0,1134976,1134976,24.08,244.9,268.98
2020-07-06 16:00:00+08,0,12,12,0,1134976,1134976,24.08,292.9,316.98
2020-07-06 20:00:00+08,0,12,12,0,1237110,1237110,0,210,210
2020-07-07 00:00:00+08,0,12,12,0,1031836,1031836,0,192.6,192.6
2020-07-07 04:00:00+08,0,10,10,0,931660,931660,0,182.24,182.24
2020-07-07 08:00:00+08,0,16,16,0,1440414,1440414,0,237.6,237.6
2020-07-07 12:00:00+08,0,12,12,0,1113728,1113728,0,178.84,178.84
2020-07-07 16:00:00+08,0,12,12,0,1113728,1113728,0,226.84,226.84
2020-07-07 20:00:00+08,0,10,10,0,1203258,1203258,0,209.14,209.14
2020-07-08 00:00:00+08,0,14,14,0,1585776,1585776,0,284.32,284.32
2020-07-08 04:00:00+08,0,20,20,0,2018318,2018318,0,353.48,353.48
2020-07-08 08:00:00+08,0,24,24,0,2421416,2421416,0,402.14,402.14
2020-07-08 12:00:00+08,0,24,24,0,2421416,2421416,0,498.14,498.14
2020-07-08 16:00:00+08,0,20,20,0,2007646,2007646,0,482.12,482.12
2020-07-08 20:00:00+08,0,20,20,0,1804142,1804142,0,351.82,351.82
2020-07-09 00:00:00+08,0,22,22,0,2036128,2036128,0,432.36,432.36
2020-07-09 04:00:00+08,0,20,20,0,1753212,1753212,0,403.78,403.78
2020-07-09 08:00:00+08,0,12,12,0,1302572,1302572,0,278.16,278.16
2020-07-09 12:00:00+08,0,10,10,0,1156608,1156608,0,265.14,265.14
2020-07-09 16:00:00+08,0,10,10,0,1156608,1156608,0,305.14,305.14
2020-07-09 20:00:00+08,0,12,12,0,1204344,1204344,0,275.96,275.96
2020-07-10 00:00:00+08,0,14,14,0,1271726,1271726,0,326.38,326.38
2020-07-10 04:00:00+08,0,14,14,0,1368364,1368364,0,287.66,287.66
2020-07-10 08:00:00+08,0,14,14,0,1471784,1471784,0,319.06,319.06
2020-07-10 12:00:00+08,0,6,6,0,649568,649568,0,68.54,68.54
2020-07-10 16:00:00+08,0,6,6,0,649568,649568,0,92.54,92.54
2020-07-10 20:00:00+08,0,10,10,0,1041190,1041190,0,72.28,72.28
2020-07-11 00:00:00+08,0,10,10,0,1041190,1041190,0,112.28,112.28
2020-07-11 04:00:00+08,0,10,10,0,1041190,1041190,0,152.28,152.28
2020-07-11 08:00:00+08,0,10,10,0,1041190,1041190,0,192.28,192.28
2020-07-11 12:00:00+08,0,10,10,0,1041190,1041190,0,232.28,232.28
2020-07-11 16:00:00+08,0,4,4,0,589104,589104,0,116.44,116.44
2020-07-11 20:00:00+08,2,6,8,227928,712102,940030,2.8,134.6,137.4
2020-07-12 00:00:00+08,2,8,10,34382,940030,974412,7.48,162.18,169.66
2020-07-12 04:00:00+08,2,8,10,34382,940030,974412,15.48,194.18,209.66
2020-07-12 08:00:00+08,2,8,10,34382,940030,974412,23.48,226.18,249.66
2020-07-12 12:00:00+08,2,4,6,34382,525912,560294,31.48,109.4,140.88
2020-07-12 16:00:00+08,0,6,6,0,757898,757898,7.2,129.02,136.22
2020-07-12 20:00:00+08,0,14,14,0,1383908,1383908,43.76,171.74,215.5
2020-07-13 00:00:00+08,0,14,14,0,1383908,1383908,43.76,227.74,271.5
2020-07-13 04:00:00+08,0,10,10,0,857996,857996,36.56,110.3,146.86
2020-07-13 08:00:00+08,0,14,14,0,1370372,1370372,36.56,164.82,201.38
2020-07-13 12:00:00+08,0,12,12,0,1335990,1335990,0,185.12,185.12
2020-07-13 16:00:00+08,0,12,12,0,1335990,1335990,0,233.12,233.12
2020-07-13 20:00:00+08,0,16,16,0,1578584,1578584,0,287,287
2020-07-14 00:00:00+08,0,18,18,0,1604706,1604706,0,351.76,351.76
2020-07-14 04:00:00+08,0,18,18,0,1766028,1766028,0,363.84,363.84
2020-07-14 08:00:00+08,0,20,20,0,1821566,1821566,0,369.64,369.64
2020-07-14 12:00:00+08,2,14,16,231400,1346986,1578386,3.78,288.14,291.92
2020-07-14 16:00:00+08,2,10,12,231400,1016178,1247578,11.78,240.72,252.5
2020-07-14 20:00:00+08,2,12,14,231400,1200122,1431522,19.78,261.64,281.42
2020-07-15 00:00:00+08,4,18,22,436004,1651352,2087356,33.08,317.3,350.38
2020-07-15 04:00:00+08,2,18,20,231400,1651352,1882752,35.78,389.3,425.08
2020-07-15 08:00:00+08,2,22,24,231400,2028646,2260046,60.18,346.04,406.22
2020-07-15 12:00:00+08,2,20,22,231400,1826246,2057646,68.12,372.96,441.08
2020-07-15 16:00:00+08,2,16,18,231400,1401820,1633220,76.1,328.34,404.44
2020-07-15 20:00:00+08,2,18,20,231400,1487618,1719018,84.12,223.16,307.28
2020-07-16 00:00:00+08,2,18,20,231400,1487618,1719018,92.12,295.16,387.28
2020-07-16 04:00:00+08,0,16,16,0,1385880,1385880,16.38,308.98,325.36
2020-07-16 08:00:00+08,0,16,16,0,1647006,1647006,101.68,290.44,392.12
2020-07-16 12:00:00+08,0,16,16,0,1647006,1647006,101.68,354.44,456.12
2020-07-16 16:00:00+08,0,14,14,0,1483602,1483602,101.68,305.08,406.76
2020-07-16 20:00:00+08,0,16,16,0,1606820,1606820,101.68,367.68,469.36
2020-07-17 00:00:00+08,0,16,16,0,1606820,1606820,101.68,431.68,533.36
2020-07-17 04:00:00+08,0,14,14,0,1447986,1447986,101.68,428.7,530.38
2020-07-17 08:00:00+08,0,12,12,0,1066708,1066708,112.14,321.02,433.16
2020-07-17 12:00:00+08,0,12,12,0,1042854,1042854,26.82,312.5,339.32
2020-07-17 16:00:00+08,0,8,8,0,544954,544954,10.48,129.32,139.8
2020-07-17 20:00:00+08,0,8,8,0,634322,634322,10.5,54.84,65.34
2020-07-18 00:00:00+08,0,12,12,0,824612,824612,10.5,89.84,100.34
2020-07-18 04:00:00+08,0,12,12,0,824612,824612,10.5,137.84,148.34
2020-07-18 08:00:00+08,0,8,8,0,688840,688840,0,114.84,114.84
2020-07-18 12:00:00+08,0,6,6,0,562440,562440,0,112.28,112.28
2020-07-18 16:00:00+08,0,8,8,0,779038,779038,0,139.64,139.64
2020-07-18 20:00:00+08,0,6,6,0,680570,680570,0,63.68,63.68
2020-07-19 00:00:00+08,0,6,6,0,680570,680570,0,87.68,87.68
2020-07-19 04:00:00+08,0,4,4,0,448584,448584,0,46.04,46.04
2020-07-19 08:00:00+08,0,8,8,0,782630,782630,0,69.82,69.82
2020-07-19 12:00:00+08,0,8,8,0,782630,782630,0,101.82,101.82
2020-07-19 16:00:00+08,0,6,6,0,566032,566032,0,82.46,82.46
2020-07-19 20:00:00+08,0,14,14,0,1099472,1099472,0,118.38,118.38
2020-07-20 00:00:00+08,0,14,14,0,1099472,1099472,0,174.38,174.38
2020-07-20 04:00:00+08,0,10,10,0,740776,740776,0,122.18,122.18
2020-07-20 08:00:00+08,0,6,6,0,496890,496890,0,79.1,79.1
2020-07-20 12:00:00+08,0,6,6,0,496890,496890,0,103.1,103.1
2020-07-20 16:00:00+08,0,4,4,0,304684,304684,0,86.76,86.76
2020-07-20 20:00:00+08,0,8,8,0,588670,588670,0,61.24,61.24
2020-07-21 00:00:00+08,0,10,10,0,614796,614796,0,93.52,93.52
2020-07-21 04:00:00+08,0,10,10,0,614796,614796,0,133.52,133.52
2020-07-21 08:00:00+08,0,10,10,0,465124,465124,0,101.14,101.14
2020-07-21 12:00:00+08,0,4,4,0,261284,261284,0,46.46,46.46
2020-07-21 16:00:00+08,0,4,4,0,261284,261284,0,62.46,62.46
2020-07-21 20:00:00+08,0,4,4,0,378956,378956,0,52.64,52.64
2020-07-22 00:00:00+08,2,6,8,219264,548366,767630,4.26,71.62,75.88
2020-07-22 04:00:00+08,0,6,6,0,409608,409608,0,36.4,36.4
2020-07-22 08:00:00+08,0,12,12,0,1081036,1081036,13.14,75.82,88.96
2020-07-22 12:00:00+08,0,12,12,0,1081036,1081036,13.14,123.82,136.96
2020-07-22 16:00:00+08,0,10,10,0,909416,909416,13.14,129.86,143
2020-07-22 20:00:00+08,0,16,16,0,1202302,1202302,13.14,184.06,197.2
2020-07-23 00:00:00+08,0,16,16,0,1191738,1191738,13.14,198.46,211.6
2020-07-23 04:00:00+08,0,14,14,0,1124826,1124826,13.14,242.5,255.64
2020-07-23 08:00:00+08,0,16,16,0,1619198,1619198,13.12,245.14,258.26
2020-07-23 12:00:00+08,0,14,14,0,1448164,1448164,13.12,248.8,261.92
2020-07-23 16:00:00+08,0,10,10,0,1222190,1222190,13.12,214.58,227.7
2020-07-23 20:00:00+08,0,14,14,0,1477146,1477146,13.12,259.74,272.86
2020-07-24 00:00:00+08,2,16,18,245918,1765266,2011184,13.92,316.28,330.2
2020-07-24 04:00:00+08,0,16,16,0,1765266,1765266,13.12,380.28,393.4
2020-07-24 08:00:00+08,2,20,22,169550,2315872,2485422,25.14,453.34,478.48
2020-07-24 12:00:00+08,2,18,20,169550,2197168,2366718,33.14,498.44,531.58
2020-07-24 16:00:00+08,2,16,18,169550,1977904,2147454,27.98,451.36,479.34
2020-07-24 20:00:00+08,0,14,14,0,1668858,1668858,11.56,182.24,193.8
2020-07-25 00:00:00+08,0,20,20,0,2244168,2244168,41,250.26,291.26
2020-07-25 04:00:00+08,0,22,22,0,2380624,2380624,41,336.74,377.74
2020-07-25 08:00:00+08,0,22,22,0,2380624,2380624,41,424.74,465.74
2020-07-25 12:00:00+08,0,20,20,0,2254624,2254624,41,477.94,518.94
2020-07-25 16:00:00+08,0,18,18,0,1923874,1923874,41,440.44,481.44
2020-07-25 20:00:00+08,0,18,18,0,1886464,1886464,11.56,442.4,453.96
2020-07-26 00:00:00+08,0,18,18,0,2037402,2037402,11.58,470.58,482.16
2020-07-26 04:00:00+08,0,12,12,0,1406596,1406596,0,290.44,290.44
2020-07-26 08:00:00+08,0,10,10,0,1118476,1118476,0,225.92,225.92
2020-07-26 12:00:00+08,0,10,10,0,1118476,1118476,0,265.92,265.92
2020-07-26 16:00:00+08,0,8,8,0,1147864,1147864,0,220.94,220.94
2020-07-26 20:00:00+08,0,14,14,0,1354256,1354256,0,262.96,262.96
2020-07-27 00:00:00+08,0,14,14,0,1293346,1293346,0,216.46,216.46
2020-07-27 04:00:00+08,0,18,18,0,1818788,1818788,0,279.12,279.12
2020-07-27 08:00:00+08,0,18,18,0,1818788,1818788,0,351.12,351.12
2020-07-27 12:00:00+08,0,14,14,0,1713460,1713460,0,351.4,351.4
2020-07-27 16:00:00+08,0,14,14,0,1713460,1713460,0,407.4,407.4
2020-07-27 20:00:00+08,0,14,14,0,1543186,1543186,0,321.5,321.5
2020-07-28 00:00:00+08,0,14,14,0,1522472,1522472,0,271.9,271.9
2020-07-28 04:00:00+08,0,18,18,0,1664994,1664994,0,341.96,341.96
2020-07-28 08:00:00+08,0,20,20,0,1868630,1868630,0,417.1,417.1
2020-07-28 12:00:00+08,0,16,16,0,1514322,1514322,0,392.02,392.02
2020-07-28 16:00:00+08,0,18,18,0,1669690,1669690,0,323.42,323.42
2020-07-28 20:00:00+08,0,16,16,0,1643568,1643568,0,355.8,355.8
2020-07-29 00:00:00+08,0,14,14,0,1311192,1311192,38.46,283.42,321.88
2020-07-29 04:00:00+08,0,16,16,0,1379516,1379516,38.44,345.72,384.16
2020-07-29 08:00:00+08,0,20,20,0,1842196,1842196,38.44,416.8,455.24
2020-07-29 12:00:00+08,0,18,18,0,1725796,1725796,38.44,426.4,464.84
2020-07-29 16:00:00+08,0,12,12,0,1264610,1264610,0,336.24,336.24
2020-07-29 20:00:00+08,0,22,22,0,2035898,2035898,0,399.78,399.78
2020-07-30 00:00:00+08,0,18,18,0,1461154,1461154,0,214.24,214.24
2020-07-30 04:00:00+08,0,18,18,0,1461154,1461154,0,286.24,286.24
2020-07-30 08:00:00+08,0,16,16,0,1452994,1452994,0,287.82,287.82
2020-07-30 12:00:00+08,0,16,16,0,1452994,1452994,0,351.82,351.82
2020-07-30 16:00:00+08,0,14,14,0,1344126,1344126,0,314.42,314.42
2020-07-30 20:00:00+08,0,18,18,0,1694116,1694116,0,206.98,206.98
2020-07-31 00:00:00+08,0,18,18,0,1694116,1694116,0,278.98,278.98
2020-07-31 04:00:00+08,0,16,16,0,1548152,1548152,0,286.74,286.74
2020-07-31 08:00:00+08,0,16,16,0,1548152,1548152,0,350.74,350.74
2020-07-31 12:00:00+08,2,18,20,83180,1840580,1923760,6.6,422.52,429.12
2020-07-31 16:00:00+08,0,14,14,0,1398580,1398580,0,336.08,336.08
2020-07-31 20:00:00+08,0,16,16,0,1668662,1668662,20.7,298.62,319.32
2020-08-01 00:00:00+08,0,12,12,0,1344384,1344384,20.7,244.58,265.28
2020-08-01 04:00:00+08,0,14,14,0,1471174,1471174,20.7,299.88,320.58
2020-08-01 08:00:00+08,0,10,10,0,1094812,1094812,0,202.18,202.18
2020-08-01 12:00:00+08,0,10,10,0,1096426,1096426,0,154.82,154.82
2020-08-01 16:00:00+08,0,8,8,0,969636,969636,0,163.52,163.52
2020-08-01 20:00:00+08,0,10,10,0,1299098,1299098,0,149.42,149.42
2020-08-02 00:00:00+08,0,10,10,0,1299098,1299098,0,189.42,189.42
2020-08-02 04:00:00+08,0,8,8,0,1006670,1006670,0,141.64,141.64
2020-08-02 08:00:00+08,2,12,14,34382,1467412,1501794,2.86,185.6,188.46
2020-08-02 12:00:00+08,2,10,12,34382,1260076,1294458,10.86,179.7,190.56
2020-08-02 16:00:00+08,0,8,8,0,997540,997540,0,129.12,129.12
2020-08-02 20:00:00+08,2,12,14,181268,1239218,1420486,28.2,168.36,196.56
2020-08-03 00:00:00+08,0,10,10,0,1074288,1074288,24.24,121.3,145.54
2020-08-03 04:00:00+08,0,14,14,0,1487756,1487756,37.68,171.66,209.34
2020-08-03 08:00:00+08,0,14,14,0,1487756,1487756,37.68,227.66,265.34
2020-08-03 12:00:00+08,0,12,12,0,1453374,1453374,13.44,249.04,262.48
2020-08-03 16:00:00+08,0,12,12,0,1453374,1453374,13.44,297.04,310.48
2020-08-03 20:00:00+08,0,16,16,0,1819506,1819506,13.4,351.8,365.2
2020-08-04 00:00:00+08,0,16,16,0,1819506,1819506,13.4,415.8,429.2
2020-08-04 04:00:00+08,2,16,18,54050,1819506,1873556,14.56,479.8,494.36
2020-08-04 08:00:00+08,0,16,16,0,1738562,1738562,13.36,474.32,487.68
2020-08-04 12:00:00+08,0,12,12,0,1080586,1080586,25.86,309.44,335.3
2020-08-04 16:00:00+08,0,8,8,0,689150,689150,12.48,198.04,210.52
2020-08-04 20:00:00+08,0,8,8,0,469338,469338,12.48,76.76,89.24
2020-08-05 00:00:00+08,0,14,14,0,1087996,1087996,12.48,123.06,135.54
2020-08-05 04:00:00+08,0,14,14,0,1087996,1087996,12.48,179.06,191.54
2020-08-05 08:00:00+08,0,12,12,0,1033946,1033946,0,190.38,190.38
2020-08-05 12:00:00+08,0,12,12,0,1033946,1033946,0,238.38,238.38
2020-08-05 16:00:00+08,0,10,10,0,862166,862166,0,243.08,243.08
2020-08-05 20:00:00+08,0,12,12,0,1033394,1033394,0,286.78,286.78
2020-08-06 00:00:00+08,0,12,12,0,1033394,1033394,0,334.78,334.78
2020-08-06 04:00:00+08,0,12,12,0,1295530,1295530,0,316.86,316.86
2020-08-06 08:00:00+08,2,12,14,70450,1236210,1306660,12.4,184.54,196.94
2020-08-06 12:00:00+08,4,14,18,303330,1478098,1781428,20.64,239.82,260.46
2020-08-06 16:00:00+08,8,16,24,546408,1548814,2095222,42.3,302.56,344.86
2020-08-06 20:00:00+08,6,16,22,475958,1500058,1976016,45.24,278.9,324.14
2020-08-07 00:00:00+08,6,18,24,475958,1499480,1975438,103.22,245.14,348.36
2020-08-07 04:00:00+08,6,18,24,475958,1497818,1973776,127.22,254.92,382.14
2020-08-07 08:00:00+08,6,20,26,475958,1787942,2263900,151.22,279.84,431.06
2020-08-07 12:00:00+08,6,22,28,475958,1857142,2333100,175.22,363.98,539.2
2020-08-07 16:00:00+08,4,18,22,354680,1663784,2018464,116.38,373.24,489.62
2020-08-07 20:00:00+08,4,22,26,354680,1867362,2222042,185.32,349.92,535.24
2020-08-08 00:00:00+08,4,24,28,354680,2160376,2515056,201.32,438.44,639.76
2020-08-08 04:00:00+08,4,24,28,354680,2212878,2567558,217.32,458.5,675.82
2020-08-08 08:00:00+08,4,24,28,415842,2193258,2609100,152.22,495.46,647.68
2020-08-08 12:00:00+08,4,22,26,415842,2255738,2671580,258.62,484.94,743.56
2020-08-08 16:00:00+08,4,20,24,415842,2129750,2545592,274.58,529.68,804.26
2020-08-08 20:00:00+08,2,18,20,294042,1841488,2135530,181.8,481.48,663.28
2020-08-09 00:00:00+08,2,18,20,294042,1754088,2048130,306.42,495.8,802.22
2020-08-09 04:00:00+08,2,14,16,294042,1428422,1722464,261.5,367.2,628.7
2020-08-09 08:00:00+08,2,14,16,294042,1428422,1722464,269.5,423.2,692.7
2020-08-09 12:00:00+08,0,16,16,0,1528398,1528398,214.42,356.1,570.52
2020-08-09 16:00:00+08,0,20,20,0,2043214,2043214,283.38,426.62,710
2020-08-09 20:00:00+08,0,24,24,0,2162930,2162930,283.38,515.4,798.78
2020-08-10 00:00:00+08,0,24,24,0,2162930,2162930,283.38,611.4,894.78
2020-08-10 04:00:00+08,0,22,22,0,2041130,2041130,166.7,651.34,818.04
2020-08-10 08:00:00+08,0,14,14,0,1565494,1565494,166.68,548.88,715.56
2020-08-10 12:00:00+08,0,12,12,0,1528944,1528944,166.68,571.74,738.42
2020-08-10 16:00:00+08,0,14,14,0,1727076,1727076,166.68,620.38,787.06
2020-08-10 20:00:00+08,2,12,14,145800,1424378,1570178,172.74,482.12,654.86
2020-08-11 00:00:00+08,4,18,22,317656,1685052,2002708,186.06,540.6,726.66
2020-08-11 04:00:00+08,4,20,24,317656,1917038,2234694,202.06,618.12,820.18
2020-08-11 08:00:00+08,4,24,28,317656,2365866,2683522,218.06,706.8,924.86
2020-08-11 12:00:00+08,4,24,28,317656,2365866,2683522,234.06,802.8,1036.86
2020-08-11 16:00:00+08,2,22,24,171856,2339744,2511600,203.92,866.48,1070.4
2020-08-11 20:00:00+08,2,16,18,171856,1770148,1942004,262.22,691.68,953.9
2020-08-12 00:00:00+08,4,22,26,343468,2374608,2718076,273.26,773.36,1046.62
2020-08-12 04:00:00+08,4,22,26,369744,2374608,2744352,230.4,861.36,1091.76
2020-08-12 08:00:00+08,4,24,28,369744,2546464,2916208,311.6,953.48,1265.08
2020-08-12 12:00:00+08,4,22,26,369744,2400664,2770408,277.28,1013.66,1290.94
2020-08-12 16:00:00+08,4,18,22,238994,2042160,2281154,274.54,985.02,1259.56
2020-08-12 20:00:00+08,4,14,18,238994,1632390,1871384,290.52,764.62,1055.14
2020-08-13 00:00:00+08,4,16,20,238994,1671558,1910552,241.36,798.74,1040.1
2020-08-13 04:00:00+08,4,18,22,238994,1969004,2207998,257.38,863.72,1121.1
2020-08-13 08:00:00+08,4,20,24,238994,2214926,2453920,285.22,939.74,1224.96
2020-08-13 12:00:00+08,4,14,18,238994,1606774,1845768,232.26,762.38,994.64
2020-08-13 16:00:00+08,2,14,16,67382,1575400,1642782,165.26,777.42,942.68
2020-08-13 20:00:00+08,2,20,22,67382,2147518,2214900,259.74,837.58,1097.32
2020-08-14 00:00:00+08,2,22,24,67382,2232706,2300088,267.74,933.52,1201.26
2020-08-14 04:00:00+08,2,22,24,67382,2232706,2300088,275.74,1021.52,1297.26
2020-08-14 08:00:00+08,2,26,28,67382,2509066,2576448,283.68,1122.54,1406.22
2020-08-14 12:00:00+08,2,22,24,67382,2264896,2332278,291.68,1112.7,1404.38
2020-08-14 16:00:00+08,2,22,24,67382,2438620,2506002,299.68,1165.4,1465.08
2020-08-14 20:00:00+08,2,18,20,67382,1890714,1958096,288.56,635.98,924.54
2020-08-15 00:00:00+08,2,14,16,67382,1533452,1600834,296.56,520.8,817.36
2020-08-15 04:00:00+08,2,16,18,67382,1649852,1717234,304.56,584.64,889.2
2020-08-15 08:00:00+08,2,20,22,67382,2126552,2193934,312.56,587.2,899.76
2020-08-15 12:00:00+08,2,20,22,67382,2126552,2193934,320.56,667.2,987.76
2020-08-15 16:00:00+08,0,14,14,0,1558198,1558198,90.36,537.54,627.9
2020-08-15 20:00:00+08,0,14,14,0,1651796,1651796,248.08,507.78,755.86
2020-08-16 00:00:00+08,0,18,18,0,1973862,1973862,248.12,571.42,819.54
2020-08-16 04:00:00+08,0,18,18,0,1973862,1973862,248.12,643.42,891.54
2020-08-16 08:00:00+08,0,18,18,0,1977638,1977638,90.32,644.4,734.72
2020-08-16 12:00:00+08,0,18,18,0,1977638,1977638,90.32,716.4,806.72
2020-08-16 16:00:00+08,0,16,16,0,1743936,1743936,90.36,720.42,810.78
2020-08-16 20:00:00+08,0,14,14,0,1639870,1639870,90.36,737.84,828.2
2020-08-17 00:00:00+08,0,14,14,0,1417830,1417830,90.36,708.64,799
2020-08-17 04:00:00+08,0,14,14,0,1417830,1417830,90.36,764.64,855
2020-08-17 08:00:00+08,0,12,12,0,1199830,1199830,90.36,755.54,845.9
2020-08-17 12:00:00+08,0,10,10,0,1163132,1163132,90.36,778.06,868.42
2020-08-17 16:00:00+08,0,4,4,0,525308,525308,90.34,594.8,685.14
2020-08-17 20:00:00+08,0,4,4,0,525308,525308,90.34,610.8,701.14
2020-08-18 00:00:00+08,0,6,6,0,727708,727708,90.36,626.84,717.2
2020-08-18 04:00:00+08,0,6,6,0,727708,727708,90.36,650.84,741.2
2020-08-18 08:00:00+08,0,6,6,0,727708,727708,90.36,674.84,765.2
2020-08-18 12:00:00+08,0,4,4,0,494828,494828,0,212.96,212.96
2020-08-18 16:00:00+08,0,12,12,0,1139952,1139952,0,242.58,242.58
2020-08-18 20:00:00+08,0,16,16,0,1218118,1218118,0,296.22,296.22
2020-08-19 00:00:00+08,0,18,18,0,1446664,1446664,0,350.78,350.78
2020-08-19 04:00:00+08,4,16,20,281834,1239282,1521116,4.16,395.38,399.54
2020-08-19 08:00:00+08,2,10,12,53622,944956,998578,10.06,361.88,371.94
2020-08-19 12:00:00+08,2,16,18,53622,1539476,1593098,28.18,417.14,445.32
2020-08-19 16:00:00+08,0,12,12,0,1073006,1073006,10.18,364.54,374.72
2020-08-19 20:00:00+08,0,14,14,0,1131160,1131160,42.16,124.8,166.96
2020-08-20 00:00:00+08,0,14,14,0,1286900,1286900,42.16,125.58,167.74
2020-08-20 04:00:00+08,0,16,16,0,1458420,1458420,42.16,185.2,227.36
2020-08-20 08:00:00+08,0,16,16,0,1460228,1460228,42.16,210.84,253
2020-08-20 12:00:00+08,0,16,16,0,1460228,1460228,42.16,274.84,317
2020-08-20 16:00:00+08,0,14,14,0,1406606,1406606,10.16,296.76,306.92
2020-08-20 20:00:00+08,0,16,16,0,1588552,1588552,10.16,333.34,343.5
2020-08-21 00:00:00+08,0,14,14,0,1508782,1508782,0,309.86,309.86
2020-08-21 04:00:00+08,0,14,14,0,1508782,1508782,0,365.86,365.86
2020-08-21 08:00:00+08,2,20,22,216212,2087054,2303266,17.18,436.06,453.24
2020-08-21 12:00:00+08,0,20,20,0,2087054,2087054,11.94,516.06,528
2020-08-21 16:00:00+08,0,12,12,0,1455676,1455676,11.96,347.48,359.44
2020-08-21 20:00:00+08,0,12,12,0,1209584,1209584,34.02,199.98,234
2020-08-22 00:00:00+08,0,14,14,0,1264072,1264072,34.02,251.12,285.14
2020-08-22 04:00:00+08,0,16,16,0,1557464,1557464,34.02,313.9,347.92
2020-08-22 08:00:00+08,2,18,20,207336,1788520,1995856,41.84,358.92,400.76
2020-08-22 12:00:00+08,2,16,18,207336,1500220,1707556,49.84,296.14,345.98
2020-08-22 16:00:00+08,0,12,12,0,1238396,1238396,34,255,289
2020-08-22 20:00:00+08,0,16,16,0,1696532,1696532,40.36,255.54,295.9
2020-08-23 00:00:00+08,0,14,14,0,1543596,1543596,28.4,153.28,181.68
2020-08-23 04:00:00+08,0,14,14,0,1543596,1543596,28.4,209.28,237.68
2020-08-23 08:00:00+08,0,12,12,0,1476214,1476214,28.4,210.7,239.1
2020-08-23 12:00:00+08,0,12,12,0,1476214,1476214,28.4,258.7,287.1
2020-08-23 16:00:00+08,0,10,10,0,1306648,1306648,28.4,263.94,292.34
2020-08-23 20:00:00+08,0,10,10,0,1294530,1294530,28.4,220.9,249.3
2020-08-24 00:00:00+08,0,6,6,0,789748,789748,0,143.88,143.88
2020-08-24 04:00:00+08,0,6,6,0,789748,789748,0,167.88,167.88
2020-08-24 08:00:00+08,0,8,8,0,1021148,1021148,0,194.2,194.2
2020-08-24 12:00:00+08,0,8,8,0,1021148,1021148,0,226.2,226.2
2020-08-24 16:00:00+08,0,6,6,0,803148,803148,0,176.28,176.28
2020-08-24 20:00:00+08,0,16,16,0,1464892,1464892,0,216.66,216.66
2020-08-25 00:00:00+08,0,20,20,0,1662626,1662626,0,285.1,285.1
2020-08-25 04:00:00+08,0,22,22,0,1843512,1843512,0,369.38,369.38
2020-08-25 08:00:00+08,0,20,20,0,1719098,1719098,0,429.62,429.62
2020-08-25 12:00:00+08,0,18,18,0,1692976,1692976,0,485.22,485.22
2020-08-25 16:00:00+08,0,16,16,0,1542834,1542834,0,450.92,450.92
2020-08-25 20:00:00+08,0,18,18,0,1715204,1715204,0,349.04,349.04
2020-08-26 00:00:00+08,0,20,20,0,2007164,2007164,0,424.1,424.1
2020-08-26 04:00:00+08,0,22,22,0,2226316,2226316,0,512,512
2020-08-26 08:00:00+08,0,22,22,0,2014242,2014242,0,477.62,477.62
2020-08-26 12:00:00+08,0,14,14,0,1248638,1248638,0,219.8,219.8
2020-08-26 16:00:00+08,0,14,14,0,1248638,1248638,0,275.8,275.8
2020-08-26 20:00:00+08,0,14,14,0,1240634,1240634,0,276.32,276.32
2020-08-27 00:00:00+08,0,14,14,0,1009136,1009136,0,282.64,282.64
2020-08-27 04:00:00+08,0,14,14,0,1009136,1009136,0,338.64,338.64
2020-08-27 08:00:00+08,0,12,12,0,789984,789984,0,330.72,330.72
2020-08-27 12:00:00+08,2,12,14,101362,789984,891346,1.94,378.72,380.66
2020-08-27 16:00:00+08,2,12,14,101362,789984,891346,9.94,426.72,436.66
2020-08-27 20:00:00+08,2,10,12,101362,748758,850120,17.92,299.82,317.74
2020-08-28 00:00:00+08,2,10,12,101362,748758,850120,25.92,339.82,365.74
2020-08-28 04:00:00+08,2,8,10,101362,714376,815738,33.92,217.74,251.66
2020-08-28 08:00:00+08,2,6,8,101362,552644,654006,41.92,175.22,217.14
2020-08-28 12:00:00+08,2,4,6,101362,429426,530788,49.94,162.48,212.42
2020-08-28 16:00:00+08,0,4,4,0,429426,429426,0,178.48,178.48
2020-08-28 20:00:00+08,0,12,12,0,1185372,1185372,62.04,211.12,273.16
2020-08-29 00:00:00+08,0,16,16,0,1333650,1333650,62,119.9,181.9
2020-08-29 04:00:00+08,0,16,16,0,1277598,1277598,62.04,122.82,184.86
2020-08-29 08:00:00+08,0,16,16,0,1277598,1277598,62.04,186.82,248.86
2020-08-29 12:00:00+08,0,16,16,0,1277598,1277598,62.04,250.82,312.86
2020-08-29 16:00:00+08,0,12,12,0,961540,961540,62,228.42,290.42
2020-08-29 20:00:00+08,0,12,12,0,1078300,1078300,62.02,237.08,299.1
2020-08-30 00:00:00+08,0,12,12,0,1316802,1316802,62.02,192.42,254.44
2020-08-30 04:00:00+08,0,12,12,0,1520128,1520128,0,177.72,177.72
2020-08-30 08:00:00+08,0,12,12,0,1520128,1520128,0,225.72,225.72
2020-08-30 12:00:00+08,0,10,10,0,1320116,1320116,0,199.34,199.34
2020-08-30 16:00:00+08,0,12,12,0,1611236,1611236,0,241.36,241.36
2020-08-30 20:00:00+08,0,10,10,0,1330568,1330568,0,138.36,138.36
2020-08-31 00:00:00+08,0,16,16,0,1844156,1844156,0,182.36,182.36
2020-08-31 04:00:00+08,0,16,16,0,1844156,1844156,0,246.36,246.36
2020-08-31 08:00:00+08,0,18,18,0,2066524,2066524,0,316.12,316.12
2020-08-31 12:00:00+08,0,18,18,0,2066524,2066524,0,388.12,388.12
2020-08-31 16:00:00+08,0,16,16,0,1859188,1859188,0,378.76,378.76
2020-08-31 20:00:00+08,0,16,16,0,1591050,1591050,0,358.68,358.68
2020-09-01 00:00:00+08,0,20,20,0,1735384,1735384,0,413.16,413.16
2020-09-01 04:00:00+08,2,20,22,231400,1735384,1966784,0.46,493.16,493.62
2020-09-01 08:00:00+08,2,16,18,231400,1241482,1472882,8.46,357.86,366.32
2020-09-01 12:00:00+08,2,14,16,231400,1461354,1692754,16.46,338.74,355.2
2020-09-01 16:00:00+08,2,12,14,231400,1193300,1424700,24.44,244.28,268.72
2020-09-01 20:00:00+08,4,16,20,509214,1458052,1967266,34.18,190.92,225.1
2020-09-02 00:00:00+08,4,20,24,509214,2031926,2541140,50.14,264.64,314.78
2020-09-02 04:00:00+08,4,20,24,509214,1966486,2475700,66.14,289.24,355.38
2020-09-02 08:00:00+08,4,18,22,509214,1820166,2329380,82.14,317.24,399.38
2020-09-02 12:00:00+08,2,20,22,277814,1939340,2217154,33.7,393.54,427.24
2020-09-02 16:00:00+08,2,20,22,277814,2024216,2302030,113.18,430.92,544.1
2020-09-02 20:00:00+08,2,18,20,277814,1922478,2200292,121.18,461.16,582.34
2020-09-03 00:00:00+08,6,20,26,713396,2065048,2778444,143.04,534.68,677.72
2020-09-03 04:00:00+08,4,20,24,495354,2065048,2560402,152.66,614.68,767.34
2020-09-03 08:00:00+08,4,20,24,495354,2205548,2700902,187.12,577.26,764.38
2020-09-03 12:00:00+08,4,20,24,495354,2420646,2916000,203.04,596.36,799.4
2020-09-03 16:00:00+08,4,20,24,495354,2420646,2916000,219.04,676.36,895.4
2020-09-03 20:00:00+08,4,20,24,495354,2286400,2781754,163.64,624.74,788.38
2020-09-04 00:00:00+08,4,18,22,495354,1972392,2467746,179.68,371.88,551.56
2020-09-04 04:00:00+08,4,16,20,300720,1829822,2130542,83.18,386.4,469.58
2020-09-04 08:00:00+08,4,20,24,300720,2315418,2616138,215.46,461.84,677.3
2020-09-04 12:00:00+08,4,18,22,300720,2196714,2497434,231.46,507.44,738.9
2020-09-04 16:00:00+08,2,16,18,83180,2072300,2155480,159.96,538.56,698.52
2020-09-04 20:00:00+08,2,18,20,83180,2226164,2309344,260.88,537.84,798.72
2020-09-05 00:00:00+08,2,14,16,83180,1742046,1825226,268.82,376,644.82
2020-09-05 04:00:00+08,2,12,14,203620,1524004,1727624,211.48,340.02,551.5
2020-09-05 08:00:00+08,2,18,20,203620,2051944,2255564,270.46,403.16,673.62
2020-09-05 12:00:00+08,2,18,20,203620,2051944,2255564,278.46,475.16,753.62
2020-09-05 16:00:00+08,2,16,18,203620,1831944,2035564,286.46,505.12,791.58
2020-09-05 20:00:00+08,2,16,18,203620,1844936,2048556,294.48,493.2,787.68
2020-09-06 00:00:00+08,0,20,20,0,2197036,2197036,260.22,563.5,823.72
2020-09-06 04:00:00+08,0,14,14,0,1390490,1390490,93.4,341.46,434.86
2020-09-06 08:00:00+08,0,14,14,0,1513780,1513780,42.4,350.56,392.96
2020-09-06 12:00:00+08,0,12,12,0,1393080,1393080,42.4,377.72,420.12
2020-09-06 16:00:00+08,0,12,12,0,1393080,1393080,42.4,425.72,468.12
2020-09-06 20:00:00+08,0,12,12,0,1206426,1206426,42.48,364.86,407.34
2020-09-07 00:00:00+08,0,16,16,0,1488762,1488762,42.48,421.54,464.02
2020-09-07 04:00:00+08,0,20,20,0,1807678,1807678,42.48,496.24,538.72
2020-09-07 08:00:00+08,0,18,18,0,1586904,1586904,42.42,502.18,544.6
2020-09-07 12:00:00+08,0,14,14,0,1262006,1262006,0,476.54,476.54
2020-09-07 16:00:00+08,0,14,14,0,1262006,1262006,0,532.54,532.54
2020-09-07 20:00:00+08,0,6,6,0,468544,468544,0,135.36,135.36
2020-09-08 00:00:00+08,0,4,4,0,287768,287768,0,98,98
2020-09-08 04:00:00+08,2,4,6,53300,287768,341068,0.08,114,114.08
2020-09-08 08:00:00+08,2,4,6,53300,287768,341068,8.08,130,138.08
2020-09-08 12:00:00+08,2,4,6,53300,287768,341068,16.08,146,162.08
2020-09-08 16:00:00+08,2,6,8,53300,581580,634880,24.08,164.66,188.74
2020-09-08 20:00:00+08,4,18,22,468082,1431156,1899238,6.52,212.64,219.16
2020-09-09 00:00:00+08,2,20,22,292846,1484456,1777302,52.28,285.18,337.46
2020-09-09 04:00:00+08,2,22,24,292846,1782320,2075166,70.26,361.78,432.04
2020-09-09 08:00:00+08,2,24,26,292846,1985174,2278020,78.26,434.02,512.28
2020-09-09 12:00:00+08,2,20,22,292846,1697406,1990252,86.26,288.02,374.28
2020-09-09 16:00:00+08,0,16,16,0,1379114,1379114,49.54,291.74,341.28
2020-09-09 20:00:00+08,0,18,18,0,1623558,1623558,100.12,307.82,407.94
2020-09-10 00:00:00+08,2,20,22,228250,1854958,2083208,105.42,386.16,491.58
2020-09-10 04:00:00+08,0,18,18,0,1626746,1626746,100.12,398.3,498.42
2020-09-10 08:00:00+08,0,16,16,0,1472366,1472366,90.08,380.3,470.38
2020-09-10 12:00:00+08,0,12,12,0,1232814,1232814,90.1,320.96,411.06
2020-09-10 16:00:00+08,0,8,8,0,896570,896570,84.02,102.26,186.28
2020-09-10 20:00:00+08,0,10,10,0,1187936,1187936,84,139.62,223.62
2020-09-11 00:00:00+08,0,8,8,0,896570,896570,84.02,166.26,250.28
2020-09-11 04:00:00+08,0,8,8,0,896570,896570,84.02,198.26,282.28
2020-09-11 08:00:00+08,0,12,12,0,1219484,1219484,84.02,239.04,323.06
2020-09-11 12:00:00+08,0,10,10,0,988084,988084,84.02,208.68,292.7
2020-09-11 16:00:00+08,0,8,8,0,759834,759834,50.58,196.8,247.38
2020-09-11 20:00:00+08,2,16,18,207336,1428464,1635800,52.18,243.04,295.22
2020-09-12 00:00:00+08,2,20,22,207336,1935088,2142424,60.24,312.28,372.52
2020-09-12 04:00:00+08,0,16,16,0,1498168,1498168,0,188.26,188.26
2020-09-12 08:00:00+08,0,18,18,0,1649978,1649978,20.48,212.26,232.74
2020-09-12 12:00:00+08,0,18,18,0,1649978,1649978,20.48,284.26,304.74
2020-09-12 16:00:00+08,0,18,18,0,1649978,1649978,20.48,356.26,376.74
2020-09-12 20:00:00+08,2,12,14,227928,1170482,1398410,23.16,197.4,220.56
2020-09-13 00:00:00+08,0,12,12,0,1331028,1331028,29.04,209.92,238.96
2020-09-13 04:00:00+08,0,8,8,0,903034,903034,29.04,133.24,162.28
2020-09-13 08:00:00+08,0,12,12,0,1351526,1351526,29.04,178.92,207.96
2020-09-13 12:00:00+08,0,10,10,0,1181856,1181856,29.04,193.1,222.14
2020-09-13 16:00:00+08,0,8,8,0,974520,974520,8.52,163.98,172.5
2020-09-13 20:00:00+08,0,16,16,0,1971810,1971810,8.52,210.72,219.24
2020-09-14 00:00:00+08,0,16,16,0,1971810,1971810,8.52,274.72,283.24
2020-09-14 04:00:00+08,0,14,14,0,1837470,1837470,8.52,292.7,301.22
2020-09-14 08:00:00+08,0,16,16,0,2071172,2071172,8.56,351.84,360.4
2020-09-14 12:00:00+08,0,16,16,0,2071172,2071172,8.56,415.84,424.4
2020-09-14 16:00:00+08,0,16,16,0,2071172,2071172,8.56,479.84,488.4
2020-09-14 20:00:00+08,0,14,14,0,1430414,1430414,0,242.08,242.08
2020-09-15 00:00:00+08,0,16,16,0,1531478,1531478,0,300.06,300.06
2020-09-15 04:00:00+08,0,18,18,0,1408804,1408804,0,300.5,300.5
2020-09-15 08:00:00+08,0,24,24,0,1925346,1925346,0,383.36,383.36
2020-09-15 12:00:00+08,0,22,22,0,1634570,1634570,0,398.52,398.52
2020-09-15 16:00:00+08,0,18,18,0,1435148,1435148,0,398.34,398.34
2020-09-15 20:00:00+08,0,22,22,0,1882290,1882290,0,436.28,436.28
2020-09-16 00:00:00+08,0,22,22,0,1791394,1791394,0,415.18,415.18
2020-09-16 04:00:00+08,0,20,20,0,1737652,1737652,0,457.7,457.7
2020-09-16 08:00:00+08,0,16,16,0,1296714,1296714,0,365.08,365.08
2020-09-16 12:00:00+08,0,16,16,0,1296714,1296714,0,429.08,429.08
2020-09-16 16:00:00+08,0,12,12,0,932082,932082,0,347.38,347.38
2020-09-16 20:00:00+08,4,12,16,240054,1007086,1247140,3.64,213.94,217.58
2020-09-17 00:00:00+08,4,16,20,374728,1297600,1672328,14.48,264.52,279
2020-09-17 04:00:00+08,4,18,22,374728,1365990,1740718,41.4,335.22,376.62
2020-09-17 08:00:00+08,2,18,20,203064,1550504,1753568,31.36,306.82,338.18
2020-09-17 12:00:00+08,2,16,18,203064,1431770,1634834,39.36,353.18,392.54
2020-09-17 16:00:00+08,2,14,16,203064,1285806,1488870,47.36,347.12,394.48
2020-09-17 20:00:00+08,2,22,24,203064,1863330,2066394,55.36,417.54,472.9
2020-09-18 00:00:00+08,4,22,26,374728,1863330,2238058,121.36,505.54,626.9
2020-09-18 04:00:00+08,2,20,22,171664,1653166,1824830,76.92,525.52,602.44
2020-09-18 08:00:00+08,2,22,24,171664,1962264,2133928,148.12,551.38,699.5
2020-09-18 12:00:00+08,2,20,22,171664,1893874,2065538,145.22,568.66,713.88
2020-09-18 16:00:00+08,2,14,16,171664,1438998,1610662,153.16,343.16,496.32
2020-09-18 20:00:00+08,2,18,20,171664,1734362,1906026,161.16,403.9,565.06
2020-09-19 00:00:00+08,2,18,20,171664,1755708,1927372,169.2,394.38,563.58
2020-09-19 04:00:00+08,2,20,22,171664,1872108,2043772,177.2,474.32,651.52
2020-09-19 08:00:00+08,2,18,20,171664,1659814,1831478,185.2,406.36,591.56
2020-09-19 12:00:00+08,2,12,14,171664,1081806,1253470,193.2,223.7,416.9
2020-09-19 16:00:00+08,2,10,12,171664,912430,1084094,201.18,227.18,428.36
2020-09-19 20:00:00+08,2,8,10,171664,814064,985728,209.18,203.1,412.28
2020-09-20 00:00:00+08,2,8,10,171664,836230,1007894,217.18,183.18,400.36
2020-09-20 04:00:00+08,2,6,8,171664,633166,804830,162.02,121.86,283.88
2020-09-20 08:00:00+08,2,8,10,171664,867516,1039180,170.02,149.32,319.34
2020-09-20 12:00:00+08,2,6,8,171664,589702,761366,178.02,71.82,249.84
2020-09-20 16:00:00+08,2,8,10,171664,881794,1053458,186.02,101.2,287.22
2020-09-20 20:00:00+08,2,8,10,171664,881794,1053458,194.02,133.2,327.22
2020-09-21 00:00:00+08,2,8,10,171664,881658,1053322,202.02,106.92,308.94
2020-09-21 04:00:00+08,2,8,10,171664,881658,1053322,210.02,138.92,348.94
2020-09-21 08:00:00+08,2,10,12,171664,1091826,1263490,218.02,177.58,395.6
2020-09-21 12:00:00+08,2,8,10,171664,837674,1009338,226.02,145.36,371.38
2020-09-21 16:00:00+08,2,4,6,171664,502260,673924,234.02,76.06,310.08
2020-09-21 20:00:00+08,2,8,10,171664,832716,1004380,242.02,96.56,338.58
2020-09-22 00:00:00+08,2,8,10,171664,832716,1004380,250.02,128.56,378.58
2020-09-22 04:00:00+08,4,8,12,389204,832716,1221920,258.14,160.56,418.7
2020-09-22 08:00:00+08,4,8,12,389204,932324,1321528,274.14,167.64,441.78
2020-09-22 12:00:00+08,4,8,12,389204,932324,1321528,290.14,199.64,489.78
2020-09-22 16:00:00+08,2,8,10,171664,932324,1103988,282.02,231.64,513.66
2020-09-22 20:00:00+08,4,12,16,240190,1385562,1625752,324.12,244,568.12
2020-09-23 00:00:00+08,4,14,18,240190,1533162,1773352,340.12,293.54,633.66
2020-09-23 04:00:00+08,6,14,20,533746,1533162,2066908,363.06,349.54,712.6
2020-09-23 08:00:00+08,6,14,20,533746,1494658,2028404,387.02,305.74,692.76
2020-09-23 12:00:00+08,6,14,20,533746,1393686,1927432,411.06,331.94,743
2020-09-23 16:00:00+08,4,12,16,465220,1101594,1566814,391.16,238.54,629.7
2020-09-23 20:00:00+08,4,16,20,465220,1401520,1866740,454.76,291.94,746.7
2020-09-24 00:00:00+08,4,16,20,465220,1401520,1866740,470.76,355.94,826.7
2020-09-24 04:00:00+08,2,14,16,293556,1326468,1620024,102.48,312,414.48
2020-09-24 08:00:00+08,2,10,12,293556,1079554,1373110,466.58,188.54,655.12
2020-09-24 12:00:00+08,2,12,14,293556,1297226,1590782,474.58,234.48,709.06
2020-09-24 16:00:00+08,2,10,12,293556,1228700,1522256,435.04,238.16,673.2
2020-09-24 20:00:00+08,2,14,16,293556,1585590,1879146,443.04,285.98,729.02
2020-09-25 00:00:00+08,2,16,18,293556,1704294,1997850,451.04,344.78,795.82
2020-09-25 04:00:00+08,2,14,16,293556,1472894,1766450,459.04,343.72,802.76
2020-09-25 08:00:00+08,2,14,16,293556,1472894,1766450,467.04,399.72,866.76
2020-09-25 12:00:00+08,4,12,16,537776,1179082,1716858,482.12,279.32,761.44
2020-09-25 16:00:00+08,2,10,12,244220,961410,1205630,371.22,265.38,636.6
2020-09-25 20:00:00+08,4,20,24,490138,1887970,2378108,512.96,319.22,832.18
2020-09-26 00:00:00+08,2,24,26,244220,2429870,2674090,528.42,353.48,881.9
2020-09-26 04:00:00+08,2,22,24,244220,2284070,2528290,536.42,381.8,918.22
2020-09-26 08:00:00+08,2,22,24,244220,2488068,2732288,544.48,449.42,993.9
2020-09-26 12:00:00+08,2,24,26,244220,2563474,2807694,552.42,461.36,1013.78
2020-09-26 16:00:00+08,0,20,20,0,2074086,2074086,497.28,392.28,889.56
2020-09-26 20:00:00+08,0,20,20,0,2191906,2191906,564.22,435.88,1000.1
2020-09-27 00:00:00+08,0,20,20,0,2191906,2191906,564.22,515.88,1080.1
2020-09-27 04:00:00+08,0,20,20,0,2191906,2191906,564.22,595.88,1160.1
2020-09-27 08:00:00+08,0,18,18,0,1981034,1981034,564.24,600.6,1164.84
2020-09-27 12:00:00+08,0,18,18,0,1981034,1981034,564.24,672.6,1236.84
2020-09-27 16:00:00+08,0,12,12,0,1285502,1285502,433.58,526.36,959.94
2020-09-27 20:00:00+08,0,20,20,0,1857092,1857092,433.56,593.54,1027.1
2020-09-28 00:00:00+08,0,22,22,0,2168046,2168046,433.56,602.54,1036.1
2020-09-28 04:00:00+08,0,20,20,0,1947272,1947272,433.64,576.92,1010.56
2020-09-28 08:00:00+08,0,16,16,0,1457134,1457134,356.12,468.18,824.3
2020-09-28 12:00:00+08,0,16,16,0,1595772,1595772,356.12,504.04,860.16
2020-09-28 16:00:00+08,2,16,18,148954,1595772,1744726,358.38,568.04,926.42
2020-09-28 20:00:00+08,0,18,18,0,1697322,1697322,356.12,633.3,989.42
2020-09-29 00:00:00+08,0,18,18,0,1493552,1493552,372.8,500.34,873.14
2020-09-29 04:00:00+08,2,20,22,207336,1712874,1920210,377.52,520.14,897.66
2020-09-29 08:00:00+08,2,22,24,207336,1911006,2118342,385.5,603.7,989.2
2020-09-29 12:00:00+08,2,4,6,207336,343402,550738,376.8,340.76,717.56
2020-09-29 16:00:00+08,2,4,6,207336,343402,550738,384.8,356.76,741.56
2020-09-29 20:00:00+08,2,4,6,207336,343402,550738,392.8,372.76,765.56
2020-09-30 00:00:00+08,2,4,6,207336,343402,550738,400.8,388.76,789.56
2020-09-30 04:00:00+08,2,4,6,207336,343402,550738,408.8,404.76,813.56
2020-09-30 08:00:00+08,2,4,6,207336,343402,550738,416.8,420.76,837.56
2020-09-30 12:00:00+08,2,4,6,207336,343402,550738,424.8,436.76,861.56
2020-09-30 16:00:00+08,2,4,6,207336,343402,550738,432.8,452.76,885.56
2020-09-30 20:00:00+08,0,16,16,0,1596724,1596724,440.66,469.24,909.9
2020-10-01 00:00:00+08,0,24,24,0,2457374,2457374,440.8,563.88,1004.68
2020-10-01 04:00:00+08,0,22,22,0,2280036,2280036,440.68,644.08,1084.76
2020-10-01 08:00:00+08,0,22,22,0,2475588,2475588,440.64,714.22,1154.86
2020-10-01 12:00:00+08,0,22,22,0,2475588,2475588,440.64,802.22,1242.86
2020-10-01 16:00:00+08,0,22,22,0,2475588,2475588,440.64,890.22,1330.86
2020-10-01 20:00:00+08,0,20,20,0,2167478,2167478,0,524.8,524.8
2020-10-02 00:00:00+08,0,22,22,0,2234860,2234860,0,607.2,607.2
2020-10-02 04:00:00+08,2,24,26,297984,2539548,2837532,3.38,696.26,699.64
2020-10-02 08:00:00+08,2,20,22,297984,2149200,2447184,11.38,648.4,659.78
2020-10-02 12:00:00+08,2,20,22,297984,2149200,2447184,19.38,728.4,747.78
2020-10-02 16:00:00+08,0,12,12,0,1447622,1447622,0,554.32,554.32
2020-10-02 20:00:00+08,0,18,18,0,1925228,1925228,29.52,614.64,644.16
2020-10-03 00:00:00+08,0,20,20,0,2040966,2040966,29.6,582.94,612.54
2020-10-03 04:00:00+08,0,20,20,0,2099196,2099196,43.2,595.84,639.04
2020-10-03 08:00:00+08,0,20,20,0,2099196,2099196,43.2,675.84,719.04
2020-10-03 12:00:00+08,0,18,18,0,2045574,2045574,43.2,720.92,764.12
2020-10-03 16:00:00+08,0,14,14,0,1655698,1655698,43.2,631.24,674.44
2020-10-03 20:00:00+08,0,16,16,0,1872296,1872296,43.22,690.98,734.2
2020-10-04 00:00:00+08,0,12,12,0,1452968,1452968,43.26,617.64,660.9
2020-10-04 04:00:00+08,0,10,10,0,1172676,1172676,43.22,505.74,548.96
2020-10-04 08:00:00+08,0,10,10,0,1172676,1172676,43.22,545.74,588.96
2020-10-04 12:00:00+08,0,8,8,0,880802,880802,43.2,513.58,556.78
2020-10-04 16:00:00+08,0,4,4,0,469722,469722,29.58,428.72,458.3
2020-10-04 20:00:00+08,0,12,12,0,1408572,1408572,29.56,461.82,491.38
2020-10-05 00:00:00+08,0,12,12,0,1210800,1210800,0,401.86,401.86
2020-10-05 04:00:00+08,0,12,12,0,1210800,1210800,0,449.86,449.86
2020-10-05 08:00:00+08,0,14,14,0,1432400,1432400,0,503.64,503.64
2020-10-05 12:00:00+08,0,14,14,0,1432400,1432400,0,559.64,559.64
2020-10-05 16:00:00+08,0,14,14,0,1432400,1432400,0,615.64,615.64
2020-10-05 20:00:00+08,0,18,18,0,1438790,1438790,0,582.94,582.94
2020-10-06 00:00:00+08,0,20,20,0,1702860,1702860,0,657.86,657.86
2020-10-06 04:00:00+08,0,22,22,0,1910406,1910406,0,743.14,743.14
2020-10-06 08:00:00+08,0,16,16,0,1631856,1631856,0,704.54,704.54
2020-10-06 12:00:00+08,0,14,14,0,1426134,1426134,0,684.1,684.1
2020-10-06 16:00:00+08,0,14,14,0,1426134,1426134,0,740.1,740.1
2020-10-06 20:00:00+08,0,20,20,0,2187382,2187382,0,732.72,732.72
2020-10-07 00:00:00+08,2,20,22,181268,2136726,2317994,1.64,803.26,804.9
2020-10-07 04:00:00+08,0,20,20,0,2137336,2137336,0,828.52,828.52
2020-10-07 08:00:00+08,0,20,20,0,1973922,1973922,12.54,734.64,747.18
2020-10-07 12:00:00+08,0,22,22,0,2267218,2267218,12.54,821.24,833.78
2020-10-07 16:00:00+08,0,18,18,0,1844314,1844314,12.52,736.38,748.9
2020-10-07 20:00:00+08,0,16,16,0,1674904,1674904,12.52,757.22,769.74
2020-10-08 00:00:00+08,0,16,16,0,1674904,1674904,12.52,821.22,833.74
2020-10-08 04:00:00+08,0,16,16,0,1674904,1674904,12.52,885.22,897.74
2020-10-08 08:00:00+08,0,18,18,0,1916792,1916792,12.48,952.4,964.88
2020-10-08 12:00:00+08,0,16,16,0,1847592,1847592,12.48,957.54,970.02
2020-10-08 16:00:00+08,0,16,16,0,1847592,1847592,12.48,1021.54,1034.02
2020-10-08 20:00:00+08,0,18,18,0,1811756,1811756,12.48,898.58,911.06
2020-10-09 00:00:00+08,0,20,20,0,1988100,1988100,12.56,889.66,902.22
2020-10-09 04:00:00+08,0,18,18,0,1675878,1675878,0,795.24,795.24
2020-10-09 08:00:00+08,0,20,20,0,1883214,1883214,0,871.44,871.44
2020-10-09 12:00:00+08,0,16,16,0,1640128,1640128,0,889.4,889.4
2020-10-09 16:00:00+08,0,14,14,0,1403714,1403714,0,768.12,768.12
2020-10-09 20:00:00+08,0,22,22,0,2242954,2242954,0,784.28,784.28
2020-10-10 00:00:00+08,0,22,22,0,2242954,2242954,0,872.28,872.28
2020-10-10 04:00:00+08,0,22,22,0,2242954,2242954,0,960.28,960.28
2020-10-10 08:00:00+08,0,24,24,0,2391964,2391964,0,1054.2,1054.2
2020-10-10 12:00:00+08,0,22,22,0,2265174,2265174,0,1118.1,1118.1
2020-10-10 16:00:00+08,0,20,20,0,2095624,2095624,0,1162.28,1162.28
2020-10-10 20:00:00+08,0,18,18,0,1859488,1859488,0,964.02,964.02
2020-10-11 00:00:00+08,2,18,20,281130,1754454,2035584,5.7,907.7,913.4
2020-10-11 04:00:00+08,2,16,18,281130,1535302,1816432,13.7,912.42,926.12
2020-10-11 08:00:00+08,2,20,22,281130,1944412,2225542,21.7,985.82,1007.52
2020-10-11 12:00:00+08,2,18,20,281130,1785566,2066696,29.7,983.22,1012.92
2020-10-11 16:00:00+08,2,14,16,281130,1543362,1824492,37.7,980.24,1017.94
2020-10-11 20:00:00+08,2,16,18,281130,1854588,2135718,45.7,1000.26,1045.96
2020-10-12 00:00:00+08,2,16,18,281130,1854588,2135718,53.7,1064.26,1117.96
2020-10-12 04:00:00+08,2,18,20,281130,2081544,2362674,61.7,1134.96,1196.66
2020-10-12 08:00:00+08,4,18,22,382388,2005274,2387662,74.98,1009.62,1084.6
2020-10-12 12:00:00+08,4,18,22,382388,2005274,2387662,90.98,1081.62,1172.6
2020-10-12 16:00:00+08,4,16,20,382388,1797938,2180326,106.98,1084.72,1191.7
2020-10-12 20:00:00+08,4,18,22,382388,1827530,2209918,122.98,1045.58,1168.56
2020-10-13 00:00:00+08,6,20,26,601652,1976280,2577932,141.14,1125.38,1266.52
2020-10-13 04:00:00+08,6,18,24,601652,1795394,2397046,165.14,1158.02,1323.16
2020-10-13 08:00:00+08,6,20,26,601652,1595634,2197286,189.14,1000.76,1189.9
2020-10-13 12:00:00+08,6,18,24,601652,1558990,2160642,213.14,1044.04,1257.18
2020-10-13 16:00:00+08,4,16,20,500394,1410240,1910634,167.82,1076.24,1244.06
2020-10-13 20:00:00+08,0,22,22,0,1932570,1932570,215.68,1049.3,1264.98
2020-10-14 00:00:00+08,0,24,24,0,2418894,2418894,259.84,1106.22,1366.06
2020-10-14 04:00:00+08,0,26,26,0,2487472,2487472,259.84,1208.84,1468.68
2020-10-14 08:00:00+08,0,26,26,0,2596746,2596746,259.84,1259.26,1519.1
2020-10-14 12:00:00+08,0,24,24,0,2542852,2542852,259.84,1329.76,1589.6
2020-10-14 16:00:00+08,2,18,20,118704,1803790,1922494,267.24,1149.72,1416.96
2020-10-14 20:00:00+08,2,22,24,118704,2175384,2294088,201.14,1087.72,1288.86
2020-10-15 00:00:00+08,2,22,24,118704,2175384,2294088,209.14,1175.72,1384.86
2020-10-15 04:00:00+08,2,22,24,118704,2175384,2294088,217.14,1263.72,1480.86
2020-10-15 08:00:00+08,2,20,22,118704,2006008,2124712,225.14,1321.02,1546.16
2020-10-15 12:00:00+08,0,12,12,0,1359470,1359470,141.66,1159.3,1300.96
2020-10-15 16:00:00+08,0,10,10,0,1210460,1210460,141.66,1163.72,1305.38
2020-10-15 20:00:00+08,2,16,18,245922,1735462,1981384,203.12,1214.28,1417.4
2020-10-16 00:00:00+08,0,18,18,0,1946882,1946882,210.98,1224.58,1435.56
2020-10-16 04:00:00+08,0,16,16,0,1653700,1653700,210.96,1181,1391.96
2020-10-16 08:00:00+08,0,16,16,0,1653700,1653700,210.96,1245,1455.96
2020-10-16 12:00:00+08,0,16,16,0,1653700,1653700,210.96,1309,1519.96
2020-10-16 16:00:00+08,0,14,14,0,1372570,1372570,69.3,1236.98,1306.28
2020-10-16 20:00:00+08,0,16,16,0,1746752,1746752,69.32,1211.54,1280.86
2020-10-17 00:00:00+08,2,16,18,101738,1746752,1848490,70.86,1275.54,1346.4
2020-10-17 04:00:00+08,4,18,22,333938,1964134,2298072,79.46,1347.46,1426.92
2020-10-17 08:00:00+08,4,22,26,333938,2257030,2590968,95.44,1429.66,1525.1
2020-10-17 12:00:00+08,4,22,26,333938,2257030,2590968,111.44,1517.66,1629.1
2020-10-17 16:00:00+08,2,16,18,101738,1539876,1641614,102.9,1295.94,1398.84
2020-10-17 20:00:00+08,0,16,16,0,1647596,1647596,10.56,1264.04,1274.6
2020-10-18 00:00:00+08,0,18,18,0,1735612,1735612,75.28,1246.74,1322.02
2020-10-18 04:00:00+08,0,18,18,0,1668654,1668654,75.28,1275.64,1350.92
2020-10-18 08:00:00+08,0,20,20,0,1930722,1930722,75.3,1352.94,1428.24
2020-10-18 12:00:00+08,0,20,20,0,2022946,2022946,75.28,1354.54,1429.82
2020-10-18 16:00:00+08,0,20,20,0,2022946,2022946,75.28,1434.54,1509.82
2020-10-18 20:00:00+08,0,18,18,0,1955564,1955564,75.28,1481.56,1556.84
2020-10-19 00:00:00+08,2,14,16,32794,1491012,1523806,33.54,1209.5,1243.04
2020-10-19 04:00:00+08,2,18,20,32794,1975982,2008776,21.06,1217.36,1238.42
2020-10-19 08:00:00+08,4,18,22,363870,1975982,2339852,36.9,1289.36,1326.26
2020-10-19 12:00:00+08,4,16,20,363870,1749558,2113428,52.9,1276.64,1329.54
2020-10-19 16:00:00+08,4,16,20,363870,1749558,2113428,68.9,1340.64,1409.54
2020-10-19 20:00:00+08,2,16,18,331076,1714446,2045522,44.24,1332.72,1376.96
2020-10-20 00:00:00+08,2,20,22,331076,1865912,2196988,98.54,1401.44,1499.98
2020-10-20 04:00:00+08,2,22,24,331076,1892038,2223114,106.56,1482.36,1588.92
2020-10-20 08:00:00+08,2,22,24,331076,1816454,2147530,114.56,1480.12,1594.68
2020-10-20 12:00:00+08,2,22,24,331076,1816454,2147530,122.56,1568.12,1690.68
2020-10-20 16:00:00+08,0,14,14,0,1265278,1265278,46.3,1320.52,1366.82
2020-10-20 20:00:00+08,0,12,12,0,1406892,1406892,74.68,1247.12,1321.8
2020-10-21 00:00:00+08,0,16,16,0,1777736,1777736,74.68,1298.12,1372.8
2020-10-21 04:00:00+08,0,14,14,0,1574116,1574116,74.68,1257.08,1331.76
2020-10-21 08:00:00+08,0,18,18,0,1904848,1904848,74.68,1324,1398.68
2020-10-21 12:00:00+08,0,18,18,0,1904848,1904848,74.68,1396,1470.68
2020-10-21 16:00:00+08,6,18,24,444194,1904848,2349042,79.34,1468,1547.34
2020-10-21 20:00:00+08,6,18,24,444194,1904848,2349042,103.34,1540,1643.34
2020-10-22 00:00:00+08,2,14,16,216430,1523694,1740124,76.62,1479.2,1555.82
2020-10-22 04:00:00+08,2,20,22,216430,1967888,2184318,150.96,1545.44,1696.4
2020-10-22 08:00:00+08,2,18,20,216430,1899564,2115994,158.96,1572.28,1731.24
2020-10-22 12:00:00+08,2,18,20,216430,1948274,2164704,182.1,1568.02,1750.12
2020-10-22 16:00:00+08,2,18,20,216430,1948274,2164704,190.1,1640.02,1830.12
2020-10-22 20:00:00+08,0,18,18,0,1948274,1948274,156.14,1712.02,1868.16
2020-10-23 00:00:00+08,0,14,14,0,1514128,1514128,156.1,483.44,639.54
2020-10-23 04:00:00+08,0,16,16,0,1681788,1681788,209.32,443.58,652.9
2020-10-23 08:00:00+08,2,20,22,231986,2009772,2241758,209.36,516.68,726.04
2020-10-23 12:00:00+08,2,18,20,231986,1838252,2070238,195.8,529.34,725.14
2020-10-23 16:00:00+08,6,18,24,813544,1655926,2469470,138.24,466.92,605.16
2020-10-23 20:00:00+08,6,18,24,588638,1655926,2244564,152.34,538.92,691.26
2020-10-24 00:00:00+08,0,16,16,0,1435090,1435090,108.24,311.96,420.2
2020-10-24 04:00:00+08,0,20,20,0,1727712,1727712,76.84,328.32,405.16
2020-10-24 08:00:00+08,0,24,24,0,2249000,2249000,127.28,313.58,440.86
2020-10-24 12:00:00+08,0,20,20,0,1905052,1905052,112.2,245.74,357.94
2020-10-24 16:00:00+08,0,18,18,0,1746132,1746132,112.2,249.12,361.32
2020-10-24 20:00:00+08,0,16,16,0,1662966,1662966,112.2,293.8,406
2020-10-25 00:00:00+08,2,16,18,126400,1630616,1757016,114.2,288,402.2
2020-10-25 04:00:00+08,2,18,20,126400,1683916,1810316,122.2,354.78,476.98
2020-10-25 08:00:00+08,2,18,20,126400,1683916,1810316,130.2,426.78,556.98
2020-10-25 12:00:00+08,2,16,18,126400,1476134,1602534,138.24,431.34,569.58
2020-10-25 16:00:00+08,2,14,16,126400,1243254,1369654,146.22,421.74,567.96
2020-10-25 20:00:00+08,0,18,18,0,1608736,1608736,131.84,402.92,534.76
2020-10-26 00:00:00+08,0,16,16,0,1492336,1492336,131.8,426.02,557.82
2020-10-26 04:00:00+08,0,20,20,0,1890064,1890064,131.76,494.72,626.48
2020-10-26 08:00:00+08,0,20,20,0,1889196,1889196,109.48,462.96,572.44
2020-10-26 12:00:00+08,0,14,14,0,1517876,1517876,68.1,336.34,404.44
2020-10-26 16:00:00+08,0,18,18,0,1978406,1978406,68.16,404.38,472.54
2020-10-26 20:00:00+08,0,16,16,0,1624350,1624350,41.58,303.2,344.78
2020-10-27 00:00:00+08,0,16,16,0,1624350,1624350,41.58,367.2,408.78
2020-10-27 04:00:00+08,0,16,16,0,1624350,1624350,41.58,431.2,472.78
2020-10-27 08:00:00+08,0,14,14,0,1446680,1446680,41.58,436.24,477.82
2020-10-27 12:00:00+08,0,14,14,0,1446680,1446680,41.58,492.24,533.82
2020-10-27 16:00:00+08,0,14,14,0,1446680,1446680,41.58,548.24,589.82
2020-10-27 20:00:00+08,0,8,8,0,860628,860628,0,226.58,226.58
2020-10-28 00:00:00+08,0,8,8,0,899822,899822,0,169.78,169.78
2020-10-28 04:00:00+08,0,12,12,0,1263716,1263716,0,123.22,123.22
2020-10-28 08:00:00+08,0,12,12,0,1263716,1263716,0,171.22,171.22
2020-10-28 12:00:00+08,0,18,18,0,1538088,1538088,0,234.38,234.38
2020-10-28 16:00:00+08,0,18,18,0,1538088,1538088,0,306.38,306.38
2020-10-28 20:00:00+08,0,20,20,0,1831104,1831104,0,335.2,335.2
2020-10-29 00:00:00+08,0,22,22,0,1934766,1934766,42.42,421.9,464.32
2020-10-29 04:00:00+08,2,18,20,241868,1705606,1947474,49.32,417.88,467.2
2020-10-29 08:00:00+08,0,16,16,0,1473406,1473406,42.44,426.64,469.08
2020-10-29 12:00:00+08,0,14,14,0,1484642,1484642,62.52,369.62,432.14
2020-10-29 16:00:00+08,0,12,12,0,1398456,1398456,20.08,382.24,402.32
2020-10-29 20:00:00+08,0,18,18,0,2023636,2023636,20.08,439.54,459.62
2020-10-30 00:00:00+08,0,12,12,0,1391462,1391462,20.08,215.36,235.44
2020-10-30 04:00:00+08,0,14,14,0,1680146,1680146,20.08,265.94,286.02
2020-10-30 08:00:00+08,0,16,16,0,1796546,1796546,20.08,326.02,346.1
2020-10-30 12:00:00+08,0,14,14,0,1472242,1472242,20.1,239.72,259.82
2020-10-30 16:00:00+08,0,14,14,0,1472242,1472242,20.1,295.72,315.82
2020-10-30 20:00:00+08,0,18,18,0,1803466,1803466,20.16,307.48,327.64
2020-10-31 00:00:00+08,0,20,20,0,1930266,1930266,20.16,381.78,401.94
2020-10-31 04:00:00+08,0,20,20,0,1930266,1930266,20.16,461.78,481.94
2020-10-31 08:00:00+08,0,22,22,0,2220740,2220740,20.16,548.08,568.24
2020-10-31 12:00:00+08,0,20,20,0,1828536,1828536,0,410.1,410.1
2020-10-31 16:00:00+08,0,20,20,0,1828536,1828536,0,490.16,490.16
2020-10-31 20:00:00+08,0,18,18,0,1613948,1613948,0,428.08,428.08
2020-11-01 00:00:00+08,0,14,14,0,1512806,1512806,0,290.1,290.1
2020-11-01 04:00:00+08,0,14,14,0,1506006,1506006,0,286.58,286.58
2020-11-01 08:00:00+08,0,16,16,0,1649936,1649936,0,331.98,331.98
2020-11-01 12:00:00+08,0,16,16,0,1649936,1649936,0,395.98,395.98
2020-11-01 16:00:00+08,0,16,16,0,1649936,1649936,0,459.98,459.98
2020-11-01 20:00:00+08,0,18,18,0,1772520,1772520,0,447.18,447.18
2020-11-02 00:00:00+08,0,18,18,0,1975282,1975282,0,437.48,437.48
2020-11-02 04:00:00+08,0,18,18,0,1885056,1885056,0,399.44,399.44
2020-11-02 08:00:00+08,2,18,20,228212,1885056,2113268,0.68,471.44,472.12
2020-11-02 12:00:00+08,0,18,18,0,1892494,1892494,4.2,473.04,477.24
2020-11-02 16:00:00+08,0,16,16,0,1686772,1686772,4.24,503.68,507.92
2020-11-02 20:00:00+08,0,18,18,0,1667612,1667612,4.2,392.86,397.06
2020-11-03 00:00:00+08,0,16,16,0,1588720,1588720,4.2,319.16,323.36
2020-11-03 04:00:00+08,0,20,20,0,2017810,2017810,4.3,395.62,399.92
2020-11-03 08:00:00+08,0,20,20,0,2017810,2017810,4.3,475.62,479.92
2020-11-03 12:00:00+08,0,16,16,0,1822184,1822184,4.3,412.36,416.66
2020-11-03 16:00:00+08,0,16,16,0,1822184,1822184,4.3,476.36,480.66
2020-11-03 20:00:00+08,0,16,16,0,1787932,1787932,4.16,337.2,341.36
2020-11-04 00:00:00+08,0,16,16,0,1724594,1724594,4.2,349.44,353.64
2020-11-04 04:00:00+08,0,16,16,0,1713930,1713930,4.2,367.48,371.68
2020-11-04 08:00:00+08,0,18,18,0,1743460,1743460,4.2,326.44,330.64
2020-11-04 12:00:00+08,0,16,16,0,1414284,1414284,0,269.52,269.52
2020-11-04 16:00:00+08,0,12,12,0,1031530,1031530,0,207.96,207.96
2020-11-04 20:00:00+08,0,16,16,0,1384264,1384264,0,259.8,259.8
2020-11-05 00:00:00+08,0,16,16,0,1384264,1384264,0,323.8,323.8
2020-11-05 04:00:00+08,0,16,16,0,1384264,1384264,0,387.8,387.8
2020-11-05 08:00:00+08,0,12,12,0,1256938,1256938,0,326.62,326.62
2020-11-05 12:00:00+08,0,12,12,0,1256938,1256938,0,374.62,374.62
2020-11-05 16:00:00+08,0,10,10,0,1188360,1188360,0,365.06,365.06
2020-11-05 20:00:00+08,2,14,16,237424,1518380,1755804,6.08,409.16,415.24
2020-11-06 00:00:00+08,0,12,12,0,1220934,1220934,0,380.04,380.04
2020-11-06 04:00:00+08,0,14,14,0,1458358,1458358,17.92,432.12,450.04
2020-11-06 08:00:00+08,0,10,10,0,1063080,1063080,17.94,177.1,195.04
2020-11-06 12:00:00+08,0,10,10,0,1147110,1147110,17.96,103.78,121.74
2020-11-06 16:00:00+08,0,8,8,0,1038796,1038796,17.96,101.72,119.68
2020-11-06 20:00:00+08,0,20,20,0,2109860,2109860,18,141.84,159.84
2020-11-07 00:00:00+08,0,20,20,0,2109860,2109860,18,221.84,239.84
2020-11-07 04:00:00+08,0,24,24,0,2431836,2431836,18,311.5,329.5
2020-11-07 08:00:00+08,0,20,20,0,2173580,2173580,17.94,308.46,326.4
2020-11-07 12:00:00+08,0,18,18,0,1981374,1981374,17.94,355.92,373.86
2020-11-07 16:00:00+08,0,20,20,0,2152946,2152946,17.94,433.66,451.6
2020-11-07 20:00:00+08,0,20,20,0,2152946,2152946,17.94,513.66,531.6
2020-11-08 00:00:00+08,0,20,20,0,2152946,2152946,17.94,593.66,611.6
2020-11-08 04:00:00+08,0,20,20,0,2246920,2246920,17.92,612.26,630.18
2020-11-08 08:00:00+08,0,18,18,0,2065890,2065890,0,526.24,526.24
2020-11-08 12:00:00+08,0,16,16,0,1731916,1731916,0,436.16,436.16
2020-11-08 16:00:00+08,0,14,14,0,1524580,1524580,0,420.66,420.66
2020-11-08 20:00:00+08,0,16,16,0,1731916,1731916,0,477.36,477.36
2020-11-09 00:00:00+08,4,16,20,242602,1731916,1974518,2.4,541.36,543.76
2020-11-09 04:00:00+08,4,18,22,242602,1764388,2006990,18.42,506.76,525.18
2020-11-09 08:00:00+08,4,16,20,242602,1592816,1835418,34.42,493,527.42
2020-11-09 12:00:00+08,4,12,16,242602,1390040,1632642,50.4,335.7,386.1
2020-11-09 16:00:00+08,0,14,14,0,1561070,1561070,0,390.7,390.7
2020-11-09 20:00:00+08,0,24,24,0,2135450,2135450,78,455.94,533.94
2020-11-10 00:00:00+08,0,26,26,0,2236514,2236514,78,552.22,630.22
2020-11-10 04:00:00+08,0,24,24,0,1948214,1948214,78,470.64,548.64
2020-11-10 08:00:00+08,0,26,26,0,2166214,2166214,77.98,574.12,652.1
2020-11-10 12:00:00+08,0,22,22,0,1948994,1948994,39.1,423.34,462.44
2020-11-10 16:00:00+08,0,20,20,0,1847474,1847474,39.1,469.74,508.84
2020-11-10 20:00:00+08,0,20,20,0,1875336,1875336,39.12,359.22,398.34
2020-11-11 00:00:00+08,0,22,22,0,1987296,1987296,39.06,344.22,383.28
2020-11-11 04:00:00+08,0,22,22,0,1987296,1987296,39.06,432.22,471.28
2020-11-11 08:00:00+08,0,20,20,0,2080716,2080716,39.06,430.8,469.86
2020-11-11 12:00:00+08,0,22,22,0,2162616,2162616,39.06,450.64,489.7
2020-11-11 16:00:00+08,0,22,22,0,2209558,2209558,39.06,498.6,537.66
2020-11-11 20:00:00+08,0,24,24,0,2299724,2299724,39.12,534.52,573.64
2020-11-12 00:00:00+08,0,24,24,0,2336056,2336056,0,470.4,470.4
2020-11-12 04:00:00+08,0,22,22,0,1974582,1974582,0,346.94,346.94
2020-11-12 08:00:00+08,0,22,22,0,2040682,2040682,0,400.72,400.72
2020-11-12 12:00:00+08,0,20,20,0,1972358,1972358,0,434.06,434.06
2020-11-12 16:00:00+08,2,16,18,227928,1710926,1938854,7.86,368.46,376.32
2020-11-12 20:00:00+08,2,22,24,66164,2384408,2450572,1.1,445.44,446.54
2020-11-13 00:00:00+08,2,20,22,66164,2348742,2414906,26.94,417.1,444.04
2020-11-13 04:00:00+08,2,20,22,66164,2348742,2414906,34.94,497.1,532.04
2020-11-13 08:00:00+08,2,20,22,66164,2438370,2504534,48,512.06,560.06
2020-11-13 12:00:00+08,2,20,22,66164,2438370,2504534,56,592.06,648.06
2020-11-13 16:00:00+08,2,22,24,66164,2654582,2720746,64.02,678.38,742.4
2020-11-13 20:00:00+08,2,18,20,66164,2165528,2231692,72.1,541.06,613.16
2020-11-14 00:00:00+08,0,20,20,0,2395882,2395882,22.92,618.48,641.4
2020-11-14 04:00:00+08,0,20,20,0,2223728,2223728,86.18,596.08,682.26
2020-11-14 08:00:00+08,0,18,18,0,1993656,1993656,86.24,597.18,683.42
2020-11-14 12:00:00+08,0,20,20,0,2287200,2287200,86.24,676.6,762.84
2020-11-14 16:00:00+08,0,18,18,0,1989754,1989754,86.24,664.08,750.32
2020-11-14 20:00:00+08,0,18,18,0,1950068,1950068,86.24,640.26,726.5
2020-11-15 00:00:00+08,0,18,18,0,1927764,1927764,81.12,511.78,592.9
2020-11-15 04:00:00+08,0,12,12,0,1417460,1417460,0,345.68,345.68
2020-11-15 08:00:00+08,0,14,14,0,1643604,1643604,0,395.62,395.62
2020-11-15 12:00:00+08,0,14,14,0,1643604,1643604,0,451.62,451.62
2020-11-15 16:00:00+08,0,10,10,0,1244152,1244152,0,239.62,239.62
2020-11-15 20:00:00+08,0,12,12,0,1422434,1422434,0,188.56,188.56
2020-11-16 00:00:00+08,2,12,14,94232,1422434,1516666,87.26,236.56,323.82
2020-11-16 04:00:00+08,2,14,16,94232,1627038,1721270,95.26,285.54,380.8
2020-11-16 08:00:00+08,2,16,18,94232,1721644,1815876,103.26,274.42,377.68
2020-11-16 12:00:00+08,2,14,16,94232,1495500,1589732,111.26,280.48,391.74
2020-11-16 16:00:00+08,2,14,16,94232,1495500,1589732,119.26,336.48,455.74
2020-11-16 20:00:00+08,2,16,18,94232,1449530,1543762,127.26,278.6,405.86
2020-11-17 00:00:00+08,2,16,18,94232,1524220,1618452,135.26,285.96,421.22
2020-11-17 04:00:00+08,2,18,20,94232,1724232,1818464,143.26,356.76,500.02
2020-11-17 08:00:00+08,2,18,20,94232,1934126,2028358,151.26,408,559.26
2020-11-17 12:00:00+08,2,18,20,94232,1934126,2028358,159.26,480,639.26
2020-11-17 16:00:00+08,2,16,18,94232,1741920,1836152,167.26,462.88,630.14
2020-11-17 20:00:00+08,2,16,18,94232,1722038,1816270,175.26,481.72,656.98
2020-11-18 00:00:00+08,2,16,18,94232,1759128,1853360,183.26,457.82,641.08
2020-11-18 04:00:00+08,2,14,16,94232,1658064,1752296,191.26,455.92,647.18
2020-11-18 08:00:00+08,2,16,18,94232,1942456,2036688,199.26,492.94,692.2
2020-11-18 12:00:00+08,2,16,18,94232,1793042,1887274,207.26,453.64,660.9
2020-11-18 16:00:00+08,0,16,16,0,1711260,1711260,0,454.38,454.38
2020-11-18 20:00:00+08,0,22,22,0,2196882,2196882,222.68,439.72,662.4
2020-11-19 00:00:00+08,0,20,20,0,1903338,1903338,222.68,304.3,526.98
2020-11-19 04:00:00+08,2,20,22,210640,1983808,2194448,223.84,288.42,512.26
2020-11-19 08:00:00+08,2,24,26,210640,2399188,2609828,231.88,371.7,603.58
2020-11-19 12:00:00+08,0,24,24,0,2378428,2378428,239.58,407.22,646.8
2020-11-19 16:00:00+08,0,18,18,0,1910094,1910094,239.52,333.7,573.22
2020-11-19 20:00:00+08,0,18,18,0,1862352,1862352,16.84,269.52,286.36
2020-11-20 00:00:00+08,0,16,16,0,1555312,1555312,16.84,283.42,300.26
2020-11-20 04:00:00+08,0,18,18,0,1702022,1702022,16.84,353.66,370.5
2020-11-20 08:00:00+08,0,20,20,0,1909250,1909250,16.8,433.22,450.02
2020-11-20 12:00:00+08,0,20,20,0,1909250,1909250,16.8,513.22,530.02
2020-11-20 16:00:00+08,0,14,14,0,1495002,1495002,16.8,360.52,377.32
2020-11-20 20:00:00+08,0,20,20,0,2092450,2092450,16.8,424.22,441.02
2020-11-21 00:00:00+08,0,18,18,0,1968436,1968436,16.8,421.04,437.84
2020-11-21 04:00:00+08,0,18,18,0,1968436,1968436,16.8,493.04,509.84
2020-11-21 08:00:00+08,0,22,22,0,2310112,2310112,16.88,571.28,588.16
2020-11-21 12:00:00+08,0,18,18,0,1952762,1952762,0,492.78,492.78
2020-11-21 16:00:00+08,0,14,14,0,1510972,1510972,0,405.06,405.06
2020-11-21 20:00:00+08,0,18,18,0,1964294,1964294,0,413.92,413.92
2020-11-22 00:00:00+08,0,18,18,0,1831896,1831896,0,306.74,306.74
2020-11-22 04:00:00+08,0,16,16,0,1697556,1697556,0,336.58,336.58
2020-11-22 08:00:00+08,0,16,16,0,1877618,1877618,0,379.74,379.74
2020-11-22 12:00:00+08,0,12,12,0,1471148,1471148,0,243.3,243.3
2020-11-22 16:00:00+08,0,14,14,0,1633490,1633490,0,292.76,292.76
2020-11-22 20:00:00+08,0,16,16,0,1734838,1734838,0,275.94,275.94
2020-11-23 00:00:00+08,0,14,14,0,1403532,1403532,0,233.16,233.16
2020-11-23 04:00:00+08,2,16,18,84164,1621072,1705236,4,296.72,300.72
2020-11-23 08:00:00+08,4,18,22,312414,1699238,2011652,12.28,364.74,377.02
2020-11-23 12:00:00+08,4,14,18,312414,1177938,1490352,28.28,250.5,278.78
2020-11-23 16:00:00+08,2,10,12,84164,998222,1082386,28.02,244.54,272.56
2020-11-23 20:00:00+08,2,10,12,84164,1064130,1148294,58.52,228.86,287.38
2020-11-24 00:00:00+08,2,14,16,84164,1577456,1661620,66.5,278.3,344.8
2020-11-24 04:00:00+08,4,12,16,377010,1458210,1835220,79.82,271.04,350.86
2020-11-24 08:00:00+08,4,14,18,377010,1675592,2052602,95.84,322.3,418.14
2020-11-24 12:00:00+08,2,12,14,84164,1468458,1552622,90.48,296.96,387.44
2020-11-24 16:00:00+08,2,12,14,84164,1468458,1552622,98.48,344.96,443.44
2020-11-24 20:00:00+08,0,16,16,0,1730224,1730224,54.22,178.26,232.48
2020-11-25 00:00:00+08,0,22,22,0,2266526,2266526,140.16,262.42,402.58
2020-11-25 04:00:00+08,0,24,24,0,2303170,2303170,140.16,352.38,492.54
2020-11-25 08:00:00+08,2,22,24,130330,2074920,2205250,118.14,374.6,492.74
2020-11-25 12:00:00+08,2,24,26,130330,2052380,2182710,126.14,411,537.14
2020-11-25 16:00:00+08,2,22,24,130330,1968216,2098546,48.22,468.92,517.14
2020-11-25 20:00:00+08,2,26,28,130330,2457318,2587648,56.22,570.28,626.5
2020-11-26 00:00:00+08,2,24,26,130330,2316138,2446468,64.22,617.2,681.42
2020-11-26 04:00:00+08,2,24,26,298100,2207070,2505170,35.14,627.82,662.96
2020-11-26 08:00:00+08,2,24,26,298100,2340952,2639052,103.06,548.2,651.26
2020-11-26 12:00:00+08,2,22,24,298100,2033348,2331448,111.06,522.74,633.8
2020-11-26 16:00:00+08,0,14,14,0,1559902,1559902,91.6,338.64,430.24
2020-11-26 20:00:00+08,0,10,10,0,1192226,1192226,125.66,207.7,333.36
2020-11-27 00:00:00+08,2,8,10,145964,967194,1113158,130.14,185.3,315.44
2020-11-27 04:00:00+08,2,8,10,145964,967194,1113158,138.14,217.3,355.44
2020-11-27 08:00:00+08,2,8,10,145964,967194,1113158,146.14,249.3,395.44
2020-11-27 12:00:00+08,2,8,10,145964,967194,1113158,154.14,281.3,435.44
2020-11-27 16:00:00+08,2,8,10,145964,967194,1113158,162.14,313.3,475.44
2020-11-27 20:00:00+08,2,14,16,145964,1494934,1640898,170.08,351.2,521.28
2020-11-28 00:00:00+08,2,18,20,145964,1894958,2040922,178.08,421.6,599.68
2020-11-28 04:00:00+08,2,20,22,145964,2178106,2324070,186.06,494.88,680.94
2020-11-28 08:00:00+08,2,22,24,145964,2409506,2555470,194.08,576.56,770.64
2020-11-28 12:00:00+08,2,22,24,145964,2409506,2555470,202.08,664.56,866.64
2020-11-28 16:00:00+08,4,20,24,246564,2283518,2530082,213.44,711.64,925.08
2020-11-28 20:00:00+08,4,24,28,246564,2631318,2877882,229.36,794.12,1023.48
2020-11-29 00:00:00+08,4,22,26,246564,2500988,2747552,198.4,760.64,959.04
2020-11-29 04:00:00+08,4,20,24,246564,2353388,2599952,214.4,780.76,995.16
2020-11-29 08:00:00+08,4,22,26,246564,2413850,2660414,230.4,862.96,1093.36
2020-11-29 12:00:00+08,6,16,22,348302,1766862,2115164,236.52,661.72,898.24
2020-11-29 16:00:00+08,4,14,18,202338,1650462,1852800,128,684.24,812.24
2020-11-29 20:00:00+08,2,20,22,101738,1996288,2098026,192.34,503.28,695.62
2020-11-30 00:00:00+08,6,20,26,337596,1842736,2180332,270.6,478.66,749.26
2020-11-30 04:00:00+08,6,22,28,337596,2112024,2449620,294.62,496.96,791.58
2020-11-30 08:00:00+08,8,20,28,437808,2044642,2482450,324.66,555.4,880.06
2020-11-30 12:00:00+08,8,16,24,437808,1762474,2200282,356.7,544.8,901.5
2020-11-30 16:00:00+08,4,16,20,201950,1889218,2091168,321.22,569.78,891
2020-11-30 20:00:00+08,6,20,26,405570,2125076,2530646,419.36,637.28,1056.64
2020-12-01 00:00:00+08,6,20,26,405570,2126122,2531692,443.36,572.08,1015.44
2020-12-01 04:00:00+08,6,20,26,405570,2126122,2531692,467.36,652.08,1119.44
2020-12-01 08:00:00+08,6,18,24,405570,1842974,2248544,491.32,578.82,1070.14
2020-12-01 12:00:00+08,6,18,24,405570,1842974,2248544,515.32,650.82,1166.14
2020-12-01 16:00:00+08,6,16,22,405570,1623504,2029074,539.32,649.4,1188.72
2020-12-01 20:00:00+08,6,18,24,405570,1987168,2392738,489.24,427.64,916.88
2020-12-02 00:00:00+08,6,20,26,405570,2042542,2448112,373.92,400.72,774.64
2020-12-02 04:00:00+08,4,20,24,316810,2042542,2359352,208.42,480.72,689.14
2020-12-02 08:00:00+08,4,20,24,316810,2043680,2360490,292.84,452.02,744.86
2020-12-02 12:00:00+08,4,16,20,316810,1609216,1926026,268.94,372.6,641.54
2020-12-02 16:00:00+08,2,14,16,100212,1583090,1683302,253.3,404.16,657.46
2020-12-02 20:00:00+08,2,20,22,100212,2031166,2131378,298.66,464.48,763.14
2020-12-03 00:00:00+08,4,18,22,170254,1700802,1871056,313.22,430.04,743.26
2020-12-03 04:00:00+08,2,14,16,100212,1355854,1456066,314.7,376.12,690.82
2020-12-03 08:00:00+08,0,18,18,0,1583282,1583282,190.22,440.64,630.86
2020-12-03 12:00:00+08,0,18,18,0,1466896,1466896,309.04,480.26,789.3
2020-12-03 16:00:00+08,0,18,18,0,1466896,1466896,309.04,552.26,861.3
2020-12-03 20:00:00+08,0,16,16,0,1405804,1405804,173.74,402.22,575.96
2020-12-04 00:00:00+08,0,16,16,0,1324592,1324592,173.74,286.76,460.5
2020-12-04 04:00:00+08,0,20,20,0,1573868,1573868,173.74,365.7,539.44
2020-12-04 08:00:00+08,0,18,18,0,1319690,1319690,173.78,251.98,425.76
2020-12-04 12:00:00+08,0,18,18,0,1420640,1420640,173.74,296.34,470.08
2020-12-04 16:00:00+08,0,14,14,0,1250386,1250386,0,241.54,241.54
2020-12-04 20:00:00+08,0,14,14,0,1219400,1219400,0,225.54,225.54
2020-12-05 00:00:00+08,0,14,14,0,1219400,1219400,0,281.54,281.54
2020-12-05 04:00:00+08,0,20,20,0,1856472,1856472,0,354.02,354.02
2020-12-05 08:00:00+08,0,18,18,0,1612602,1612602,0,300.22,300.22
2020-12-05 12:00:00+08,0,18,18,0,1806530,1806530,0,289.96,289.96
2020-12-05 16:00:00+08,0,14,14,0,1538134,1538134,0,196.46,196.46
2020-12-05 20:00:00+08,2,14,16,36550,1633558,1670108,2.72,220,222.72
2020-12-06 00:00:00+08,2,14,16,181268,1505046,1686314,6.22,203.28,209.5
2020-12-06 04:00:00+08,2,18,20,181268,1713022,1894290,30.82,269.02,299.84
2020-12-06 08:00:00+08,2,18,20,181268,1803682,1984950,38.82,320.82,359.64
2020-12-06 12:00:00+08,2,18,20,181268,1985132,2166400,30.16,382.68,412.84
2020-12-06 16:00:00+08,4,14,18,415132,1546968,1962100,45.16,307.84,353
2020-12-06 20:00:00+08,4,14,18,415132,1546968,1962100,61.16,363.84,425
2020-12-07 00:00:00+08,4,16,20,415132,1705814,2120946,77.16,426.92,504.08
2020-12-07 04:00:00+08,4,14,18,415132,1534174,1949306,93.16,405.94,499.1
2020-12-07 08:00:00+08,4,14,18,415132,1617468,2032600,109.14,399.78,508.92
2020-12-07 12:00:00+08,2,12,14,181268,1385482,1566750,78.22,374.8,453.02
2020-12-07 16:00:00+08,2,10,12,181268,1231970,1413238,136.9,297.32,434.22
2020-12-07 20:00:00+08,4,14,18,282526,1770410,2052936,148.98,345.46,494.44
2020-12-08 00:00:00+08,4,16,20,282526,1977706,2260232,164.98,406.24,571.22
2020-12-08 04:00:00+08,4,14,18,282526,1689098,1971624,180.98,190.76,371.74
2020-12-08 08:00:00+08,4,14,18,282526,1689098,1971624,196.98,246.76,443.74
2020-12-08 12:00:00+08,4,12,16,282526,1358348,1640874,212.98,263.5,476.48
2020-12-08 16:00:00+08,4,10,14,282526,1199502,1482028,228.98,224.42,453.4
2020-12-08 20:00:00+08,4,10,14,282526,1147182,1429708,244.84,191.86,436.7
2020-12-09 00:00:00+08,4,14,18,282526,1546852,1829378,260.96,243.22,504.18
2020-12-09 04:00:00+08,6,16,22,524220,1703108,2227328,231.56,233.84,465.4
2020-12-09 08:00:00+08,6,18,24,524220,1737490,2261710,255.56,300.62,556.18
2020-12-09 12:00:00+08,4,18,22,282526,1598428,1880954,258.28,292.94,551.22
2020-12-09 16:00:00+08,4,20,24,282526,1840122,2122648,298.42,370.08,668.5
2020-12-09 20:00:00+08,4,22,26,282526,2071522,2354048,314.42,457.7,772.12
2020-12-10 00:00:00+08,2,20,22,101258,1982962,2084220,132.34,395.4,527.74
2020-12-10 04:00:00+08,4,24,28,343146,2190352,2533498,340.46,487.18,827.64
2020-12-10 08:00:00+08,2,24,26,241888,2209270,2451158,232.42,538.6,771.02
2020-12-10 12:00:00+08,2,20,22,241888,1978300,2220188,240.42,518.08,758.5
2020-12-10 16:00:00+08,0,18,18,0,1780876,1780876,360.36,281.14,641.5
2020-12-10 20:00:00+08,0,20,20,0,1916914,1916914,360.36,302.9,663.26
2020-12-11 00:00:00+08,0,20,20,0,2105502,2105502,393.7,352,745.7
2020-12-11 04:00:00+08,0,22,22,0,2175574,2175574,393.7,434.36,828.06
2020-12-11 08:00:00+08,0,20,20,0,2013074,2013074,393.7,484.56,878.26
2020-12-11 12:00:00+08,0,20,20,0,2007002,2007002,393.7,447.06,840.76
2020-12-11 16:00:00+08,0,20,20,0,2007002,2007002,393.7,527.06,920.76
2020-12-11 20:00:00+08,0,16,16,0,1666832,1666832,232.8,390.3,623.1
2020-12-12 00:00:00+08,0,18,18,0,1724566,1724566,33.3,413.34,446.64
2020-12-12 04:00:00+08,0,20,20,0,1838814,1838814,33.3,445.3,478.6
2020-12-12 08:00:00+08,0,20,20,0,1946644,1946644,33.3,503.72,537.02
2020-12-12 12:00:00+08,0,18,18,0,1876572,1876572,33.3,517.36,550.66
2020-12-12 16:00:00+08,0,14,14,0,1506352,1506352,33.28,456.26,489.54
2020-12-12 20:00:00+08,0,16,16,0,1702348,1702348,33.28,408.72,442
2020-12-13 00:00:00+08,0,14,14,0,1636596,1636596,0,327.66,327.66
2020-12-13 04:00:00+08,0,18,18,0,1918824,1918824,0,318.74,318.74
2020-12-13 08:00:00+08,0,20,20,0,2153174,2153174,0,392,392
2020-12-13 12:00:00+08,0,20,20,0,2153174,2153174,0,472,472
2020-12-13 16:00:00+08,0,16,16,0,1863322,1863322,0,455.4,455.4
2020-12-13 20:00:00+08,0,14,14,0,1575036,1575036,0,333.3,333.3
2020-12-14 00:00:00+08,0,14,14,0,1621480,1621480,0,294.78,294.78
2020-12-14 04:00:00+08,0,14,14,0,1621480,1621480,0,350.78,350.78
2020-12-14 08:00:00+08,0,16,16,0,1911450,1911450,0,334.96,334.96
2020-12-14 12:00:00+08,0,16,16,0,1911450,1911450,0,398.96,398.96
2020-12-14 16:00:00+08,0,14,14,0,1620674,1620674,0,377.22,377.22
2020-12-14 20:00:00+08,0,14,14,0,1643684,1643684,0,257.78,257.78
2020-12-15 00:00:00+08,0,16,16,0,1901278,1901278,0,240.08,240.08
2020-12-15 04:00:00+08,0,20,20,0,2347164,2347164,0,312,312
2020-12-15 08:00:00+08,2,24,26,192206,2680528,2872734,2.36,401.46,403.82
2020-12-15 12:00:00+08,2,22,24,217354,2462856,2680210,2.52,424.98,427.5
2020-12-15 16:00:00+08,2,26,28,217354,2817066,3034420,20.84,521.22,542.06
2020-12-15 20:00:00+08,2,28,30,217354,2853710,3071064,28.84,626.88,655.72
2020-12-16 00:00:00+08,4,28,32,437354,2853710,3291064,37.32,738.88,776.2
2020-12-16 04:00:00+08,4,26,30,437354,2591126,3028480,53.36,701.48,754.84
2020-12-16 08:00:00+08,4,26,30,437354,2637018,3074372,69.42,734.12,803.54
2020-12-16 12:00:00+08,4,26,30,437354,2725104,3162458,75.04,793.9,868.94
2020-12-16 16:00:00+08,2,28,30,220000,2752472,2972472,32.6,898.6,931.2
2020-12-16 20:00:00+08,4,30,34,288578,2861444,3150022,110.88,956.68,1067.56
2020-12-17 00:00:00+08,0,20,20,0,1895622,1895622,65.1,582.1,647.2
2020-12-17 04:00:00+08,0,24,24,0,2341256,2341256,134,462.36,596.36
2020-12-17 08:00:00+08,0,18,18,0,1617592,1617592,134,272.44,406.44
2020-12-17 12:00:00+08,0,18,18,0,1617592,1617592,134,344.44,478.44
2020-12-17 16:00:00+08,0,18,18,0,1617592,1617592,134,416.44,550.44
2020-12-17 20:00:00+08,0,18,18,0,1617592,1617592,134,488.44,622.44
2020-12-18 00:00:00+08,0,18,18,0,1617592,1617592,134,560.44,694.44
2020-12-18 04:00:00+08,0,18,18,0,1617592,1617592,134,632.44,766.44
2020-12-18 08:00:00+08,0,18,18,0,1617592,1617592,134,704.44,838.44
2020-12-18 12:00:00+08,0,20,20,0,1725906,1725906,134,780.24,914.24
2020-12-18 16:00:00+08,0,18,18,0,1672284,1672284,134.02,771.28,905.3
2020-12-18 20:00:00+08,2,18,20,245922,1811042,2056964,116.04,761.96,878
2020-12-19 00:00:00+08,0,20,20,0,2056964,2056964,122.88,835.12,958
2020-12-19 04:00:00+08,2,18,20,207336,1868004,2075340,130.32,811.38,941.7
2020-12-19 08:00:00+08,2,18,20,207336,1868004,2075340,138.32,883.38,1021.7
2020-12-19 12:00:00+08,4,18,22,423934,1868004,2291938,146.42,955.38,1101.8
2020-12-19 16:00:00+08,4,18,22,423934,1951896,2375830,162.38,971,1133.38
2020-12-19 20:00:00+08,4,20,24,423934,2078686,2502620,178.38,1044.52,1222.9
2020-12-20 00:00:00+08,4,22,26,423934,2023390,2447324,194.38,1047.72,1242.1
2020-12-20 04:00:00+08,4,22,26,423934,2029264,2453198,145.28,981.72,1127
2020-12-20 08:00:00+08,4,20,24,423934,1958288,2382222,119.76,843.76,963.52
2020-12-20 12:00:00+08,4,18,22,423934,1786662,2210596,135.74,816.64,952.38
2020-12-20 16:00:00+08,4,18,22,423934,1992522,2416456,151.78,855.02,1006.8
2020-12-20 20:00:00+08,2,18,20,207336,1992508,2199844,159.82,896.7,1056.52
2020-12-21 00:00:00+08,4,18,22,464456,1981612,2446068,172.7,681.66,854.36
2020-12-21 04:00:00+08,6,20,26,495636,2279596,2775232,94.04,758.46,852.5
2020-12-21 08:00:00+08,6,20,26,495636,2340968,2836604,226.28,639.22,865.5
2020-12-21 12:00:00+08,6,18,24,495636,2148762,2644398,250.3,627.8,878.1
2020-12-21 16:00:00+08,2,16,18,257120,1902840,2159960,209.22,570.66,779.88
2020-12-21 20:00:00+08,2,20,22,257120,1977464,2234584,285.64,380.24,665.88
2020-12-22 00:00:00+08,4,18,22,357296,1760866,2118162,237.62,404.08,641.7
2020-12-22 04:00:00+08,2,16,18,100176,1598366,1698542,192.7,389.28,581.98
2020-12-22 08:00:00+08,2,20,22,100176,2085696,2185872,266.9,460.08,726.98
2020-12-22 12:00:00+08,2,18,20,100176,1853710,1953886,274.92,447.38,722.3
2020-12-22 16:00:00+08,2,18,20,100176,1853710,1953886,282.92,519.38,802.3
2020-12-22 20:00:00+08,2,18,20,100176,1992580,2092756,254.2,544,798.2
2020-12-23 00:00:00+08,2,20,22,100176,2290564,2390740,262.2,621.78,883.98
2020-12-23 04:00:00+08,2,22,24,100176,2512164,2612340,270.18,707.56,977.74
2020-12-23 08:00:00+08,2,22,24,100176,2496482,2596658,278.18,639.68,917.86
2020-12-23 12:00:00+08,2,20,22,100176,2290760,2390936,254.5,644.88,899.38
2020-12-23 16:00:00+08,2,20,22,100176,2290760,2390936,262.5,724.88,987.38
2020-12-23 20:00:00+08,2,20,22,207336,2150012,2357348,67.62,400.82,468.44
2020-12-24 00:00:00+08,2,22,24,207336,2250188,2457524,172.02,488.32,660.34
2020-12-24 04:00:00+08,2,22,24,207336,2250188,2457524,180.02,576.32,756.34
2020-12-24 08:00:00+08,2,24,26,207336,2487858,2695194,187.94,664.74,852.68
2020-12-24 12:00:00+08,2,24,26,207336,2487858,2695194,195.94,760.74,956.68
2020-12-24 16:00:00+08,2,22,24,207336,2381580,2588916,203.94,815.64,1019.58
2020-12-24 20:00:00+08,2,14,16,207336,1706090,1913426,211.98,604.36,816.34
2020-12-25 00:00:00+08,2,14,16,207336,1809550,2016886,123.62,605.4,729.02
2020-12-25 04:00:00+08,4,14,18,439322,1809550,2248872,134.8,661.4,796.2
2020-12-25 08:00:00+08,6,14,20,620098,1809550,2429648,153.32,717.4,870.72
2020-12-25 12:00:00+08,6,14,20,620098,1809550,2429648,177.32,773.4,950.72
2020-12-25 16:00:00+08,6,14,20,620098,1809550,2429648,201.32,829.4,1030.72
2020-12-25 20:00:00+08,6,14,20,620098,1809550,2429648,225.32,885.4,1110.72
2020-12-26 00:00:00+08,6,14,20,620098,1809550,2429648,249.32,941.4,1190.72
2020-12-26 04:00:00+08,6,14,20,620098,1809550,2429648,273.32,997.4,1270.72
2020-12-26 08:00:00+08,6,12,18,620098,1511566,2131664,297.32,800.64,1097.96
2020-12-26 12:00:00+08,6,12,18,620098,1511566,2131664,321.32,848.64,1169.96
2020-12-26 16:00:00+08,4,12,16,412762,1511566,1924328,208,896.64,1104.64
2020-12-26 20:00:00+08,4,20,24,412762,2138678,2551440,369.3,947.06,1316.36
2020-12-27 00:00:00+08,4,20,24,412762,2091722,2504484,319.1,809.06,1128.16
2020-12-27 04:00:00+08,4,20,24,412762,2091722,2504484,335.1,889.06,1224.16
2020-12-27 08:00:00+08,4,22,26,412762,2297240,2710002,351.16,970.76,1321.92
2020-12-27 12:00:00+08,4,20,24,412762,2075640,2488402,367.08,844.96,1212.04
2020-12-27 16:00:00+08,2,18,20,180776,1774876,1955652,259.84,509.94,769.78
2020-12-27 20:00:00+08,2,22,24,180776,2178434,2359210,397.88,589.92,987.8
2020-12-28 00:00:00+08,4,22,26,463876,2178434,2642310,410.18,677.92,1088.1
2020-12-28 04:00:00+08,4,22,26,463876,2178434,2642310,426.18,765.92,1192.1
2020-12-28 08:00:00+08,4,18,22,463876,1903398,2367274,442.18,708.22,1150.4
2020-12-28 12:00:00+08,4,18,22,463876,1903398,2367274,458.18,780.22,1238.4
2020-12-28 16:00:00+08,4,12,16,463876,1280380,1744256,328.8,609.88,938.68
2020-12-28 20:00:00+08,4,10,14,463876,907600,1371476,344.84,258.46,603.3
2020-12-29 00:00:00+08,4,10,14,463876,946178,1410054,230.76,189.2,419.96
2020-12-29 04:00:00+08,4,12,16,463876,1149612,1613488,246.76,230.84,477.6
2020-12-29 08:00:00+08,4,18,22,463876,1753160,2217036,262.78,287.78,550.56
2020-12-29 12:00:00+08,6,18,24,565076,1753160,2318236,283.6,359.78,643.38
2020-12-29 16:00:00+08,6,16,22,565076,1608420,2173496,307.6,295.06,602.66
2020-12-29 20:00:00+08,6,14,20,565076,1596662,2161738,331.52,268.56,600.08
2020-12-30 00:00:00+08,6,20,26,565076,2049064,2614140,355.58,399.28,754.86
2020-12-30 04:00:00+08,6,24,30,565076,2511584,3076660,379.56,449.56,829.12
2020-12-30 08:00:00+08,4,26,30,281976,2545966,2827942,287.28,548.9,836.18
2020-12-30 12:00:00+08,6,26,32,416316,2539770,2956086,432.08,461.5,893.58
2020-12-30 16:00:00+08,6,26,32,416316,2495478,2911794,456.06,498.98,955.04
2020-12-30 20:00:00+08,8,30,38,517710,2687324,3205034,482.86,606.14,1089
2020-12-31 00:00:00+08,10,28,38,687086,2515660,3202746,518.3,709.32,1227.62
2020-12-31 04:00:00+08,8,24,32,552746,2277844,2830590,520.34,680.4,1200.74
2020-12-31 08:00:00+08,10,26,36,762914,2337092,3100006,600.86,721.1,1321.96
2020-12-31 12:00:00+08,10,24,34,762914,2268464,3031378,640.86,791.92,1432.78
2020-12-31 16:00:00+08,10,22,32,762914,2050422,2813336,680.8,772.02,1452.82
2020-12-31 20:00:00+08,12,14,26,994900,1388036,2382936,722.66,566.58,1289.24
2021-01-01 00:00:00+08,12,10,22,994900,1078838,2073738,770.64,367.58,1138.22
2021-01-01 04:00:00+08,10,8,18,825524,944498,1770022,716.76,363.94,1080.7
2021-01-01 08:00:00+08,14,8,22,1235106,944498,2179604,772.2,395.94,1168.14
2021-01-01 12:00:00+08,14,8,22,1235106,944498,2179604,828.2,427.94,1256.14
2021-01-01 16:00:00+08,14,8,22,1235106,944498,2179604,884.2,459.94,1344.14
2021-01-01 20:00:00+08,16,8,24,1442324,944498,2386822,942.52,491.94,1434.46
2021-01-02 00:00:00+08,8,4,12,721162,472249,1193411,503.26,261.97,765.23
2021-01-02 04:00:00+08,8,5,13,721162,575863,1297025,535.28,281.69,816.97
2021-01-02 08:00:00+08,8,5,13,721162,575863,1297025,567.28,301.69,868.97
2021-01-02 12:00:00+08,8,5,13,721162,575863,1297025,599.28,321.69,920.97
2021-01-02 16:00:00+08,4,5,9,391188,575863,967051,422.14,341.69,763.83
2021-01-02 20:00:00+08,4,11,15,391188,1192194,1583382,654.71,368.45,1023.16
2021-01-03 00:00:00+08,4,12,16,391188,1242891,1634079,744.4,416.13,1160.53
2021-01-03 04:00:00+08,4,11,15,391188,1140030,1531218,760.41,358.68,1119.09
2021-01-03 08:00:00+08,4,11,15,391188,1140030,1531218,776.41,402.68,1179.09
2021-01-03 12:00:00+08,4,11,15,391188,1140030,1531218,792.41,446.68,1239.09
2021-01-03 16:00:00+08,5,7,12,548264,811526,1359790,652.1,388.52,1040.62
2021-01-03 20:00:00+08,5,7,12,548264,811526,1359790,672.1,416.52,1088.62
2021-01-04 00:00:00+08,5,7,12,548264,811526,1359790,692.1,444.52,1136.62
2021-01-04 04:00:00+08,3,7,10,394055,694056,1088111,501.14,266.92,768.06
2021-01-04 08:00:00+08,3,8,11,394055,744656,1138711,652.25,298.21,950.46
2021-01-04 12:00:00+08,3,8,11,394055,744656,1138711,664.25,330.21,994.46
2021-01-04 16:00:00+08,2,5,7,303667,416775,720442,303.76,103.86,407.62
2021-01-04 20:00:00+08,1,6,7,157076,507163,664239,475.52,125.41,600.93
2021-01-05 00:00:00+08,1,7,8,157076,653100,810176,479.52,158.43,637.95
2021-01-05 04:00:00+08,1,10,11,157076,885736,1042812,576.19,196.8,772.99
2021-01-05 08:00:00+08,3,12,15,234419,1038968,1273387,532.84,208.33,741.17
2021-01-05 12:00:00+08,3,11,14,234419,1025905,1260324,544.82,245.1,789.92
2021-01-05 16:00:00+08,3,12,15,234419,1114574,1348993,556.82,291.26,848.08
2021-01-05 20:00:00+08,3,11,14,234419,1059180,1293599,429.7,256.63,686.33
2021-01-06 00:00:00+08,3,9,12,354256,896798,1251054,424.3,205.51,629.81
2021-01-06 04:00:00+08,3,11,14,354256,1026370,1380626,456.84,244.34,701.18
2021-01-06 08:00:00+08,3,12,15,354256,1147304,1501560,468.86,288.86,757.72
2021-01-06 12:00:00+08,3,13,16,354256,1294096,1648352,480.85,340.76,821.61
2021-01-06 16:00:00+08,3,10,13,354256,1091715,1445971,492.86,282.44,775.3
2021-01-06 20:00:00+08,3,9,12,354256,927046,1281302,504.88,233.68,738.56
2021-01-07 00:00:00+08,3,13,16,354256,1181514,1535770,516.86,306.92,823.78
2021-01-07 04:00:00+08,3,13,16,354256,1213857,1568113,528.85,329.62,858.47
2021-01-07 08:00:00+08,3,11,14,354256,1050487,1404743,289.13,264.22,553.35
2021-01-07 12:00:00+08,3,12,15,354256,1081566,1435822,301.13,260.85,561.98
2021-01-07 16:00:00+08,3,11,14,354256,1041466,1395722,313.16,289.77,602.93
2021-01-07 20:00:00+08,4,11,15,470249,1213463,1683712,305.01,271.17,576.18
2021-01-08 00:00:00+08,4,10,14,470249,1118983,1589232,321.01,286.31,607.32
2021-01-08 04:00:00+08,4,8,12,470249,936944,1407193,337.05,249.95,587
2021-01-08 08:00:00+08,4,9,13,470249,1032754,1503003,353.02,282.02,635.04
2021-01-08 12:00:00+08,5,8,13,505720,911820,1417540,371.54,265.5,637.04
2021-01-08 16:00:00+08,5,7,12,505720,812754,1318474,391.54,265.53,657.07
2021-01-08 20:00:00+08,4,11,15,455188,1256019,1711207,324.54,299.1,623.64
2021-01-09 00:00:00+08,3,8,11,419717,840303,1260020,233.32,141.75,375.07
2021-01-09 04:00:00+08,2,9,11,262641,885150,1147791,202.36,146.98,349.34
2021-01-09 08:00:00+08,2,10,12,262641,1100139,1362780,348.08,150.43,498.51
2021-01-09 12:00:00+08,2,10,12,262641,1100139,1362780,356.08,190.43,546.51
2021-01-09 16:00:00+08,1,8,9,115993,851359,967352,274.52,143.06,417.58
2021-01-09 20:00:00+08,1,10,11,115993,1129365,1245358,371.53,176.31,547.84
2021-01-10 00:00:00+08,2,8,10,151464,994128,1145592,321.7,163.75,485.45
2021-01-10 04:00:00+08,2,10,12,151464,1178582,1330046,329.7,185.9,515.6
2021-01-10 08:00:00+08,2,9,11,151464,1082772,1234236,337.72,177.79,515.51
2021-01-10 12:00:00+08,2,9,11,151464,1082772,1234236,345.72,213.79,559.51
2021-01-10 16:00:00+08,1,9,10,115993,1082772,1198765,299.2,249.79,548.99
2021-01-10 20:00:00+08,1,10,11,115993,1100545,1216538,361.14,238.95,600.09
2021-01-11 00:00:00+08,2,9,11,201510,996654,1198164,366.83,231.96,598.79
2021-01-11 04:00:00+08,2,9,11,201510,975901,1177411,374.83,243.88,618.71
2021-01-11 08:00:00+08,2,9,11,201510,975901,1177411,382.83,279.88,662.71
2021-01-11 12:00:00+08,2,8,10,201510,862423,1063933,390.81,280.11,670.92
2021-01-11 16:00:00+08,1,6,7,85517,629906,715423,213.36,246.4,459.76
2021-01-11 20:00:00+08,1,7,8,85517,717402,802919,313.66,223.33,536.99
2021-01-12 00:00:00+08,1,6,7,85517,608711,694228,317.66,203.94,521.6
2021-01-12 04:00:00+08,1,7,8,85517,727423,812940,321.66,231.6,553.26
2021-01-12 08:00:00+08,1,6,7,85517,676891,762408,325.66,228.14,553.8
2021-01-12 12:00:00+08,1,5,6,85517,641420,726937,271.7,211.58,483.28
2021-01-12 16:00:00+08,1,4,5,85517,484344,569861,137.97,150,287.97
2021-01-12 20:00:00+08,2,5,7,180146,588012,768158,143.24,166.76,310
2021-01-13 00:00:00+08,2,8,10,180146,698472,878618,151.23,193.52,344.75
2021-01-13 04:00:00+08,2,9,11,180146,812578,992724,159.26,228.92,388.18
2021-01-13 08:00:00+08,2,7,9,180146,652739,832885,167.26,144.65,311.91
2021-01-13 12:00:00+08,2,9,11,180146,832494,1012640,175.21,177.53,352.74
2021-01-13 16:00:00+08,1,7,8,85517,613640,699157,65.68,123.95,189.63
2021-01-13 20:00:00+08,1,12,13,85517,1105033,1190550,93.77,135.21,228.98
2021-01-14 00:00:00+08,1,13,14,85517,1231562,1317079,97.74,158.35,256.09
2021-01-14 04:00:00+08,1,13,14,85517,1231562,1317079,101.74,210.35,312.09
2021-01-14 08:00:00+08,1,12,13,85517,1127894,1213411,105.74,225.59,331.33
2021-01-14 12:00:00+08,1,11,12,85517,1009182,1094699,109.74,213.91,323.65
2021-01-14 16:00:00+08,1,11,12,146507,1009182,1155689,28,257.91,285.91
2021-01-14 20:00:00+08,1,9,10,146507,873870,1020377,100.82,166.7,267.52
2021-01-15 00:00:00+08,1,10,11,146507,893320,1039827,104.84,170.27,275.11
2021-01-15 04:00:00+08,1,10,11,146507,902222,1048729,108.84,181.47,290.31
2021-01-15 08:00:00+08,1,3,4,146507,289179,435686,19.94,91.14,111.08
2021-01-15 12:00:00+08,1,3,4,146507,289179,435686,23.94,103.14,127.08
2021-01-15 16:00:00+08,1,2,3,146507,254984,401491,27.94,59.48,87.42
2021-01-15 20:00:00+08,1,2,3,146507,254984,401491,31.94,67.48,99.42
2021-01-16 00:00:00+08,1,2,3,146507,254984,401491,35.94,75.48,111.42
2021-01-16 04:00:00+08,1,2,3,146507,254984,401491,39.94,83.48,123.42
2021-01-16 08:00:00+08,1,2,3,146507,254984,401491,43.94,91.48,135.42
2021-01-16 12:00:00+08,0,2,2,0,254984,254984,0,99.48,99.48
2021-01-16 16:00:00+08,0,2,2,0,254984,254984,0,107.48,107.48
2021-01-16 20:00:00+08,0,2,2,0,254984,254984,0,115.48,115.48
2021-01-17 00:00:00+08,0,3,3,0,401491,401491,59.28,124.12,183.4
2021-01-17 04:00:00+08,0,3,3,0,401491,401491,59.28,136.12,195.4
2021-01-17 08:00:00+08,0,3,3,0,401491,401491,59.28,148.12,207.4
2021-01-17 12:00:00+08,0,3,3,0,401491,401491,59.28,160.12,219.4
2021-01-17 16:00:00+08,0,3,3,0,401491,401491,59.28,172.12,231.4
2021-01-17 20:00:00+08,0,3,3,0,401491,401491,59.28,184.12,243.4
2021-01-18 00:00:00+08,0,3,3,0,401491,401491,59.28,196.12,255.4
2021-01-18 04:00:00+08,0,3,3,0,401491,401491,59.28,208.12,267.4
2021-01-18 08:00:00+08,0,3,3,0,401702,401702,59.28,114.68,173.96
2021-01-18 12:00:00+08,0,9,9,0,924194,924194,59.28,46.8,106.08
2021-01-18 16:00:00+08,0,8,8,0,819594,819594,59.28,77.94,137.22
2021-01-18 20:00:00+08,0,8,8,0,939641,939641,59.28,102.63,161.91
2021-01-19 00:00:00+08,0,6,6,0,788144,788144,59.28,109,168.28
2021-01-19 04:00:00+08,0,6,6,0,787534,787534,59.28,120.08,179.36
2021-01-19 08:00:00+08,0,6,6,0,787534,787534,59.28,144.08,203.36
2021-01-19 12:00:00+08,0,6,6,0,787534,787534,59.28,168.08,227.36
2021-01-19 16:00:00+08,1,5,6,50775,691724,742499,61.89,163.12,225.01
2021-01-19 20:00:00+08,1,7,8,50775,789475,840250,65.89,183.96,249.85
2021-01-20 00:00:00+08,1,7,8,50775,789475,840250,69.89,211.96,281.85
2021-01-20 04:00:00+08,1,8,9,50775,874246,925021,73.89,243.67,317.56
2021-01-20 08:00:00+08,1,8,9,50775,833175,883950,18.61,198.75,217.36
2021-01-20 12:00:00+08,1,8,9,50775,735436,786211,22.61,168.66,191.27
2021-01-20 16:00:00+08,1,8,9,50775,735436,786211,26.61,200.66,227.27
2021-01-20 20:00:00+08,1,8,9,50775,796879,847654,30.61,216.67,247.28
2021-01-21 00:00:00+08,1,8,9,50775,885925,936700,34.61,238.14,272.75
2021-01-21 04:00:00+08,3,9,12,259763,883087,1142850,42.67,224.94,267.61
2021-01-21 08:00:00+08,3,10,13,259763,942710,1202473,54.68,261.6,316.28
2021-01-21 12:00:00+08,3,9,12,259763,884537,1144300,66.66,245.56,312.22
2021-01-21 16:00:00+08,2,6,8,156095,569266,725361,66.19,116.72,182.91
2021-01-21 20:00:00+08,2,8,10,156095,781890,937985,90.49,95.59,186.08
2021-01-22 00:00:00+08,1,8,9,50775,781890,832665,74.91,127.59,202.5
2021-01-22 04:00:00+08,1,9,10,50775,887210,937985,104.58,161.46,266.04
2021-01-22 08:00:00+08,1,9,10,50775,915039,965814,108.62,167.18,275.8
2021-01-22 12:00:00+08,1,10,11,50775,972359,1023134,112.61,204.35,316.96
2021-01-22 16:00:00+08,0,9,9,0,912736,912736,42,211.68,253.68
2021-01-22 20:00:00+08,0,7,7,0,704332,704332,119.96,143.52,263.48
2021-01-23 00:00:00+08,0,7,7,0,704332,704332,119.96,171.52,291.48
2021-01-23 04:00:00+08,0,7,7,0,704332,704332,119.96,199.52,319.48
2021-01-23 08:00:00+08,0,6,6,0,481100,481100,103.67,129.8,233.47
2021-01-23 12:00:00+08,0,7,7,0,646522,646522,103.67,155.1,258.77
2021-01-23 16:00:00+08,0,5,5,0,457167,457167,103.65,107.41,211.06
2021-01-23 20:00:00+08,0,6,6,0,562374,562374,103.64,113.69,217.33
2021-01-24 00:00:00+08,0,5,5,0,533355,533355,0,66.87,66.87
2021-01-24 04:00:00+08,1,5,6,146648,533355,680003,1.64,86.87,88.51
2021-01-24 08:00:00+08,1,5,6,146648,533355,680003,5.64,106.87,112.51
2021-01-24 12:00:00+08,0,4,4,0,452105,452105,0,110.62,110.62
2021-01-24 16:00:00+08,0,5,5,0,540622,540622,11.22,71.94,83.16
2021-01-24 20:00:00+08,0,6,6,0,648728,648728,11.22,92.18,103.4
2021-01-25 00:00:00+08,0,6,6,0,648728,648728,11.22,116.18,127.4
2021-01-25 04:00:00+08,0,5,5,0,598121,598121,11.22,107.97,119.19
2021-01-25 08:00:00+08,0,6,6,0,706336,706336,11.22,128.29,139.51
2021-01-25 12:00:00+08,0,6,6,0,706336,706336,11.22,152.29,163.51
2021-01-25 16:00:00+08,0,6,6,0,706336,706336,11.22,176.29,187.51
2021-01-25 20:00:00+08,0,6,6,0,679096,679096,11.22,176.35,187.57
2021-01-26 00:00:00+08,0,8,8,0,766343,766343,11.2,194.44,205.64
2021-01-26 04:00:00+08,0,8,8,0,766343,766343,11.2,226.44,237.64
2021-01-26 08:00:00+08,0,8,8,0,766343,766343,11.2,258.44,269.64
2021-01-26 12:00:00+08,0,8,8,0,766343,766343,11.2,290.44,301.64
2021-01-26 16:00:00+08,0,6,6,0,607259,607259,11.2,241.81,253.01
2021-01-26 20:00:00+08,0,6,6,0,684105,684105,11.2,166.52,177.72
2021-01-27 00:00:00+08,1,7,8,114108,769911,884019,14.02,232.52,246.54
2021-01-27 04:00:00+08,1,9,10,114108,868265,982373,18.02,215.2,233.22
2021-01-27 08:00:00+08,1,10,11,114108,881326,995434,22.02,253.13,275.15
2021-01-27 12:00:00+08,1,9,10,114108,795813,909921,14.82,170.36,185.18
2021-01-27 16:00:00+08,1,10,11,114108,830102,944210,18.82,209.77,228.59
2021-01-27 20:00:00+08,1,9,10,114108,841720,955828,22.81,187.71,210.52
2021-01-28 00:00:00+08,2,8,10,259345,756885,1016230,67.86,200.31,268.17
2021-01-28 04:00:00+08,1,8,9,145237,785187,930424,73.97,164.2,238.17
2021-01-28 08:00:00+08,1,7,8,145237,786682,931919,77.97,146.86,224.83
2021-01-28 12:00:00+08,1,5,6,145237,596442,741679,81.97,97.45,179.42
2021-01-28 16:00:00+08,1,5,6,145237,596442,741679,85.97,117.45,203.42
2021-01-28 20:00:00+08,1,5,6,145237,596442,741679,89.97,137.45,227.42
2021-01-29 00:00:00+08,1,9,10,145237,945362,1090599,113.78,167.82,281.6
2021-01-29 04:00:00+08,1,9,10,145237,945362,1090599,117.78,203.82,321.6
2021-01-29 08:00:00+08,1,9,10,145237,945362,1090599,121.78,239.82,361.6
2021-01-29 12:00:00+08,1,9,10,145237,945362,1090599,125.78,275.82,401.6
2021-01-29 16:00:00+08,1,7,8,145237,813781,959018,110,246.74,356.74
2021-01-29 20:00:00+08,2,7,9,260937,808673,1069610,88.7,233.04,321.74
2021-01-30 00:00:00+08,1,7,8,145237,808673,953910,89.06,261.04,350.1
2021-01-30 04:00:00+08,1,8,9,145237,924373,1069610,104.43,289.31,393.74
2021-01-30 08:00:00+08,1,6,7,145237,633474,778711,108.41,167.47,275.88
2021-01-30 12:00:00+08,0,6,6,0,692821,692821,112.31,137.99,250.3
2021-01-30 16:00:00+08,0,6,6,0,759917,759917,112.29,120.81,233.1
2021-01-30 20:00:00+08,0,7,7,0,906938,906938,112.29,145.67,257.96
2021-01-31 00:00:00+08,0,7,7,0,906938,906938,112.29,173.67,285.96
2021-01-31 04:00:00+08,0,7,7,0,906938,906938,112.29,201.67,313.96
2021-01-31 08:00:00+08,0,7,7,0,865108,865108,112.28,195.42,307.7
2021-01-31 12:00:00+08,0,7,7,0,865108,865108,112.28,223.42,335.7
2021-01-31 16:00:00+08,0,6,6,0,749408,749408,100.92,215.15,316.07
2021-01-31 20:00:00+08,1,8,9,122959,921069,1044028,101.99,239.58,341.57
2021-02-01 00:00:00+08,0,8,8,0,937508,937508,100.95,196.75,297.7
2021-02-01 04:00:00+08,0,11,11,0,1187717,1187717,106.74,236.33,343.07
2021-02-01 08:00:00+08,0,9,9,0,975310,975310,5.79,210.31,216.1
2021-02-01 12:00:00+08,1,10,11,127076,1120870,1247946,9.2,250.28,259.48
2021-02-01 16:00:00+08,1,10,11,127076,1120870,1247946,13.2,290.28,303.48
2021-02-01 20:00:00+08,2,10,12,230967,1120870,1351837,18.82,330.28,349.1
2021-02-02 00:00:00+08,2,10,12,230967,1120870,1351837,26.82,370.28,397.1
2021-02-02 04:00:00+08,2,10,12,230967,1120870,1351837,34.82,410.28,445.1
2021-02-02 08:00:00+08,2,10,12,230967,1120870,1351837,42.82,450.28,493.1
2021-02-02 12:00:00+08,2,10,12,230967,1120870,1351837,50.82,490.28,541.1
2021-02-02 16:00:00+08,2,10,12,230967,1120870,1351837,58.82,530.28,589.1
2021-02-02 20:00:00+08,2,10,12,230967,1120870,1351837,66.82,570.28,637.1
2021-02-03 00:00:00+08,2,10,12,230967,1120870,1351837,74.82,610.28,685.1
2021-02-03 04:00:00+08,5,9,14,513952,1018114,1532066,88.4,525.61,614.01
2021-02-03 08:00:00+08,5,11,16,513952,1142213,1656165,108.41,563.56,671.97
2021-02-03 12:00:00+08,5,10,15,513952,1033907,1547859,128.4,543.15,671.55
2021-02-03 16:00:00+08,5,11,16,513952,1182630,1696582,148.41,585,733.41
2021-02-03 20:00:00+08,6,10,16,564581,1139533,1704114,170.29,615.64,785.93
2021-02-04 00:00:00+08,6,10,16,564581,1139533,1704114,194.29,655.64,849.93
2021-02-04 04:00:00+08,6,9,15,564581,1058531,1623112,218.28,675.05,893.33
2021-02-04 08:00:00+08,7,10,17,666883,1175382,1842265,245.8,712.43,958.23
2021-02-04 12:00:00+08,7,10,17,666883,1175382,1842265,273.8,752.43,1026.23
2021-02-04 16:00:00+08,6,10,16,562992,1175382,1738374,232.2,792.43,1024.63
2021-02-04 20:00:00+08,6,11,17,562992,1279273,1842265,329.26,832.97,1162.23
2021-02-05 00:00:00+08,6,13,19,562992,1408172,1971164,353.24,937.15,1290.39
2021-02-05 04:00:00+08,5,13,18,468363,1408172,1876535,325.54,989.15,1314.69
2021-02-05 08:00:00+08,9,14,23,777737,1502801,2280538,408.6,1043.25,1451.85
2021-02-05 12:00:00+08,9,14,23,777737,1502801,2280538,444.6,1099.25,1543.85
2021-02-05 16:00:00+08,8,13,21,699647,1459704,2159351,458.66,1097.89,1556.55
2021-02-05 20:00:00+08,7,12,19,597345,1384511,1981856,451.11,803.39,1254.5
2021-02-06 00:00:00+08,8,11,19,655168,1181014,1836182,477.71,674.11,1151.82
2021-02-06 04:00:00+08,7,12,19,604539,1251371,1855910,523.21,606.99,1130.2
2021-02-06 08:00:00+08,6,12,18,530062,1251371,1781433,534.58,654.99,1189.57
2021-02-06 12:00:00+08,5,12,17,402986,1216198,1619184,497.85,651.34,1149.19
2021-02-06 16:00:00+08,4,10,14,376175,993075,1369250,499.35,454.75,954.1
2021-02-06 20:00:00+08,4,14,18,376175,1158881,1535056,685.71,360.01,1045.72
2021-02-07 00:00:00+08,6,12,18,625506,1014637,1640143,787.95,380.53,1168.48
2021-02-07 04:00:00+08,6,13,19,625506,1048328,1673834,811.92,431.21,1243.13
2021-02-07 08:00:00+08,6,12,18,625506,1005458,1630964,709.21,362.63,1071.84
2021-02-07 12:00:00+08,4,11,15,376175,954829,1331004,560.3,383.44,943.74
2021-02-07 16:00:00+08,4,9,13,376175,723120,1099295,504.92,200.3,705.22
2021-02-07 20:00:00+08,4,11,15,376175,1121780,1497955,574.43,191.07,765.5
2021-02-08 00:00:00+08,5,11,16,460946,1136562,1597508,590.64,229.88,820.52
2021-02-08 04:00:00+08,6,11,17,562764,1136562,1699326,614.43,273.88,888.31
2021-02-08 08:00:00+08,6,9,15,562764,932351,1495115,638.44,231.88,870.32
2021-02-08 12:00:00+08,5,9,14,447064,1009072,1456136,605.1,236.07,841.17
2021-02-08 16:00:00+08,4,8,12,393925,906770,1300695,500.76,206.73,707.49
2021-02-08 20:00:00+08,4,9,13,393925,948533,1342458,538.2,192.22,730.42
2021-02-09 00:00:00+08,4,11,15,393925,1067503,1461428,554.24,234.81,789.05
2021-02-09 04:00:00+08,2,11,13,186589,1067503,1254092,333.31,278.81,612.12
2021-02-09 08:00:00+08,2,13,15,186589,1274839,1461428,583.28,325.77,909.05
2021-02-09 12:00:00+08,2,10,12,186589,1088314,1274903,591.2,255.55,846.75
2021-02-09 16:00:00+08,1,11,12,101818,1234528,1336346,559.01,296.54,855.55
2021-02-09 20:00:00+08,1,11,12,101818,1243933,1345751,563.03,318.28,881.31
2021-02-10 00:00:00+08,2,12,14,203350,1328704,1532054,612.75,365.13,977.88
2021-02-10 04:00:00+08,5,11,16,430505,1275565,1706070,538.21,380.84,919.05
2021-02-10 08:00:00+08,5,12,17,430505,1314648,1745153,558.21,425.79,984
2021-02-10 12:00:00+08,5,11,16,430505,1210803,1641308,578.23,407.31,985.54
2021-02-10 16:00:00+08,5,9,14,430505,984691,1415196,528.94,350.71,879.65
2021-02-10 20:00:00+08,5,9,14,430505,984691,1415196,548.94,386.71,935.65
2021-02-11 00:00:00+08,5,12,17,430505,1189292,1619797,543.89,386.48,930.37
2021-02-11 04:00:00+08,4,12,16,328973,1189292,1518265,535.53,434.48,970.01
2021-02-11 08:00:00+08,3,10,13,238339,1109634,1347973,495.2,325.66,820.86
2021-02-11 12:00:00+08,3,10,13,255368,1096600,1351968,358.35,314.9,673.25
2021-02-11 16:00:00+08,4,10,14,408888,1096600,1505488,372.32,354.9,727.22
2021-02-11 20:00:00+08,5,10,15,517194,1096600,1613794,391.28,394.9,786.18
2021-02-12 00:00:00+08,3,9,12,255368,993993,1249361,298.34,319.29,617.63
2021-02-12 04:00:00+08,4,10,14,323355,1109047,1432402,333.71,253.73,587.44
2021-02-12 08:00:00+08,3,10,13,221537,1109047,1330584,245.93,293.73,539.66
2021-02-12 12:00:00+08,3,10,13,221537,1162459,1383996,364.99,241.63,606.62
2021-02-12 16:00:00+08,3,9,12,221537,1040321,1261858,339.83,237.54,577.37
2021-02-12 20:00:00+08,3,11,14,221537,1213270,1434807,351.8,152.59,504.39
2021-02-13 00:00:00+08,3,11,14,221537,1170236,1391773,332.16,155.77,487.93
2021-02-13 04:00:00+08,3,11,14,255683,1165422,1421105,242.65,160.76,403.41
2021-02-13 08:00:00+08,4,10,14,404406,1021973,1426379,281.89,142.07,423.96
2021-02-13 12:00:00+08,4,11,15,404406,1121979,1526385,297.89,184.97,482.86
2021-02-13 16:00:00+08,3,9,12,301545,984051,1285596,260.1,188.79,448.89
2021-02-13 20:00:00+08,3,11,14,301545,1156731,1458276,329.84,204.23,534.07
2021-02-14 00:00:00+08,3,12,15,301545,1154678,1456223,328.85,249.38,578.23
2021-02-14 04:00:00+08,5,13,18,567726,1258346,1826072,345.47,299.93,645.4
2021-02-14 08:00:00+08,5,12,17,567726,1172526,1740252,365.47,320.27,685.74
2021-02-14 12:00:00+08,5,12,17,567726,1214298,1782024,385.49,354.92,740.41
2021-02-14 16:00:00+08,3,8,11,334168,964296,1298464,149.17,260.24,409.41
2021-02-14 20:00:00+08,3,11,14,334168,1210221,1544389,239.27,247.46,486.73
2021-02-15 00:00:00+08,3,12,15,334168,1245242,1579410,251.27,295.89,547.16
2021-02-15 04:00:00+08,4,12,16,352490,1245242,1597732,264.38,343.89,608.27
2021-02-15 08:00:00+08,5,11,16,387961,1145236,1533197,283.86,344.99,628.85
2021-02-15 12:00:00+08,5,9,14,387961,901327,1289288,303.83,279.62,583.45
2021-02-15 16:00:00+08,3,8,11,313491,759971,1073462,188.91,251.07,439.98
2021-02-15 20:00:00+08,3,11,14,313491,994950,1308441,290.69,105.93,396.62
2021-02-16 00:00:00+08,3,12,15,313491,1076197,1389688,302.7,178.29,480.99
2021-02-16 04:00:00+08,3,11,14,313491,1004858,1318349,314.69,193.9,508.59
2021-02-16 08:00:00+08,3,11,14,313491,1002984,1316475,326.69,202.74,529.43
2021-02-16 12:00:00+08,3,10,13,313491,944784,1258275,338.68,206.36,545.04
2021-02-16 16:00:00+08,2,8,10,192547,841627,1034174,231.14,180.08,411.22
2021-02-16 20:00:00+08,2,5,7,192547,548906,741453,201.9,113.62,315.52
2021-02-17 00:00:00+08,3,8,11,308247,789971,1098218,280.46,144.11,424.57
2021-02-17 04:00:00+08,4,9,13,358335,862953,1221288,294.33,176.82,471.15
2021-02-17 08:00:00+08,5,9,14,445953,937382,1383335,314.04,189.29,503.33
2021-02-17 12:00:00+08,5,8,13,397176,903093,1300269,288.66,209.82,498.48
2021-02-17 16:00:00+08,5,7,12,397176,835429,1232605,177.03,153.2,330.23
2021-02-17 20:00:00+08,5,7,12,397176,782700,1179876,197.01,130.7,327.71
2021-02-18 00:00:00+08,4,11,15,288877,1238059,1526936,259.37,176.66,436.03
2021-02-18 04:00:00+08,5,12,17,397898,1346358,1744256,294.95,222.55,517.5
2021-02-18 08:00:00+08,5,11,16,397898,1218998,1616896,314.92,255.65,570.57
2021-02-18 12:00:00+08,5,11,16,397898,1246035,1643933,334.91,288.02,622.93
2021-02-18 16:00:00+08,5,10,15,397898,1164864,1562762,354.91,311.91,666.82
2021-02-18 20:00:00+08,5,7,12,397898,842535,1240433,307.53,144.43,451.96
2021-02-19 00:00:00+08,5,8,13,397898,947617,1345515,327.52,175.32,502.84
2021-02-19 04:00:00+08,5,8,13,397898,947617,1345515,347.52,207.32,554.84
2021-02-19 08:00:00+08,5,7,12,397898,907517,1305415,367.52,215.39,582.91
2021-02-19 12:00:00+08,5,7,12,397898,907517,1305415,387.52,243.39,630.91
2021-02-19 16:00:00+08,5,7,12,397898,907517,1305415,407.52,271.39,678.91
2021-02-19 20:00:00+08,5,7,12,470771,907517,1378288,362.46,299.39,661.85
2021-02-20 00:00:00+08,5,9,14,470771,968336,1439107,382.45,357.83,740.28
2021-02-20 04:00:00+08,4,10,14,347810,1018424,1366234,463.75,397.59,861.34
2021-02-20 08:00:00+08,4,12,16,347810,1175580,1523390,488.79,443.04,931.83
2021-02-20 12:00:00+08,3,10,13,312339,996226,1308565,377.31,381.5,758.81
2021-02-20 16:00:00+08,3,11,14,312339,1031697,1344036,519.03,423.28,942.31
2021-02-20 20:00:00+08,3,12,15,312339,1132081,1444420,515.49,406.18,921.67
2021-02-21 00:00:00+08,3,11,14,312318,1052748,1365066,386.23,355.88,742.11
2021-02-21 04:00:00+08,3,12,15,312318,1148428,1460746,472.73,372.89,845.62
2021-02-21 08:00:00+08,4,11,15,397835,1085428,1483263,487.27,407.48,894.75
2021-02-21 12:00:00+08,4,9,13,397835,917942,1315777,503.26,341.02,844.28
2021-02-21 16:00:00+08,4,8,12,397835,882471,1280306,389.55,351.24,740.79
2021-02-21 20:00:00+08,4,7,11,397835,838833,1236668,405.58,295.06,700.64
2021-02-22 00:00:00+08,4,7,11,328715,838833,1167548,405.33,323.06,728.39
2021-02-22 04:00:00+08,5,8,13,438347,954533,1392880,422.83,354.5,777.33
2021-02-22 08:00:00+08,6,7,13,552236,920338,1472574,446.59,336.82,783.41
2021-02-22 12:00:00+08,6,6,12,552236,797377,1349613,461.5,309.08,770.58
2021-02-22 16:00:00+08,3,5,8,332521,640301,972822,140.58,218.06,358.64
2021-02-22 20:00:00+08,3,8,11,332521,860016,1192537,449.4,242.38,691.78
2021-02-23 00:00:00+08,4,9,13,418038,917336,1335374,503.98,278.33,782.31
2021-02-23 04:00:00+08,3,9,12,308406,917336,1225742,494.55,314.33,808.88
2021-02-23 08:00:00+08,4,10,14,389482,1026968,1416450,486.63,353.74,840.37
2021-02-23 12:00:00+08,4,10,14,389482,996785,1386267,554.22,361.21,915.43
2021-02-23 16:00:00+08,3,9,12,338882,981401,1320283,539.88,310.67,850.55
2021-02-23 20:00:00+08,2,9,11,224993,1039806,1264799,316.74,234.08,550.82
2021-02-24 00:00:00+08,2,9,11,224993,937246,1162239,324.72,147.21,471.93
2021-02-24 04:00:00+08,2,11,13,224993,1105624,1330617,376.92,178.22,555.14
2021-02-24 08:00:00+08,2,10,12,224993,1087337,1312330,384.92,210.28,595.2
2021-02-24 12:00:00+08,2,9,11,224993,938287,1163280,392.92,183.36,576.28
2021-02-24 16:00:00+08,1,8,9,115993,822587,938580,170.4,173.91,344.31
2021-02-24 20:00:00+08,3,10,13,304335,1031590,1335925,271.28,207.36,478.64
2021-02-25 00:00:00+08,4,11,15,355032,1116428,1471460,286.65,261.6,548.25
2021-02-25 04:00:00+08,3,12,15,304335,1150590,1454925,295.26,309.2,604.46
2021-02-25 08:00:00+08,3,11,14,304335,1065170,1369505,253.28,275.08,528.36
2021-02-25 12:00:00+08,3,10,13,304335,955538,1259873,239.24,263.65,502.89
2021-02-25 16:00:00+08,3,7,10,304335,669515,973850,251.22,196.29,447.51
2021-02-25 20:00:00+08,3,6,9,304335,569512,873847,263.21,199.8,463.01
2021-02-26 00:00:00+08,4,5,9,447734,520853,968587,251.83,149.4,401.23
2021-02-26 04:00:00+08,4,6,10,447734,624420,1072154,297.57,173.14,470.71
2021-02-26 08:00:00+08,4,5,9,447734,454670,902404,177.38,106.14,283.52
2021-02-26 12:00:00+08,3,4,7,332034,403973,736007,167.86,97.16,265.02
2021-02-26 16:00:00+08,2,5,7,216041,519673,735714,114.09,114.37,228.46
2021-02-26 20:00:00+08,2,5,7,216041,412444,628485,122.09,61.28,183.37
2021-02-27 00:00:00+08,2,7,9,216041,674860,890901,217.77,88.69,306.46
2021-02-27 04:00:00+08,2,8,10,216041,793695,1009736,230.69,119.42,350.11
2021-02-27 08:00:00+08,2,9,11,216041,897309,1113350,238.69,155.03,393.72
2021-02-27 12:00:00+08,2,8,10,216041,857951,1073992,246.69,174,420.69
2021-02-27 16:00:00+08,1,7,8,131266,804812,936078,183.15,172.52,355.67
2021-02-27 20:00:00+08,1,8,9,131266,889587,1020853,259.17,204.04,463.21
2021-02-28 00:00:00+08,1,8,9,131266,889587,1020853,263.17,236.04,499.21
2021-02-28 04:00:00+08,1,6,7,131266,682406,813672,237.49,192.66,430.15
2021-02-28 08:00:00+08,1,7,8,131266,739726,870992,241.49,217.79,459.28
2021-02-28 12:00:00+08,1,7,8,131266,739726,870992,245.49,245.79,491.28
2021-02-28 16:00:00+08,1,6,7,131266,623733,754999,161.74,229.83,391.57
2021-02-28 20:00:00+08,0,7,7,0,639858,639858,76.94,202.19,279.13
2021-03-01 00:00:00+08,0,8,8,0,761823,761823,74.2,80.93,155.13
2021-03-01 04:00:00+08,0,8,8,0,761823,761823,74.2,112.93,187.13
2021-03-01 08:00:00+08,0,10,10,0,901630,901630,74.2,150.27,224.47
2021-03-01 12:00:00+08,0,8,8,0,780915,780915,74.2,147.95,222.15
2021-03-01 16:00:00+08,0,8,8,0,780915,780915,74.2,179.95,254.15
2021-03-01 20:00:00+08,0,8,8,0,785833,785833,74.2,188.39,262.59
2021-03-02 00:00:00+08,0,9,9,0,807749,807749,96.61,119.7,216.31
2021-03-02 04:00:00+08,0,10,10,0,906815,906815,96.61,158.44,255.05
2021-03-02 08:00:00+08,0,10,10,0,906815,906815,96.61,198.44,295.05
2021-03-02 12:00:00+08,0,9,9,0,889624,889624,96.62,225.22,321.84
2021-03-02 16:00:00+08,0,9,9,0,889624,889624,96.62,261.22,357.84
2021-03-02 20:00:00+08,0,6,6,0,669394,669394,74.2,193.63,267.83
2021-03-03 00:00:00+08,0,7,7,0,719926,719926,74.2,220.16,294.36
2021-03-03 04:00:00+08,0,9,9,0,927822,927822,74.19,203.42,277.61
2021-03-03 08:00:00+08,0,13,13,0,1372952,1372952,74.24,243.7,317.94
2021-03-03 12:00:00+08,1,11,12,122110,1183953,1306063,74.63,199.07,273.7
2021-03-03 16:00:00+08,1,12,13,122110,1218267,1340377,78.63,246.55,325.18
2021-03-03 20:00:00+08,2,11,13,148131,1153644,1301775,10.1,203.71,213.81
2021-03-04 00:00:00+08,3,12,15,263831,1284880,1548711,21.04,251.49,272.53
2021-03-04 04:00:00+08,3,12,15,263831,1284880,1548711,33.04,299.49,332.53
2021-03-04 08:00:00+08,3,12,15,263831,1292382,1556213,45.07,264.71,309.78
2021-03-04 12:00:00+08,3,11,14,263831,1258068,1521899,57.07,289.23,346.3
2021-03-04 16:00:00+08,1,10,11,115700,1204261,1319961,18.94,300.84,319.78
2021-03-04 20:00:00+08,1,10,11,115700,1131216,1246916,47.97,297.8,345.77
2021-03-05 00:00:00+08,1,11,12,115700,1253326,1369026,85.66,340.56,426.22
2021-03-05 04:00:00+08,1,11,12,115700,1267868,1383568,89.68,338.33,428.01
2021-03-05 08:00:00+08,1,11,12,115700,1267868,1383568,93.68,382.33,476.01
2021-03-05 12:00:00+08,1,10,11,115700,1182108,1297808,97.68,398.1,495.78
2021-03-05 16:00:00+08,1,8,9,115700,1038912,1154612,76.6,373,449.6
2021-03-05 20:00:00+08,1,8,9,115700,999321,1115021,80.6,345.05,425.65
2021-03-06 00:00:00+08,1,8,9,115700,999321,1115021,84.6,377.05,461.65
2021-03-06 04:00:00+08,1,10,11,115700,1191424,1307124,88.62,415.43,504.05
2021-03-06 08:00:00+08,1,10,11,115700,1166378,1282078,92.59,383.43,476.02
2021-03-06 12:00:00+08,2,10,12,230805,1230688,1461493,99.28,413.4,512.68
2021-03-06 16:00:00+08,2,10,12,230805,1208288,1439093,107.3,389.05,496.35
2021-03-06 20:00:00+08,0,9,9,0,1087563,1087563,0,357.4,357.4
2021-03-07 00:00:00+08,0,9,9,0,1097456,1097456,72.68,240.44,313.12
2021-03-07 04:00:00+08,0,10,10,0,1207154,1207154,88.75,255.43,344.18
2021-03-07 08:00:00+08,0,11,11,0,1291842,1291842,88.75,298.86,387.61
2021-03-07 12:00:00+08,0,9,9,0,1101790,1101790,88.75,266.96,355.71
2021-03-07 16:00:00+08,0,9,9,0,1101790,1101790,88.75,302.96,391.71
2021-03-07 20:00:00+08,0,8,8,0,992954,992954,88.72,307.57,396.29
2021-03-08 00:00:00+08,0,8,8,0,992954,992954,88.72,339.57,428.29
2021-03-08 04:00:00+08,1,9,10,141574,1096622,1238196,92.44,374.71,467.15
2021-03-08 08:00:00+08,2,10,12,159896,1184056,1343952,97.17,366.55,463.72
2021-03-08 12:00:00+08,3,10,13,268573,1102047,1370620,36.38,371.69,408.07
2021-03-08 16:00:00+08,3,9,12,268573,1017359,1285932,48.38,376.26,424.64
2021-03-08 20:00:00+08,3,10,13,355413,1045619,1401032,31.73,371.56,403.29
2021-03-09 00:00:00+08,4,10,14,471406,979771,1451177,45.23,307.53,352.76
2021-03-09 04:00:00+08,5,11,16,640281,938319,1578600,59.68,334.17,393.85
2021-03-09 08:00:00+08,5,13,18,640281,1065283,1705564,100.51,383.96,484.47
2021-03-09 12:00:00+08,5,13,18,640281,1138523,1778804,120.54,422.37,542.91
2021-03-09 16:00:00+08,4,12,16,535119,1050917,1586036,120.37,441.84,562.21
2021-03-09 20:00:00+08,4,12,16,535119,1103425,1638544,159.79,413.82,573.61
2021-03-10 00:00:00+08,3,12,15,393545,1198281,1591826,128.08,475.11,603.19
2021-03-10 04:00:00+08,2,11,13,244553,1176145,1420698,148.69,451.49,600.18
2021-03-10 08:00:00+08,2,10,12,244553,1076685,1321238,184.26,393.18,577.44
2021-03-10 12:00:00+08,2,12,14,244553,1261930,1506483,192.27,437.96,630.23
2021-03-10 16:00:00+08,1,9,10,128560,1025344,1153904,158.83,361.89,520.72
2021-03-10 20:00:00+08,1,12,13,128560,1185852,1314412,207.73,375.71,583.44
2021-03-11 00:00:00+08,1,12,13,128560,1185852,1314412,211.73,423.71,635.44
2021-03-11 04:00:00+08,1,12,13,128560,1185852,1314412,215.73,471.71,687.44
2021-03-11 08:00:00+08,1,11,12,128560,1137373,1265933,219.73,442.15,661.88
2021-03-11 12:00:00+08,1,12,13,128560,1248987,1377547,223.7,490.07,713.77
2021-03-11 16:00:00+08,2,10,12,294098,1117175,1411273,208.14,471.68,679.82
2021-03-11 20:00:00+08,3,10,13,410091,1117175,1527266,219.46,511.68,731.14
2021-03-12 00:00:00+08,1,9,10,165538,1082886,1248424,155.92,523.15,679.07
2021-03-12 04:00:00+08,1,13,14,165538,1487141,1652679,238.36,569.1,807.46
2021-03-12 08:00:00+08,1,12,13,165538,1418860,1584398,242.36,584.25,826.61
2021-03-12 12:00:00+08,0,10,10,0,1194190,1194190,156.63,512.73,669.36
2021-03-12 16:00:00+08,0,10,10,0,1153722,1153722,156.67,500.04,656.71
2021-03-12 20:00:00+08,0,14,14,0,1514136,1514136,184.98,545.42,730.4
2021-03-13 00:00:00+08,0,13,13,0,1352870,1352870,134.25,268.03,402.28
2021-03-13 04:00:00+08,0,13,13,0,1352870,1352870,134.25,320.03,454.28
2021-03-13 08:00:00+08,0,13,13,0,1352870,1352870,134.25,372.03,506.28
2021-03-13 12:00:00+08,0,11,11,0,1101383,1101383,106.68,272.78,379.46
2021-03-13 16:00:00+08,0,11,11,0,1077475,1077475,37.03,281.78,318.81
2021-03-13 20:00:00+08,0,10,10,0,911315,911315,28.28,223.7,251.98
2021-03-14 00:00:00+08,0,9,9,0,851692,851692,28.28,234.97,263.25
2021-03-14 04:00:00+08,0,11,11,0,1017870,1017870,28.28,275.26,303.54
2021-03-14 08:00:00+08,0,9,9,0,879933,879933,28.28,229.37,257.65
2021-03-14 12:00:00+08,0,9,9,0,879933,879933,28.28,265.37,293.65
2021-03-14 16:00:00+08,0,9,9,0,879933,879933,28.28,301.37,329.65
2021-03-14 20:00:00+08,0,10,10,0,911403,911403,28.28,309.14,337.42
2021-03-15 00:00:00+08,1,10,11,16397,904968,921365,29.18,313.28,342.46
2021-03-15 04:00:00+08,1,8,9,16397,743907,760304,33.18,271.1,304.28
2021-03-15 08:00:00+08,1,8,9,16397,743907,760304,37.18,303.1,340.28
2021-03-15 12:00:00+08,1,6,7,16397,581772,598169,41.18,216.9,258.08
2021-03-15 16:00:00+08,1,5,6,16397,520325,536722,45.18,196.51,241.69
2021-03-15 20:00:00+08,0,5,5,0,545610,545610,28.28,192.49,220.77
2021-03-16 00:00:00+08,0,3,3,0,200179,200179,23.48,31.6,55.08
2021-03-16 04:00:00+08,0,4,4,0,346875,346875,23.48,46.23,69.71
2021-03-16 08:00:00+08,0,5,5,0,448592,448592,23.48,65.48,88.96
2021-03-16 12:00:00+08,0,6,6,0,595183,595183,23.48,86.61,110.09
2021-03-16 16:00:00+08,0,5,5,0,578786,578786,0,93.19,93.19
2021-03-16 20:00:00+08,0,6,6,0,609536,609536,0,73.66,73.66
2021-03-17 00:00:00+08,0,8,8,0,746121,746121,0,98.99,98.99
2021-03-17 04:00:00+08,0,10,10,0,793346,793346,0,134.59,134.59
2021-03-17 08:00:00+08,0,9,9,0,760256,760256,0,124.3,124.3
2021-03-17 12:00:00+08,0,9,9,0,863186,863186,0,151.89,151.89
2021-03-17 16:00:00+08,0,8,8,0,761469,761469,0,152.63,152.63
2021-03-17 20:00:00+08,0,12,12,0,1133238,1133238,0,189.08,189.08
2021-03-18 00:00:00+08,0,10,10,0,967041,967041,0,210.15,210.15
2021-03-18 04:00:00+08,0,8,8,0,830666,830666,0,143.31,143.31
2021-03-18 08:00:00+08,0,8,8,0,883465,883465,0,140.12,140.12
2021-03-18 12:00:00+08,0,7,7,0,857445,857445,0,154.21,154.21
2021-03-18 16:00:00+08,1,7,8,103891,857445,961336,0.93,182.21,183.14
2021-03-18 20:00:00+08,1,8,9,103891,938695,1042586,4.93,211.16,216.09
2021-03-19 00:00:00+08,1,9,10,103891,1034505,1138396,8.93,245.37,254.3
2021-03-19 04:00:00+08,0,9,9,0,1027425,1027425,0,249.33,249.33
2021-03-19 08:00:00+08,0,9,9,0,983802,983802,0,242.47,242.47
2021-03-19 12:00:00+08,0,9,9,0,957120,957120,19.75,225.37,245.12
2021-03-19 16:00:00+08,0,10,10,0,1106112,1106112,19.75,263.45,283.2
2021-03-19 20:00:00+08,1,13,14,71339,1252730,1324069,19.82,307.82,327.64
2021-03-20 00:00:00+08,1,13,14,71339,1252730,1324069,23.82,359.82,383.64
2021-03-20 04:00:00+08,1,13,14,71339,1252730,1324069,27.82,411.82,439.64
2021-03-20 08:00:00+08,1,12,13,71339,1106139,1177478,31.82,370.68,402.5
2021-03-20 12:00:00+08,1,12,13,71339,1106139,1177478,35.82,418.68,454.5
2021-03-20 16:00:00+08,1,6,7,71339,561966,633305,39.78,217.18,256.96
2021-03-20 20:00:00+08,0,6,6,0,675929,675929,19.72,166.29,186.01
2021-03-21 00:00:00+08,0,7,7,0,729182,729182,44.88,117.04,161.92
2021-03-21 04:00:00+08,0,7,7,0,728050,728050,25.17,107.37,132.54
2021-03-21 08:00:00+08,1,6,7,71285,697971,769256,26.04,97.42,123.46
2021-03-21 12:00:00+08,1,6,7,71285,697971,769256,30.04,121.42,151.46
2021-03-21 16:00:00+08,1,6,7,71285,697971,769256,34.04,145.42,179.46
2021-03-21 20:00:00+08,1,7,8,71285,799789,871074,38.04,171.01,209.05
2021-03-22 00:00:00+08,1,6,7,71285,664031,735316,42.04,117.79,159.83
2021-03-22 04:00:00+08,1,7,8,71285,729020,800305,46.06,145.35,191.41
2021-03-22 08:00:00+08,1,5,6,71285,572906,644191,24.88,105.64,130.52
2021-03-22 12:00:00+08,1,5,6,71285,572906,644191,28.88,125.64,154.52
2021-03-22 16:00:00+08,1,5,6,71285,572906,644191,32.88,145.64,178.52
2021-03-22 20:00:00+08,1,6,7,71285,584834,656119,36.88,149.7,186.58
2021-03-23 00:00:00+08,1,6,7,71285,584834,656119,40.88,173.7,214.58
2021-03-23 04:00:00+08,1,5,6,71285,556136,627421,52.22,160.4,212.62
2021-03-23 08:00:00+08,1,5,6,71285,556136,627421,56.22,180.4,236.62
2021-03-23 12:00:00+08,1,4,5,71285,399818,471103,60.23,30.05,90.28
2021-03-23 16:00:00+08,1,5,6,71285,541276,612561,64.23,48.87,113.1
2021-03-23 20:00:00+08,1,10,11,71285,1131000,1202285,68.22,51.82,120.04
2021-03-24 00:00:00+08,1,10,11,71285,1131000,1202285,72.22,91.82,164.04
2021-03-24 04:00:00+08,1,11,12,71285,1149349,1220634,76.22,132.51,208.73
2021-03-24 08:00:00+08,1,13,14,71285,1275295,1346580,80.25,180.98,261.23
2021-03-24 12:00:00+08,1,13,14,71285,1275295,1346580,84.25,232.98,317.23
2021-03-24 16:00:00+08,1,10,11,71285,989110,1060395,80.87,196.83,277.7
2021-03-24 20:00:00+08,1,12,13,71285,1197228,1268513,84.87,215.08,299.95
2021-03-25 00:00:00+08,1,14,15,71285,1378928,1450213,88.87,270.73,359.6
2021-03-25 04:00:00+08,1,14,15,71285,1296921,1368206,92.87,305.21,398.08
2021-03-25 08:00:00+08,1,12,13,71285,1248436,1319721,96.87,306.29,403.16
2021-03-25 12:00:00+08,1,12,13,71285,1248436,1319721,100.87,354.29,455.16
2021-03-25 16:00:00+08,1,11,12,71285,1135224,1206509,104.87,357.24,462.11
2021-03-25 20:00:00+08,2,10,12,150708,1121421,1272129,110.09,384.47,494.56
2021-03-26 00:00:00+08,1,8,9,71285,908236,979521,112.87,309.96,422.83
2021-03-26 04:00:00+08,0,6,6,0,759240,759240,8.73,243.7,252.43
2021-03-26 08:00:00+08,0,7,7,0,766120,766120,127.07,213.7,340.77
2021-03-26 12:00:00+08,0,8,8,0,833668,833668,127.07,174.4,301.47
2021-03-26 16:00:00+08,0,9,9,0,979056,979056,127.07,207.32,334.39
2021-03-26 20:00:00+08,0,9,9,0,979056,979056,127.07,243.32,370.39
2021-03-27 00:00:00+08,0,8,8,0,904579,904579,127.06,259.64,386.7
2021-03-27 04:00:00+08,1,9,10,103668,1012885,1116553,129.33,295.51,424.84
2021-03-27 08:00:00+08,2,9,11,167078,1012885,1179963,137.28,331.51,468.79
2021-03-27 12:00:00+08,2,9,11,167078,1012885,1179963,145.28,367.51,512.79
2021-03-27 16:00:00+08,2,9,11,167078,971802,1138880,153.25,310.74,463.99
2021-03-27 20:00:00+08,1,10,11,146778,1065971,1212749,9.38,311.84,321.22
2021-03-28 00:00:00+08,1,11,12,146778,1129381,1276159,30.32,354.84,385.16
2021-03-28 04:00:00+08,1,11,12,146778,1153626,1300404,47.98,354.2,402.18
2021-03-28 08:00:00+08,1,9,10,146778,939962,1086740,52.05,320.63,372.68
2021-03-28 12:00:00+08,1,9,10,146778,939962,1086740,56.05,356.63,412.68
2021-03-28 16:00:00+08,1,6,7,146778,668352,815130,43.12,257.48,300.6
2021-03-28 20:00:00+08,1,4,5,146778,479977,626755,47.1,100.68,147.78
2021-03-29 00:00:00+08,2,6,8,249539,661810,911349,51.97,118.59,170.56
2021-03-29 04:00:00+08,2,7,9,249539,765424,1014963,59.99,145.42,205.41
2021-03-29 08:00:00+08,2,8,10,244311,807585,1051896,35.28,111.08,146.36
2021-03-29 12:00:00+08,2,9,11,244311,954363,1198674,83.64,143.39,227.03
2021-03-29 16:00:00+08,2,7,9,244311,746850,991161,69.16,93.55,162.71
2021-03-29 20:00:00+08,2,9,11,244311,878650,1122961,77.14,125.26,202.4
2021-03-30 00:00:00+08,2,9,11,244311,878650,1122961,85.14,161.26,246.4
2021-03-30 04:00:00+08,2,9,11,244311,901003,1145314,93.14,171.42,264.56
2021-03-30 08:00:00+08,2,9,11,244311,909552,1153863,101.14,195.82,296.96
2021-03-30 12:00:00+08,2,9,11,244311,909552,1153863,109.14,231.82,340.96
2021-03-30 16:00:00+08,1,8,9,141550,805938,947488,76.29,228.98,305.27
2021-03-30 20:00:00+08,1,9,10,141550,928415,1069965,123.92,214.86,338.78
2021-03-31 00:00:00+08,1,10,11,141550,1069759,1211309,127.86,163.66,291.52
2021-03-31 04:00:00+08,1,10,11,141550,1069759,1211309,131.86,203.66,335.52
2021-03-31 08:00:00+08,2,10,12,282115,1069759,1351874,136.18,243.66,379.84
2021-03-31 12:00:00+08,1,8,9,140565,820120,960685,47.93,182.01,229.94
2021-03-31 16:00:00+08,1,8,9,140565,855610,996175,108.75,139.89,248.64
2021-03-31 20:00:00+08,1,8,9,140565,868460,1009025,112.75,130.49,243.24
2021-04-01 00:00:00+08,1,8,9,140565,868460,1009025,116.75,162.49,279.24
2021-04-01 04:00:00+08,1,7,8,140565,765699,906264,77.13,161.24,238.37
2021-04-01 08:00:00+08,1,6,7,140565,598301,738866,81.13,145.9,227.03
2021-04-01 12:00:00+08,1,5,6,140565,451509,592074,85.13,127.37,212.5
2021-04-01 16:00:00+08,1,3,4,140565,301120,441685,89.13,79.88,169.01
2021-04-01 20:00:00+08,1,5,6,140565,541913,682478,93.13,81.32,174.45
2021-04-02 00:00:00+08,1,6,7,140565,686044,826609,97.13,101.49,198.62
2021-04-02 04:00:00+08,1,6,7,140565,686044,826609,101.13,125.49,226.62
2021-04-02 08:00:00+08,1,7,8,140565,740201,880766,105.13,150.67,255.8
2021-04-02 12:00:00+08,1,7,8,140565,740201,880766,109.13,178.67,287.8
2021-04-02 16:00:00+08,1,7,8,140565,740201,880766,113.13,206.67,319.8
2021-04-02 20:00:00+08,1,8,9,140565,772063,912628,117.13,209.6,326.73
2021-04-03 00:00:00+08,1,9,10,140565,839703,980268,121.13,242.61,363.74
2021-04-03 04:00:00+08,1,9,10,140565,801014,941579,68.33,218.8,287.13
2021-04-03 08:00:00+08,1,9,10,140565,763507,904072,72.33,174.01,246.34
2021-04-03 12:00:00+08,2,9,11,203920,763507,967427,80.14,210.01,290.15
2021-04-03 16:00:00+08,2,9,11,203920,813429,1017349,88.15,226.42,314.57
2021-04-03 20:00:00+08,1,9,10,140565,744024,884589,84.33,214.47,298.8
2021-04-04 00:00:00+08,1,9,10,140565,791061,931626,104.01,174.41,278.42
2021-04-04 04:00:00+08,2,9,11,156962,791061,948023,109.12,210.41,319.53
2021-04-04 08:00:00+08,2,9,11,156962,791061,948023,117.12,246.41,363.53
2021-04-04 12:00:00+08,2,6,8,156962,494495,651457,125.12,176.49,301.61
2021-04-04 16:00:00+08,2,5,7,156962,460232,617194,133.11,178.84,311.95
2021-04-04 20:00:00+08,2,4,6,156962,406075,563037,141.11,137.66,278.77
2021-04-05 00:00:00+08,3,6,9,242785,578048,820833,149.95,208.75,358.7
2021-04-05 04:00:00+08,4,6,10,356910,578048,934958,164.31,232.75,397.06
2021-04-05 08:00:00+08,5,6,11,522332,578048,1100380,180.41,256.75,437.16
2021-04-05 12:00:00+08,4,5,9,436509,552012,988521,187.56,245.23,432.79
2021-04-05 16:00:00+08,3,5,8,356676,552012,908688,154.3,265.23,419.53
2021-04-05 20:00:00+08,3,9,12,356676,847621,1204297,222.32,293.73,516.05
2021-04-06 00:00:00+08,4,9,13,442499,847621,1290120,259.17,329.73,588.9
2021-04-06 04:00:00+08,6,9,15,649652,847621,1497273,282.24,365.73,647.97
2021-04-06 08:00:00+08,6,9,15,649652,847621,1497273,306.24,401.73,707.97
2021-04-06 12:00:00+08,6,8,14,649652,703490,1353142,330.24,329.56,659.8
2021-04-06 16:00:00+08,4,6,10,459432,601576,1061008,258.37,275.12,533.49
2021-04-06 20:00:00+08,4,9,13,522851,853612,1376463,292.85,163.94,456.79
2021-04-07 00:00:00+08,3,10,13,408743,907669,1316412,335.3,120.57,455.87
2021-04-07 04:00:00+08,2,12,14,268178,1055939,1324117,193.06,163.94,357
2021-04-07 08:00:00+08,2,11,13,268178,1031417,1299595,368.88,135.47,504.35
2021-04-07 12:00:00+08,3,12,15,377199,1061573,1438772,378.75,181.48,560.23
2021-04-07 16:00:00+08,3,12,15,377199,1061573,1438772,390.75,229.48,620.23
2021-04-07 20:00:00+08,3,11,14,377199,903557,1280756,359.09,226.27,585.36
2021-04-08 00:00:00+08,3,10,13,377199,869395,1246594,371.09,247.72,618.81
2021-04-08 04:00:00+08,3,11,14,377199,926715,1303914,383.09,291.46,674.55
2021-04-08 08:00:00+08,3,11,14,377199,950773,1327972,361.63,274.69,636.32
2021-04-08 12:00:00+08,3,9,12,377199,810058,1187257,373.63,259.57,633.2
2021-04-08 16:00:00+08,2,8,10,268178,751858,1020036,355.74,251.2,606.94
2021-04-08 20:00:00+08,1,9,10,165422,914079,1079501,311.17,181.89,493.06
2021-04-09 00:00:00+08,1,9,10,165422,905081,1070503,368.25,141.33,509.58
2021-04-09 04:00:00+08,1,9,10,165422,905081,1070503,372.25,177.33,549.58
2021-04-09 08:00:00+08,1,9,10,165422,907073,1072495,366.05,162.25,528.3
2021-04-09 12:00:00+08,1,10,11,165422,1007142,1172564,370.05,182.29,552.34
2021-04-09 16:00:00+08,1,10,11,165422,1007142,1172564,374.05,222.29,596.34
2021-04-09 20:00:00+08,0,9,9,0,957179,957179,269.96,242.05,512.01
2021-04-10 00:00:00+08,0,10,10,0,1020173,1020173,269.96,281.95,551.91
2021-04-10 04:00:00+08,0,11,11,0,1185595,1185595,384.18,323.85,708.03
2021-04-10 08:00:00+08,0,9,9,0,1001267,1001267,384.18,292.3,676.48
2021-04-10 12:00:00+08,0,9,9,0,1046914,1046914,384.22,315.61,699.83
2021-04-10 16:00:00+08,0,8,8,0,950012,950012,216.47,245.04,461.51
2021-04-10 20:00:00+08,0,8,8,0,950012,950012,216.47,277.04,493.51
2021-04-11 00:00:00+08,0,7,7,0,868841,868841,216.47,271.27,487.74
2021-04-11 04:00:00+08,0,9,9,0,1051920,1051920,216.46,302.27,518.73
2021-04-11 08:00:00+08,0,8,8,0,850360,850360,184.98,204.17,389.15
2021-04-11 12:00:00+08,1,8,9,26811,850360,877171,188.08,236.17,424.25
2021-04-11 16:00:00+08,1,8,9,26811,850360,877171,192.08,268.17,460.25
2021-04-11 20:00:00+08,2,8,10,112425,850360,962785,198.71,300.17,498.88
2021-04-12 00:00:00+08,2,6,8,142804,667281,810085,203.06,289.22,492.28
2021-04-12 04:00:00+08,1,4,5,115993,331544,447537,130.83,75.16,205.99
2021-04-12 08:00:00+08,1,5,6,115993,478322,594315,134.83,93.6,228.43
2021-04-12 12:00:00+08,0,5,5,0,474713,474713,147.06,86.57,233.63
2021-04-12 16:00:00+08,0,6,6,0,590706,590706,165.99,106.64,272.63
2021-04-12 20:00:00+08,0,7,7,0,717782,717782,165.97,131.99,297.96
2021-04-13 00:00:00+08,0,7,7,0,717782,717782,165.97,159.99,325.96
2021-04-13 04:00:00+08,1,7,8,26868,717782,744650,167.21,187.99,355.2
2021-04-13 08:00:00+08,1,9,10,26868,909988,936856,171.19,218.93,390.12
2021-04-13 12:00:00+08,1,8,9,26868,859900,886768,175.19,221.56,396.75
2021-04-13 16:00:00+08,0,7,7,0,848675,848675,133.11,187.14,320.25
2021-04-13 20:00:00+08,0,10,10,0,1046183,1046183,148.72,220.45,369.17
2021-04-14 00:00:00+08,0,11,11,0,1110067,1110067,34.54,168.29,202.83
2021-04-14 04:00:00+08,0,12,12,0,1177707,1177707,34.54,215,249.54
2021-04-14 08:00:00+08,1,13,14,146648,1114740,1261388,17.1,227.91,245.01
2021-04-14 12:00:00+08,1,13,14,146648,1114740,1261388,21.1,279.91,301.01
2021-04-14 16:00:00+08,1,12,13,146648,1087872,1234520,9.5,310.27,319.77
2021-04-14 20:00:00+08,1,9,10,146648,726412,873060,13.49,208.08,221.57
2021-04-15 00:00:00+08,0,8,8,0,637743,637743,0,218.38,218.38
2021-04-15 04:00:00+08,1,6,7,109000,576671,685671,19.72,152.56,172.28
2021-04-15 08:00:00+08,1,7,8,109000,708752,817752,23.75,143.8,167.55
2021-04-15 12:00:00+08,1,10,11,109000,957911,1066911,27.74,178.6,206.34
2021-04-15 16:00:00+08,1,9,10,109000,856711,965711,31.73,168.14,199.87
2021-04-15 20:00:00+08,1,8,9,109000,767457,876457,35.73,123.04,158.77
2021-04-16 00:00:00+08,1,8,9,109000,767457,876457,39.73,155.04,194.77
2021-04-16 04:00:00+08,1,8,9,109000,767457,876457,43.73,187.04,230.77
2021-04-16 08:00:00+08,1,7,8,109000,798462,907462,47.74,185,232.74
2021-04-16 12:00:00+08,1,7,8,109000,798462,907462,51.74,213,264.74
2021-04-16 16:00:00+08,1,5,6,109000,685720,794720,37.3,138.66,175.96
2021-04-16 20:00:00+08,1,9,10,109000,1093045,1202045,41.28,164.14,205.42
2021-04-17 00:00:00+08,1,10,11,109000,1123276,1232276,45.28,200.74,246.02
2021-04-17 04:00:00+08,1,10,11,109000,1123276,1232276,49.28,240.74,290.02
2021-04-17 08:00:00+08,1,10,11,109000,1123276,1232276,53.28,280.74,334.02
2021-04-17 12:00:00+08,1,9,10,109000,982639,1091639,57.28,236.71,293.99
2021-04-17 16:00:00+08,1,8,9,109000,919645,1028645,61.28,250.08,311.36
2021-04-17 20:00:00+08,1,7,8,109000,814563,923563,65.28,258.02,323.3
2021-04-18 00:00:00+08,1,5,6,109000,481701,590701,69.3,167.03,236.33
2021-04-18 04:00:00+08,1,7,8,109000,648402,757402,73.29,122.32,195.61
2021-04-18 08:00:00+08,1,8,9,109000,773761,882761,77.31,105.09,182.4
2021-04-18 12:00:00+08,1,7,8,109000,743530,852530,81.31,100.49,181.8
2021-04-18 16:00:00+08,1,7,8,109000,743530,852530,85.31,128.49,213.8
2021-04-18 20:00:00+08,1,9,10,109000,852330,961330,89.31,159.07,248.38
2021-04-19 00:00:00+08,1,8,9,109000,790721,899721,93.31,170.78,264.09
2021-04-19 04:00:00+08,1,10,11,109000,953934,1062934,97.27,209.64,306.91
2021-04-19 08:00:00+08,1,8,9,109000,759523,868523,101.29,191.63,292.92
2021-04-19 12:00:00+08,1,7,8,109000,617503,726503,105.29,153.51,258.8
2021-04-19 16:00:00+08,1,7,8,109000,746591,855591,109.31,135.45,244.76
2021-04-19 20:00:00+08,2,7,9,199634,684902,884536,114.88,97.78,212.66
2021-04-20 00:00:00+08,2,7,9,224700,651830,876530,123.94,53.62,177.56
2021-04-20 04:00:00+08,2,7,9,224700,651830,876530,131.94,81.62,213.56
2021-04-20 08:00:00+08,2,7,9,224700,651830,876530,139.94,109.62,249.56
2021-04-20 12:00:00+08,2,7,9,224700,642982,867682,147.92,103.28,251.2
2021-04-20 16:00:00+08,1,5,6,115700,641803,757503,22.63,72.14,94.77
2021-04-20 20:00:00+08,1,9,10,115700,998332,1114032,161.8,99.99,261.79
2021-04-21 00:00:00+08,3,9,12,328150,998332,1326482,168.72,135.99,304.71
2021-04-21 04:00:00+08,2,11,13,226553,1163884,1390437,175.08,176.31,351.39
2021-04-21 08:00:00+08,2,12,14,226553,1265481,1492034,189.11,223.96,413.07
2021-04-21 12:00:00+08,2,11,13,226553,1184479,1411032,197.11,252.35,449.46
2021-04-21 16:00:00+08,1,10,11,115700,1029687,1145387,187.85,246.75,434.6
2021-04-21 20:00:00+08,1,12,13,115700,1148233,1263933,207.17,246.48,453.65
2021-04-22 00:00:00+08,1,12,13,115700,1148233,1263933,211.17,294.48,505.65
2021-04-22 04:00:00+08,1,12,13,115700,1148233,1263933,215.17,342.48,557.65
2021-04-22 08:00:00+08,1,12,13,115700,1148233,1263933,219.17,390.48,609.65
2021-04-22 12:00:00+08,1,11,12,115700,1134594,1250294,223.17,421.94,645.11
2021-04-22 16:00:00+08,1,6,7,115700,745422,861122,227.2,259.98,487.18
2021-04-22 20:00:00+08,1,6,7,115700,745422,861122,96,234.78,330.78
2021-04-23 00:00:00+08,1,5,6,115700,643825,759525,93.94,215.16,309.1
2021-04-23 04:00:00+08,1,4,5,115700,497888,613588,97.94,150.24,248.18
2021-04-23 08:00:00+08,1,6,7,115700,649412,765112,101.94,169.96,271.9
2021-04-23 12:00:00+08,1,5,6,115700,518149,633849,105.93,137.2,243.13
2021-04-23 16:00:00+08,0,4,4,0,409149,409149,20.71,136.3,157.01
2021-04-23 20:00:00+08,0,6,6,0,544945,544945,112.14,79.82,191.96
2021-04-24 00:00:00+08,0,8,8,0,820925,820925,94.52,55.41,149.93
2021-04-24 04:00:00+08,0,8,8,0,820925,820925,94.52,87.41,181.93
2021-04-24 08:00:00+08,0,9,9,0,926371,926371,94.5,121.55,216.05
2021-04-24 12:00:00+08,0,7,7,0,791107,791107,94.5,109.73,204.23
2021-04-24 16:00:00+08,0,7,7,0,791107,791107,94.5,137.73,232.23
2021-04-24 20:00:00+08,0,10,10,0,1090547,1090547,3.12,142.53,145.65
2021-04-25 00:00:00+08,0,9,9,0,1011087,1011087,3.12,141.53,144.65
2021-04-25 04:00:00+08,0,9,9,0,1011087,1011087,3.12,177.53,180.65
2021-04-25 08:00:00+08,1,9,10,16397,997097,1013494,5.87,182.89,188.76
2021-04-25 12:00:00+08,1,8,9,16397,893429,909826,9.87,178.21,188.08
2021-04-25 16:00:00+08,1,7,8,16397,839272,855669,13.87,189.6,203.47
2021-04-25 20:00:00+08,1,7,8,16397,839272,855669,17.87,217.6,235.47
2021-04-26 00:00:00+08,1,7,8,16397,828827,845224,18.75,199.07,217.82
2021-04-26 04:00:00+08,1,4,5,16397,519040,535437,22.75,92.08,114.83
2021-04-26 08:00:00+08,1,5,6,16397,627876,644273,26.75,112.01,138.76
2021-04-26 12:00:00+08,2,4,6,118699,513499,632198,31.67,64.64,96.31
2021-04-26 16:00:00+08,1,4,5,102302,513499,615801,4.92,80.64,85.56
2021-04-26 20:00:00+08,1,7,8,102302,637793,740095,45.9,101.61,147.51
2021-04-27 00:00:00+08,1,10,11,102302,884962,987264,49.88,131.31,181.19
2021-04-27 04:00:00+08,0,11,11,0,987264,987264,51.86,173.33,225.19
2021-04-27 08:00:00+08,0,11,11,0,987264,987264,51.86,217.33,269.19
2021-04-27 12:00:00+08,0,9,9,0,848098,848098,51.88,206.05,257.93
2021-04-27 16:00:00+08,0,8,8,0,701511,701511,51.88,173.22,225.1
2021-04-27 20:00:00+08,0,10,10,0,902950,902950,51.89,190.14,242.03
2021-04-28 00:00:00+08,1,9,10,146648,886553,1033201,17.61,200.36,217.97
2021-04-28 04:00:00+08,1,9,10,146648,811879,958527,21.6,189.99,211.59
2021-04-28 08:00:00+08,1,8,9,146648,696256,842904,25.56,144.83,170.39
2021-04-28 12:00:00+08,1,8,9,146648,791938,938586,29.56,140.56,170.12
2021-04-28 16:00:00+08,1,5,6,146648,510288,656936,18.68,90.49,109.17
2021-04-28 20:00:00+08,1,7,8,146648,611728,758376,22.68,71,93.68
2021-04-29 00:00:00+08,1,8,9,146648,720175,866823,26.68,100.18,126.86
2021-04-29 04:00:00+08,1,8,9,146648,720175,866823,30.68,132.18,162.86
2021-04-29 08:00:00+08,1,8,9,146648,720175,866823,34.68,164.18,198.86
2021-04-29 12:00:00+08,1,5,6,146648,516462,663110,38.68,104.5,143.18
2021-04-29 16:00:00+08,1,5,6,146648,516462,663110,42.68,124.5,167.18
2021-04-29 20:00:00+08,1,10,11,146648,968175,1114823,46.7,116.1,162.8
2021-04-30 00:00:00+08,1,10,11,146648,948869,1095517,50.7,126.26,176.96
2021-04-30 04:00:00+08,1,10,11,146648,948869,1095517,54.7,166.26,220.96
2021-04-30 08:00:00+08,1,11,12,146648,963524,1110172,58.67,166.27,224.94
2021-04-30 12:00:00+08,1,11,12,85820,963524,1049344,0.91,210.27,211.18
2021-04-30 16:00:00+08,1,8,9,85820,856245,942065,69.22,127.05,196.27
2021-04-30 20:00:00+08,1,11,12,85820,1055023,1140843,73.22,163.2,236.42
2021-05-01 00:00:00+08,1,11,12,85820,1055023,1140843,77.22,207.2,284.42
2021-05-01 04:00:00+08,2,11,13,243917,1055023,1298940,84.63,251.2,335.83
2021-05-01 08:00:00+08,2,11,13,243917,1055023,1298940,92.63,295.2,387.83
2021-05-01 12:00:00+08,2,11,13,243917,1055023,1298940,100.63,339.2,439.83
2021-05-01 16:00:00+08,2,11,13,243917,1055023,1298940,108.63,383.2,491.83
2021-05-01 20:00:00+08,2,10,12,243917,906300,1150217,116.62,376.36,492.98
2021-05-02 00:00:00+08,1,6,7,158097,659010,817107,87.69,266.98,354.67
2021-05-02 04:00:00+08,0,6,6,0,685531,685531,104.46,189.68,294.14
2021-05-02 08:00:00+08,0,7,7,0,912659,912659,134.96,179.39,314.35
2021-05-02 12:00:00+08,0,7,7,0,912659,912659,134.96,207.39,342.35
2021-05-02 16:00:00+08,0,6,6,0,807114,807114,134.96,166.59,301.55
2021-05-02 20:00:00+08,0,6,6,0,807114,807114,134.96,190.59,325.55
2021-05-03 00:00:00+08,0,5,5,0,660466,660466,70.67,156.2,226.87
2021-05-03 04:00:00+08,0,3,3,0,397719,397719,70.67,67.21,137.88
2021-05-03 08:00:00+08,0,5,5,0,709650,709650,70.67,86.66,157.33
2021-05-03 12:00:00+08,0,6,6,0,760182,760182,70.67,109.64,180.31
2021-05-03 16:00:00+08,0,6,6,0,760182,760182,70.67,133.64,204.31
2021-05-03 20:00:00+08,0,6,6,0,691553,691553,30.49,118.2,148.69
2021-05-04 00:00:00+08,0,6,6,0,691553,691553,30.49,142.2,172.69
2021-05-04 04:00:00+08,1,7,8,145237,823588,968825,31.21,167.05,198.26
2021-05-04 08:00:00+08,1,6,7,145237,806397,951634,35.21,181.75,216.96
2021-05-04 12:00:00+08,1,4,5,145237,602063,747300,39.23,125.21,164.44
2021-05-04 16:00:00+08,1,4,5,145237,602063,747300,43.23,141.21,184.44
2021-05-04 20:00:00+08,1,5,6,145237,710362,855599,47.23,160.3,207.53
2021-05-05 00:00:00+08,1,6,7,145237,815211,960448,51.23,181.41,232.64
2021-05-05 04:00:00+08,1,5,6,145237,657114,802351,24.74,136.49,161.23
2021-05-05 08:00:00+08,1,9,10,145237,886355,1031592,28.74,160.22,188.96
2021-05-05 12:00:00+08,1,10,11,145237,986361,1131598,32.74,196.72,229.46
2021-05-05 16:00:00+08,1,11,12,145237,1105196,1250433,36.74,237.96,274.7
2021-05-05 20:00:00+08,1,10,11,145237,1009278,1154515,40.74,242.29,283.03
2021-05-06 00:00:00+08,1,9,10,145237,844096,989333,44.73,214.5,259.23
2021-05-06 04:00:00+08,1,10,11,145237,864697,1009934,48.73,205.54,254.27
2021-05-06 08:00:00+08,1,10,11,145237,864697,1009934,52.73,245.54,298.27
2021-05-06 12:00:00+08,1,9,10,145237,830383,975620,56.73,257.32,314.05
2021-05-06 16:00:00+08,0,5,5,0,444459,444459,0,114.92,114.92
2021-05-06 20:00:00+08,0,9,9,0,974832,974832,64.38,105.89,170.27
2021-05-07 00:00:00+08,0,10,10,0,1129624,1129624,64.41,142.05,206.46
2021-05-07 04:00:00+08,0,8,8,0,955165,955165,64.41,113.97,178.38
2021-05-07 08:00:00+08,0,9,9,0,989465,989465,64.41,147.84,212.25
2021-05-07 12:00:00+08,0,8,8,0,870630,870630,64.41,138.61,203.02
2021-05-07 16:00:00+08,0,8,8,0,870630,870630,64.41,170.61,235.02
2021-05-07 20:00:00+08,0,9,9,0,922825,922825,64.41,165.26,229.67
2021-05-08 00:00:00+08,0,11,11,0,1065593,1065593,64.41,205.59,270
2021-05-08 04:00:00+08,0,11,11,0,1065593,1065593,64.41,249.59,314
2021-05-08 08:00:00+08,0,11,11,0,1065593,1065593,64.41,293.59,358
2021-05-08 12:00:00+08,0,10,10,0,1047950,1047950,0,230.41,230.41
2021-05-08 16:00:00+08,0,8,8,0,957744,957744,0,232.31,232.31
2021-05-08 20:00:00+08,0,10,10,0,1063396,1063396,0,225.75,225.75
2021-05-09 00:00:00+08,1,11,12,115700,1137451,1253151,0.91,213.64,214.55
2021-05-09 04:00:00+08,1,10,11,115700,1033884,1149584,4.92,224.25,229.17
2021-05-09 08:00:00+08,1,8,9,115700,832034,947734,8.92,187.91,196.83
2021-05-09 12:00:00+08,1,8,9,115700,832034,947734,12.92,219.94,232.86
2021-05-09 16:00:00+08,1,6,7,115700,667335,783035,16.92,138.57,155.49
2021-05-09 20:00:00+08,1,9,10,115700,981705,1097405,20.93,168.06,188.99
2021-05-10 00:00:00+08,1,6,7,115700,690528,806228,24.92,111.36,136.28
2021-05-10 04:00:00+08,1,7,8,115700,765033,880733,28.92,138.67,167.59
2021-05-10 08:00:00+08,1,8,9,115700,860843,976543,32.91,169.65,202.56
2021-05-10 12:00:00+08,0,6,6,0,631706,631706,0,122.46,122.46
2021-05-10 16:00:00+08,0,6,6,0,631706,631706,0,146.46,146.46
2021-05-10 20:00:00+08,0,8,8,0,727450,727450,41.04,126.18,167.22
2021-05-11 00:00:00+08,1,7,8,148723,580429,729152,44.06,95.48,139.54
2021-05-11 04:00:00+08,1,7,8,148723,580429,729152,48.06,123.48,171.54
2021-05-11 08:00:00+08,1,7,8,148723,766652,915375,52.07,130.03,182.1
2021-05-11 12:00:00+08,1,7,8,148723,766652,915375,56.07,158.03,214.1
2021-05-11 16:00:00+08,1,6,7,148723,692147,840870,60.07,146.72,206.79
2021-05-11 20:00:00+08,1,9,10,148723,917688,1066411,23.02,151.05,174.07
2021-05-12 00:00:00+08,0,10,10,0,1021302,1021302,0,187.22,187.22
2021-05-12 04:00:00+08,0,10,10,0,1021302,1021302,0,227.22,227.22
2021-05-12 08:00:00+08,0,11,11,0,1170025,1170025,31.2,271.04,302.24
2021-05-12 12:00:00+08,0,12,12,0,1204314,1204314,31.2,317.76,348.96
2021-05-12 16:00:00+08,0,10,10,0,1019664,1019664,31.2,298.41,329.61
2021-05-12 20:00:00+08,0,11,11,0,986775,986775,31.2,231.55,262.75
2021-05-13 00:00:00+08,0,10,10,0,863597,863597,31.2,179.56,210.76
2021-05-13 04:00:00+08,0,10,10,0,863597,863597,31.2,219.56,250.76
2021-05-13 08:00:00+08,1,9,10,127360,829402,956762,33.74,222.34,256.08
2021-05-13 12:00:00+08,1,8,9,127360,802428,929788,37.74,241.58,279.32
2021-05-13 16:00:00+08,1,6,7,127360,593876,721236,41.72,192.11,233.83
2021-05-13 20:00:00+08,1,6,7,118712,590713,709425,1.83,177.27,179.1
2021-05-14 00:00:00+08,0,8,8,0,884280,884280,18.15,177.88,196.03
2021-05-14 04:00:00+08,0,9,9,0,912441,912441,25.35,164.33,189.68
2021-05-14 08:00:00+08,0,9,9,0,912441,912441,25.35,200.33,225.68
2021-05-14 12:00:00+08,0,9,9,0,912441,912441,25.35,236.33,261.68
2021-05-14 16:00:00+08,0,6,6,0,723733,723733,25.35,130.68,156.03
2021-05-14 20:00:00+08,0,8,8,0,840884,840884,25.35,159.77,185.12
2021-05-15 00:00:00+08,0,7,7,0,732310,732310,25.34,138.39,163.73
2021-05-15 04:00:00+08,0,7,7,0,732310,732310,25.34,166.39,191.73
2021-05-15 08:00:00+08,0,6,6,0,582101,582101,18.16,132.64,150.8
2021-05-15 12:00:00+08,0,4,4,0,464950,464950,18.16,119.57,137.73
2021-05-15 16:00:00+08,0,4,4,0,464950,464950,18.16,135.57,153.73
2021-05-15 20:00:00+08,0,7,7,0,806836,806836,18.16,146.75,164.91
2021-05-16 00:00:00+08,0,7,7,0,806836,806836,18.16,174.75,192.91
2021-05-16 04:00:00+08,0,7,7,0,806836,806836,18.16,202.75,220.91
2021-05-16 08:00:00+08,0,7,7,0,772891,772891,18.15,176.56,194.71
2021-05-16 12:00:00+08,1,7,8,16397,772891,789288,19.03,204.56,223.59
2021-05-16 16:00:00+08,1,7,8,16397,810906,827303,4.88,171.62,176.5
2021-05-16 20:00:00+08,1,6,7,16397,665346,681743,8.88,126.64,135.52
2021-05-17 00:00:00+08,1,5,6,16397,570866,587263,12.88,119.85,132.73
2021-05-17 04:00:00+08,1,8,9,16397,919666,936063,23.44,143.1,166.54
2021-05-17 08:00:00+08,1,6,7,16397,756338,772735,27.48,98.61,126.09
2021-05-17 12:00:00+08,1,6,7,16397,756338,772735,31.48,122.61,154.09
2021-05-17 16:00:00+08,0,6,6,0,744980,744980,6.6,104.6,111.2
2021-05-17 20:00:00+08,0,9,9,0,913935,913935,37.2,97.7,134.9
2021-05-18 00:00:00+08,0,11,11,0,1120396,1120396,37.2,135.67,172.87
2021-05-18 04:00:00+08,0,11,11,0,1120396,1120396,37.2,179.67,216.87
2021-05-18 08:00:00+08,0,11,11,0,1120396,1120396,37.2,223.67,260.87
2021-05-18 12:00:00+08,0,11,11,0,1120396,1120396,37.2,267.67,304.87
2021-05-18 16:00:00+08,1,11,12,84775,1120396,1205171,40.12,311.67,351.79
2021-05-18 20:00:00+08,1,8,9,84775,802110,886885,37.52,242.15,279.67
2021-05-19 00:00:00+08,1,8,9,145237,906214,1051451,12.26,214.27,226.53
2021-05-19 04:00:00+08,1,9,10,145237,924489,1069726,16.26,246.68,262.94
2021-05-19 08:00:00+08,1,10,11,145237,961535,1106772,20.26,254.08,274.34
2021-05-19 12:00:00+08,1,9,10,145237,943260,1088497,24.26,285.68,309.94
2021-05-19 16:00:00+08,1,7,8,145237,744596,889833,17.4,260.1,277.5
2021-05-19 20:00:00+08,2,5,7,179500,629063,808563,22.69,204.9,227.59
2021-05-20 00:00:00+08,2,7,9,179500,768583,948083,30.7,226.65,257.35
2021-05-20 04:00:00+08,3,6,9,265323,603208,868531,39.09,167.24,206.33
2021-05-20 08:00:00+08,3,9,12,265323,897555,1162878,51.1,199.2,250.3
2021-05-20 12:00:00+08,3,9,12,265323,897024,1162347,63.09,154,217.09
2021-05-20 16:00:00+08,2,9,11,179500,897024,1076524,62.69,190,252.69
2021-05-20 20:00:00+08,2,11,13,179500,955617,1135117,87.01,159.85,246.86
2021-05-21 00:00:00+08,3,11,14,295200,1055636,1350836,97.4,175.75,273.15
2021-05-21 04:00:00+08,3,11,14,295200,1107234,1402434,109.39,194,303.39
2021-05-21 08:00:00+08,3,11,14,295200,1107234,1402434,121.39,238,359.39
2021-05-21 12:00:00+08,3,9,12,295200,945074,1240274,133.4,211.33,344.73
2021-05-21 16:00:00+08,3,10,13,295200,1030589,1325789,145.4,250.62,396.02
2021-05-21 20:00:00+08,2,10,12,260937,1041490,1302427,91.78,225.69,317.47
2021-05-22 00:00:00+08,2,12,14,260937,1287143,1548080,99.78,267.35,367.13
2021-05-22 04:00:00+08,2,13,15,260937,1294169,1555106,161.07,275.68,436.75
2021-05-22 08:00:00+08,2,11,13,260937,1193773,1454710,169.07,240.3,409.37
2021-05-22 12:00:00+08,2,11,13,260937,1193773,1454710,177.07,284.3,461.37
2021-05-22 16:00:00+08,0,9,9,0,942948,942948,53.29,264.57,317.86
2021-05-22 20:00:00+08,0,12,12,0,1331621,1331621,136.78,287.1,423.88
2021-05-23 00:00:00+08,1,12,13,68126,1331621,1399747,145.99,335.1,481.09
2021-05-23 04:00:00+08,1,11,12,68126,1245861,1313987,149.99,331.65,481.64
2021-05-23 08:00:00+08,1,12,13,68126,1363036,1431162,153.99,379.59,533.58
2021-05-23 12:00:00+08,1,10,11,68126,1155844,1223970,157.97,312.98,470.95
2021-05-23 16:00:00+08,0,7,7,0,772213,772213,136.76,191.07,327.83
2021-05-23 20:00:00+08,0,6,6,0,701124,701124,163.73,139.87,303.6
2021-05-24 00:00:00+08,0,9,9,0,1060108,1060108,163.73,169.07,332.8
2021-05-24 04:00:00+08,1,8,9,128560,951809,1080369,164.39,171.71,336.1
2021-05-24 08:00:00+08,1,8,9,128560,944945,1073505,123.15,168.15,291.3
2021-05-24 12:00:00+08,1,8,9,128560,944945,1073505,127.15,200.15,327.3
2021-05-24 16:00:00+08,0,7,7,0,876819,876819,91.56,209.9,301.46
2021-05-24 20:00:00+08,0,9,9,0,966513,966513,106.42,135.23,241.65
2021-05-25 00:00:00+08,0,9,9,0,966513,966513,106.42,171.23,277.65
2021-05-25 04:00:00+08,1,8,9,27025,820953,847978,107.8,176.94,284.74
2021-05-25 08:00:00+08,1,8,9,27025,768352,795377,111.81,177.16,288.97
2021-05-25 12:00:00+08,1,9,10,27025,854184,881209,115.81,212.39,328.2
2021-05-25 16:00:00+08,0,7,7,0,728157,728157,106.44,193.13,299.57
2021-05-25 20:00:00+08,0,12,12,0,1158738,1158738,122.54,230.4,352.94
2021-05-26 00:00:00+08,0,11,11,0,1108109,1108109,122.54,248.57,371.11
2021-05-26 04:00:00+08,0,10,10,0,1048486,1048486,122.54,269.86,392.4
2021-05-26 08:00:00+08,0,11,11,0,1128305,1128305,122.54,259.69,382.23
2021-05-26 12:00:00+08,0,9,9,0,972720,972720,91.58,244.64,336.22
2021-05-26 16:00:00+08,0,9,9,0,972720,972720,91.58,280.64,372.22
2021-05-26 20:00:00+08,0,10,10,0,953693,953693,91.58,243.69,335.27
2021-05-27 00:00:00+08,0,10,10,0,1019240,1019240,91.58,265.68,357.26
2021-05-27 04:00:00+08,0,9,9,0,914588,914588,91.58,272.36,363.94
2021-05-27 08:00:00+08,0,8,8,0,792160,792160,0,154.14,154.14
2021-05-27 12:00:00+08,1,10,11,115700,1044214,1159914,0.98,191.37,192.35
2021-05-27 16:00:00+08,1,9,10,115700,935444,1051144,5,185.77,190.77
2021-05-27 20:00:00+08,1,11,12,115700,937971,1053671,9.02,160.94,169.96
2021-05-28 00:00:00+08,1,12,13,115700,1041862,1157562,13,206.14,219.14
2021-05-28 04:00:00+08,1,11,12,115700,1007548,1123248,17,221.56,238.56
2021-05-28 08:00:00+08,1,11,12,115700,1007548,1123248,21,265.56,286.56
2021-05-28 12:00:00+08,1,7,8,115700,693623,809323,24.99,148.83,173.82
2021-05-28 16:00:00+08,0,6,6,0,632014,632014,0,155.82,155.82
2021-05-28 20:00:00+08,0,9,9,0,999864,999864,31.68,124.07,155.75
2021-05-29 00:00:00+08,0,9,9,0,990316,990316,31.64,122.67,154.31
2021-05-29 04:00:00+08,0,9,9,0,990316,990316,31.64,158.67,190.31
2021-05-29 08:00:00+08,0,9,9,0,914905,914905,31.64,152.38,184.02
2021-05-29 12:00:00+08,0,9,9,0,914905,914905,31.64,188.38,220.02
2021-05-29 16:00:00+08,0,9,9,0,914905,914905,31.64,224.38,256.02
2021-05-29 20:00:00+08,0,7,7,0,710325,710325,31.66,140.49,172.15
2021-05-30 00:00:00+08,0,6,6,0,680094,680094,31.66,139.53,171.19
2021-05-30 04:00:00+08,0,7,7,0,746788,746788,31.66,165.92,197.58
2021-05-30 08:00:00+08,1,8,9,81247,892768,974015,34.44,194.55,228.99
2021-05-30 12:00:00+08,1,8,9,81247,892768,974015,38.44,226.55,264.99
2021-05-30 16:00:00+08,1,7,8,81247,777068,858315,10.78,213.21,223.99
2021-05-30 20:00:00+08,1,6,7,81247,689450,770697,14.77,217.07,231.84
2021-05-31 00:00:00+08,1,5,6,81247,622756,704003,18.77,218.68,237.45
2021-05-31 04:00:00+08,1,5,6,81247,622756,704003,22.77,238.68,261.45
2021-05-31 08:00:00+08,1,6,7,81247,685763,767010,26.77,261.05,287.82
2021-05-31 12:00:00+08,1,6,7,81247,685763,767010,30.77,285.05,315.82
2021-05-31 16:00:00+08,2,6,8,186409,763470,949879,34.97,252.79,287.76
2021-05-31 20:00:00+08,2,4,6,186409,459640,646049,42.97,59.43,102.4
2021-06-01 00:00:00+08,2,5,7,186409,563308,749717,50.98,75.89,126.87
2021-06-01 04:00:00+08,2,5,7,186409,640447,826856,58.98,74.79,133.77
2021-06-01 08:00:00+08,1,6,7,81247,745609,826856,66.34,95.43,161.77
2021-06-01 12:00:00+08,1,6,7,81247,745609,826856,70.34,119.43,189.77
2021-06-01 16:00:00+08,1,7,8,81247,834278,915525,74.35,144.07,218.42
2021-06-01 20:00:00+08,1,8,9,81247,918983,1000230,78.34,175.07,253.41
2021-06-02 00:00:00+08,1,10,11,81247,1126342,1207589,82.32,208.53,290.85
2021-06-02 04:00:00+08,1,10,11,81247,993791,1075038,86.3,143.27,229.57
2021-06-02 08:00:00+08,1,12,13,81247,1129540,1210787,90.29,185.78,276.07
2021-06-02 12:00:00+08,1,12,13,81247,1060161,1141408,94.3,200.84,295.14
2021-06-02 16:00:00+08,1,12,13,81247,1060161,1141408,98.3,248.84,347.14
2021-06-02 20:00:00+08,1,10,11,81247,835327,916574,86.77,185.44,272.21
2021-06-03 00:00:00+08,1,10,11,81247,865447,946694,90.76,177.32,268.08
2021-06-03 04:00:00+08,1,10,11,81247,865447,946694,94.76,217.32,312.08
2021-06-03 08:00:00+08,1,9,10,81247,798753,880000,98.76,243.41,342.17
2021-06-03 12:00:00+08,1,10,11,81247,900571,981818,102.76,281.23,383.99
2021-06-03 16:00:00+08,1,7,8,81247,604026,685273,106.76,194.85,301.61
2021-06-03 20:00:00+08,1,8,9,81247,769975,851222,110.78,124.34,235.12
2021-06-04 00:00:00+08,0,9,9,0,798154,798154,114.32,109.27,223.59
2021-06-04 04:00:00+08,0,11,11,0,917554,917554,114.32,148.59,262.91
2021-06-04 08:00:00+08,0,12,12,0,920540,920540,114.32,141.33,255.65
2021-06-04 12:00:00+08,0,11,11,0,866383,866383,114.32,172.51,286.83
2021-06-04 16:00:00+08,0,10,10,0,839572,839572,114.32,195.32,309.64
2021-06-04 20:00:00+08,1,11,12,71339,944516,1015855,116.48,227.09,343.57
2021-06-05 00:00:00+08,1,11,12,71339,944516,1015855,120.48,271.09,391.57
2021-06-05 04:00:00+08,1,11,12,71339,944516,1015855,124.48,315.09,439.57
2021-06-05 08:00:00+08,2,9,11,194298,879432,1073730,128.69,303.3,431.99
2021-06-05 12:00:00+08,2,9,11,194298,851098,1045396,136.69,322.54,459.23
2021-06-05 16:00:00+08,2,8,10,194298,800498,994796,144.7,317.69,462.39
2021-06-05 20:00:00+08,1,7,8,71339,743869,815208,37.7,209.63,247.33
2021-06-06 00:00:00+08,1,8,9,71339,797676,869015,41.68,238.7,280.38
2021-06-06 04:00:00+08,1,7,8,71339,762610,833949,45.68,252.84,298.52
2021-06-06 08:00:00+08,1,6,7,71339,621036,692375,49.68,218.15,267.83
2021-06-06 12:00:00+08,1,6,7,71339,689870,761209,53.7,120.28,173.98
2021-06-06 16:00:00+08,0,5,5,0,635032,635032,11.55,57.89,69.44
2021-06-06 20:00:00+08,0,9,9,0,998310,998310,60.27,84.62,144.89
2021-06-07 00:00:00+08,1,9,10,111614,998310,1109924,63.71,120.62,184.33
2021-06-07 04:00:00+08,1,9,10,111614,998310,1109924,67.71,156.62,224.33
2021-06-07 08:00:00+08,1,8,9,111614,882317,993931,71.71,154.39,226.1
2021-06-07 12:00:00+08,1,6,7,111614,655744,767358,64.17,119.81,183.98
2021-06-07 16:00:00+08,0,6,6,0,655744,655744,48.72,143.81,192.53
2021-06-07 20:00:00+08,0,9,9,0,1031883,1031883,22.12,149.36,171.48
2021-06-08 00:00:00+08,0,7,7,0,897020,897020,22.12,125.64,147.76
2021-06-08 04:00:00+08,0,7,7,0,897020,897020,22.12,153.64,175.76
2021-06-08 08:00:00+08,0,8,8,0,1002565,1002565,22.1,184.53,206.63
2021-06-08 12:00:00+08,0,8,8,0,1002565,1002565,22.1,216.53,238.63
2021-06-08 16:00:00+08,0,8,8,0,936661,936661,22.1,193.98,216.08
2021-06-08 20:00:00+08,0,9,9,0,953058,953058,22.1,228.18,250.28
2021-06-09 00:00:00+08,0,10,10,0,1056726,1056726,22.14,264.81,286.95
2021-06-09 04:00:00+08,0,11,11,0,1055744,1055744,22.1,271.99,294.09
2021-06-09 08:00:00+08,0,11,11,0,1055744,1055744,22.1,315.99,338.09
2021-06-09 12:00:00+08,0,10,10,0,974742,974742,22.1,339.07,361.17
2021-06-09 16:00:00+08,0,8,8,0,827059,827059,22.12,311.8,333.92
2021-06-09 20:00:00+08,0,6,6,0,568266,568266,22.11,220.38,242.49
2021-06-10 00:00:00+08,0,8,8,0,677103,677103,22.12,169.22,191.34
2021-06-10 04:00:00+08,0,10,10,0,930739,930739,22.1,202.39,224.49
2021-06-10 08:00:00+08,0,12,12,0,1188938,1188938,22.14,249.58,271.72
2021-06-10 12:00:00+08,0,10,10,0,1043162,1043162,0,198.5,198.5
2021-06-10 16:00:00+08,1,10,11,103668,1043162,1146830,1.14,238.5,239.64
2021-06-10 20:00:00+08,1,9,10,103668,858167,961835,5.17,152.36,157.53
2021-06-11 00:00:00+08,1,11,12,103668,1061912,1165580,9.17,125.04,134.21
2021-06-11 04:00:00+08,1,11,12,103668,1061912,1165580,13.17,169.04,182.21
2021-06-11 08:00:00+08,1,12,13,103668,1170218,1273886,17.17,215.77,232.94
2021-06-11 12:00:00+08,1,10,11,103668,1001086,1104754,21.16,206.09,227.25
2021-06-11 16:00:00+08,1,9,10,103668,888570,992238,25.16,210.31,235.47
2021-06-11 20:00:00+08,2,10,12,230744,952306,1183050,29.58,224.01,253.59
2021-06-12 00:00:00+08,2,11,13,230744,1032349,1263093,37.59,226.74,264.33
2021-06-12 04:00:00+08,2,12,14,230744,1045412,1276156,45.59,274.01,319.6
2021-06-12 08:00:00+08,2,12,14,230744,1045412,1276156,53.59,322.01,375.6
2021-06-12 12:00:00+08,3,10,13,377335,930222,1307557,63.51,302.93,366.44
2021-06-12 16:00:00+08,3,10,13,377335,930222,1307557,75.51,342.93,418.44
2021-06-12 20:00:00+08,3,9,12,377335,769720,1147055,87.51,249.78,337.29
2021-06-13 00:00:00+08,2,8,10,273667,727847,1001514,42.34,215.26,257.6
2021-06-13 04:00:00+08,2,9,11,273667,824560,1098227,111.38,197.83,309.21
2021-06-13 08:00:00+08,2,10,12,273667,927319,1200986,119.36,237.25,356.61
2021-06-13 12:00:00+08,1,6,7,127076,513760,640836,101.46,75.96,177.42
2021-06-13 16:00:00+08,2,5,7,229837,487110,716947,105.75,77.57,183.32
2021-06-13 20:00:00+08,2,7,9,229837,749694,979531,145.16,102.58,247.74
2021-06-14 00:00:00+08,2,7,9,229837,749784,979621,153.16,106.62,259.78
2021-06-14 04:00:00+08,2,6,8,229837,613437,843274,168.94,78.82,247.76
2021-06-14 08:00:00+08,2,9,11,229837,879307,1109144,176.92,108.15,285.07
2021-06-14 12:00:00+08,2,9,11,229837,879307,1109144,184.92,144.15,329.07
2021-06-14 16:00:00+08,1,8,9,127076,733919,860995,168.61,140.72,309.33
2021-06-14 20:00:00+08,2,11,13,179589,992552,1172141,200.93,152.67,353.6
2021-06-15 00:00:00+08,2,13,15,179589,1215124,1394713,208.95,198.97,407.92
2021-06-15 04:00:00+08,0,12,12,0,1133547,1133547,126.86,228.47,355.33
2021-06-15 08:00:00+08,0,12,12,0,1211444,1211444,153.92,165.28,319.2
2021-06-15 12:00:00+08,0,12,12,0,1211444,1211444,153.92,213.28,367.2
2021-06-15 16:00:00+08,0,12,12,0,1297867,1297867,153.88,240.3,394.18
2021-06-15 20:00:00+08,0,12,12,0,1307170,1307170,153.88,251.19,405.07
2021-06-16 00:00:00+08,0,12,12,0,1307170,1307170,153.88,299.19,453.07
2021-06-16 04:00:00+08,0,11,11,0,1204409,1204409,127.28,313.48,440.76
2021-06-16 08:00:00+08,0,11,11,0,1254757,1254757,114.03,334.29,448.32
2021-06-16 12:00:00+08,0,12,12,0,1289071,1289071,114.03,381.58,495.61
2021-06-16 16:00:00+08,0,8,8,0,874244,874244,114.03,288.49,402.52
2021-06-16 20:00:00+08,0,9,9,0,959112,959112,114.03,321.84,435.87
2021-06-17 00:00:00+08,0,9,9,0,895716,895716,114.06,241.47,355.53
2021-06-17 04:00:00+08,0,8,8,0,762195,762195,0,149.51,149.51
2021-06-17 08:00:00+08,0,6,6,0,573713,573713,0,127.29,127.29
2021-06-17 12:00:00+08,0,7,7,0,667111,667111,0,154.26,154.26
2021-06-17 16:00:00+08,0,8,8,0,806018,806018,0,182.8,182.8
2021-06-17 20:00:00+08,0,7,7,0,800091,800091,0,159.74,159.74
2021-06-18 00:00:00+08,0,8,8,0,857411,857411,0,189.02,189.02
2021-06-18 04:00:00+08,0,9,9,0,892447,892447,0,223.34,223.34
2021-06-18 08:00:00+08,0,10,10,0,972139,972139,0,214.78,214.78
2021-06-18 12:00:00+08,0,11,11,0,1116270,1116270,0,257.96,257.96
2021-06-18 16:00:00+08,0,11,11,0,1116270,1116270,0,301.96,301.96
2021-06-18 20:00:00+08,0,11,11,0,1094238,1094238,0,198,198
2021-06-19 00:00:00+08,1,11,12,104357,1017086,1121443,1.9,199.04,200.94
2021-06-19 04:00:00+08,1,11,12,104357,1106273,1210630,5.9,214.83,220.73
2021-06-19 08:00:00+08,1,10,11,104357,1071237,1175594,9.9,228.51,238.41
2021-06-19 12:00:00+08,1,10,11,104357,1095434,1199791,13.9,239.43,253.33
2021-06-19 16:00:00+08,1,10,11,104357,1095434,1199791,17.9,279.43,297.33
2021-06-19 20:00:00+08,1,9,10,104357,1032440,1136797,21.9,298.07,319.97
2021-06-20 00:00:00+08,1,7,8,104357,834523,938880,25.9,273.65,299.55
2021-06-20 04:00:00+08,1,7,8,104357,834523,938880,29.9,301.65,331.55
2021-06-20 08:00:00+08,1,8,9,104357,943293,1047650,33.89,332.35,366.24
2021-06-20 12:00:00+08,1,6,7,104357,718782,823139,37.87,268.93,306.8
2021-06-20 16:00:00+08,1,5,6,104357,632976,737333,41.87,264.13,306
2021-06-20 20:00:00+08,1,5,6,104357,582737,687094,45.89,195.43,241.32
2021-06-21 00:00:00+08,2,4,6,207113,488076,695189,50.94,118.8,169.74
2021-06-21 04:00:00+08,1,4,5,104357,488076,592433,53.88,134.8,188.68
2021-06-21 08:00:00+08,1,5,6,104357,590832,695189,63.86,153.88,217.74
2021-06-21 12:00:00+08,1,5,6,104357,590832,695189,67.86,173.88,241.74
2021-06-21 16:00:00+08,1,5,6,104357,590832,695189,71.86,193.88,265.74
2021-06-21 20:00:00+08,1,6,7,104357,589896,694253,75.89,131.48,207.37
2021-06-22 00:00:00+08,1,8,9,104357,733770,838127,79.87,159.38,239.25
2021-06-22 04:00:00+08,0,8,8,0,733770,733770,6,191.38,197.38
2021-06-22 08:00:00+08,0,11,11,0,1010187,1010187,85.9,228.61,314.51
2021-06-22 12:00:00+08,0,11,11,0,1010187,1010187,85.9,272.61,358.51
2021-06-22 16:00:00+08,0,11,11,0,1010187,1010187,85.9,316.61,402.51
2021-06-22 20:00:00+08,0,13,13,0,1188351,1188351,79.95,303.21,383.16
2021-06-23 00:00:00+08,1,11,12,90634,956034,1046668,81.83,257.77,339.6
2021-06-23 04:00:00+08,2,12,14,206627,1121456,1328083,87.52,302.98,390.5
2021-06-23 08:00:00+08,2,12,14,206627,1150804,1357431,95.52,290.8,386.32
2021-06-23 12:00:00+08,3,10,13,264654,894898,1159552,104.23,233.6,337.83
2021-06-23 16:00:00+08,2,9,11,174020,876576,1050596,98.42,240.53,338.95
2021-06-23 20:00:00+08,2,8,10,174020,796353,970373,127.14,165.78,292.92
2021-06-24 00:00:00+08,2,8,10,174020,803836,977856,55.19,132.37,187.56
2021-06-24 04:00:00+08,2,9,11,174020,975115,1149135,63.22,111.76,174.98
2021-06-24 08:00:00+08,2,11,13,174020,1180950,1354970,71.26,154.18,225.44
2021-06-24 12:00:00+08,2,11,13,174020,1175069,1349089,79.22,160.18,239.4
2021-06-24 16:00:00+08,2,10,12,174020,1095189,1269209,87.22,170.99,258.21
2021-06-24 20:00:00+08,3,9,12,226533,1065053,1291586,98.22,188.22,286.44
2021-06-25 00:00:00+08,4,10,14,349494,1168701,1518195,110.47,225.15,335.62
2021-06-25 04:00:00+08,4,10,14,349494,1168701,1518195,126.47,265.15,391.62
2021-06-25 08:00:00+08,4,10,14,349494,1168701,1518195,142.47,305.15,447.62
2021-06-25 12:00:00+08,4,9,13,349494,1052708,1402202,158.5,306.62,465.12
2021-06-25 16:00:00+08,3,8,11,233501,920673,1154174,112.77,307.97,420.74
2021-06-25 20:00:00+08,3,10,13,233501,1080017,1313518,187.25,307.11,494.36
2021-06-26 00:00:00+08,3,9,12,233501,978170,1211671,199.19,293.5,492.69
2021-06-26 04:00:00+08,2,8,10,110540,887536,998076,162.21,272.35,434.56
2021-06-26 08:00:00+08,2,9,11,110540,1010497,1121037,199.82,307.02,506.84
2021-06-26 12:00:00+08,2,8,10,110540,868947,979487,207.82,287,494.82
2021-06-26 16:00:00+08,2,8,10,110540,994384,1104924,215.83,280.6,496.43
2021-06-26 20:00:00+08,0,9,9,0,1102599,1102599,92.05,315.46,407.51
2021-06-27 00:00:00+08,0,9,9,0,945207,945207,176.34,250.66,427
2021-06-27 04:00:00+08,0,10,10,0,997720,997720,231.5,290.51,522.01
2021-06-27 08:00:00+08,0,6,6,0,584304,584304,169.06,95.09,264.15
2021-06-27 12:00:00+08,1,6,7,85437,584304,669741,170.66,119.09,289.75
2021-06-27 16:00:00+08,1,6,7,85437,584304,669741,174.66,143.09,317.75
2021-06-27 20:00:00+08,1,6,7,85437,670619,756056,94.37,149.19,243.56
2021-06-28 00:00:00+08,1,8,9,16397,927696,944093,84.99,176.81,261.8
2021-06-28 04:00:00+08,1,6,7,16397,696520,712917,59.38,127.27,186.65
2021-06-28 08:00:00+08,2,6,8,66929,688102,755031,27.14,83.27,110.41
2021-06-28 12:00:00+08,2,6,8,66929,660546,727475,35.14,64.11,99.25
2021-06-28 16:00:00+08,1,6,7,50532,660546,711078,26.93,88.11,115.04
2021-06-28 20:00:00+08,1,9,10,50532,871784,922316,49.13,115.83,164.96
2021-06-29 00:00:00+08,2,9,11,117696,871784,989480,56.05,151.83,207.88
2021-06-29 04:00:00+08,2,10,12,117696,1028860,1146556,64.05,191.03,255.08
2021-06-29 08:00:00+08,2,11,13,117696,1116466,1234162,72.04,232.54,304.58
2021-06-29 12:00:00+08,2,11,13,117696,1145414,1263110,80.04,241.7,321.74
2021-06-29 16:00:00+08,2,12,14,117696,1179576,1297272,88.04,286.45,374.49
2021-06-29 20:00:00+08,2,12,14,117696,1259926,1377622,77.85,237.24,315.09
2021-06-30 00:00:00+08,2,13,15,117696,1366838,1484534,85.85,289.11,374.96
2021-06-30 04:00:00+08,2,13,15,117696,1366838,1484534,93.85,341.11,434.96
2021-06-30 08:00:00+08,2,14,16,117696,1448009,1565705,101.88,395.04,496.92
2021-06-30 12:00:00+08,2,14,16,117696,1448009,1565705,109.88,451.04,560.92
2021-06-30 16:00:00+08,2,12,14,180236,1253551,1433787,46.27,401.96,448.23
2021-06-30 20:00:00+08,2,11,13,180236,1025435,1205671,112.93,349.85,462.78
2021-07-01 00:00:00+08,3,13,16,301083,1228576,1529659,122.94,368.02,490.96
2021-07-01 04:00:00+08,2,12,14,188011,1145258,1333269,119.61,412.95,532.56
2021-07-01 08:00:00+08,2,12,14,188011,1097118,1285129,146.55,401.27,547.82
2021-07-01 12:00:00+08,2,11,13,188011,1062956,1250967,154.55,404.54,559.09
2021-07-01 16:00:00+08,1,10,11,67164,917568,984732,144.54,392.63,537.17
2021-07-01 20:00:00+08,1,11,12,67164,946275,1013439,89.86,272.42,362.28
2021-07-02 00:00:00+08,1,11,12,67164,922780,989944,116.26,217.45,333.71
2021-07-02 04:00:00+08,1,11,12,67164,997109,1064273,120.25,243.77,364.02
2021-07-02 08:00:00+08,1,11,12,67164,1060281,1127445,124.25,207.55,331.8
2021-07-02 12:00:00+08,1,10,11,67164,1030373,1097537,128.29,199.87,328.16
2021-07-02 16:00:00+08,1,9,10,67164,979504,1046668,132.29,193.04,325.33
2021-07-02 20:00:00+08,0,8,8,0,975159,975159,41.3,179.63,220.93
2021-07-03 00:00:00+08,0,10,10,0,1143920,1143920,139.48,214.32,353.8
2021-07-03 04:00:00+08,0,10,10,0,1143920,1143920,139.48,254.32,393.8
2021-07-03 08:00:00+08,1,12,13,105358,1297018,1402376,139.76,298.38,438.14
2021-07-03 12:00:00+08,1,11,12,105358,1200038,1305396,143.73,286.02,429.75
2021-07-03 16:00:00+08,0,9,9,0,985766,985766,120.5,233.6,354.1
2021-07-03 20:00:00+08,0,11,11,0,1122096,1122096,131.6,250.31,381.91
2021-07-04 00:00:00+08,0,11,11,0,1149561,1149561,33.44,272.35,305.79
2021-07-04 04:00:00+08,0,11,11,0,1149561,1149561,33.44,316.35,349.79
2021-07-04 08:00:00+08,0,9,9,0,901638,901638,11.04,254.15,265.19
2021-07-04 12:00:00+08,0,9,9,0,901638,901638,11.04,290.15,301.19
2021-07-04 16:00:00+08,0,5,5,0,454682,454682,11.04,150,161.04
2021-07-04 20:00:00+08,0,3,3,0,258456,258456,11.02,101.26,112.28
2021-07-05 00:00:00+08,0,3,3,0,258456,258456,11.02,113.26,124.28
2021-07-05 04:00:00+08,0,3,3,0,258456,258456,11.02,125.26,136.28
2021-07-05 08:00:00+08,1,4,5,63410,367226,430636,11.21,137.3,148.51
2021-07-05 12:00:00+08,0,4,4,0,367226,367226,11.04,153.3,164.34
2021-07-05 16:00:00+08,0,5,5,0,430636,430636,15.7,172.81,188.51
2021-07-05 20:00:00+08,2,9,11,163134,841115,1004249,19.1,199.47,218.57
2021-07-06 00:00:00+08,2,9,11,163134,841115,1004249,27.1,235.47,262.57
2021-07-06 04:00:00+08,2,9,11,163134,848702,1011836,35.09,203.31,238.4
2021-07-06 08:00:00+08,2,9,11,163134,848702,1011836,43.09,239.31,282.4
2021-07-06 12:00:00+08,2,8,10,163134,785292,948426,46.45,251.79,298.24
2021-07-06 16:00:00+08,1,6,7,74505,649266,723771,13.44,179.75,193.19
2021-07-06 20:00:00+08,2,10,12,168050,975763,1143813,67.99,184.17,252.16
2021-07-07 00:00:00+08,3,11,14,312200,994038,1306238,76.96,228.02,304.98
2021-07-07 04:00:00+08,3,11,14,252969,994038,1247007,82.08,272.02,354.1
2021-07-07 08:00:00+08,2,10,12,218655,960538,1179193,99.66,257.44,357.1
2021-07-07 12:00:00+08,1,9,10,74505,743557,818062,91.95,169.66,261.61
2021-07-07 16:00:00+08,1,7,8,74505,675337,749842,111.67,127.01,238.68
2021-07-07 20:00:00+08,1,8,9,74505,779005,853510,115.66,156.75,272.41
2021-07-08 00:00:00+08,1,8,9,74505,830009,904514,93.95,160.83,254.78
2021-07-08 04:00:00+08,1,8,9,74505,830009,904514,97.95,192.83,290.78
2021-07-08 08:00:00+08,1,7,8,74505,698651,773156,101.94,163,264.94
2021-07-08 12:00:00+08,1,8,9,74505,815091,889596,105.95,194.08,300.03
2021-07-08 16:00:00+08,1,7,8,74505,780777,855282,101.66,196.31,297.97
2021-07-08 20:00:00+08,0,9,9,0,905602,905602,51.27,227.71,278.98
2021-07-09 00:00:00+08,0,11,11,0,1126755,1126755,107.44,267.74,375.18
2021-07-09 04:00:00+08,1,12,13,120934,1235061,1355995,107.54,312.01,419.55
2021-07-09 08:00:00+08,1,12,13,120934,1235061,1355995,111.54,360.01,471.55
2021-07-09 12:00:00+08,1,11,12,120934,1173452,1294386,115.54,390.28,505.82
2021-07-09 16:00:00+08,0,10,10,0,1069784,1069784,107.46,388.52,495.98
2021-07-09 20:00:00+08,0,11,11,0,1186502,1186502,121.18,397.63,518.81
2021-07-10 00:00:00+08,0,12,12,0,1209132,1209132,65.06,340.47,405.53
2021-07-10 04:00:00+08,0,11,11,0,1096773,1096773,41.19,307.16,348.35
2021-07-10 08:00:00+08,0,8,8,0,793143,793143,29.54,192.93,222.47
2021-07-10 12:00:00+08,0,8,8,0,793143,793143,29.54,224.93,254.47
2021-07-10 16:00:00+08,0,8,8,0,793143,793143,29.54,256.93,286.47
2021-07-10 20:00:00+08,0,6,6,0,666927,666927,29.54,216.61,246.15
2021-07-11 00:00:00+08,0,8,8,0,894857,894857,29.54,193.24,222.78
2021-07-11 04:00:00+08,0,7,7,0,836657,836657,29.54,196.44,225.98
2021-07-11 08:00:00+08,0,6,6,0,653265,653265,13.77,100.1,113.87
2021-07-11 12:00:00+08,0,6,6,0,725570,725570,13.77,90.4,104.17
2021-07-11 16:00:00+08,0,6,6,0,725570,725570,13.77,114.4,128.17
2021-07-11 20:00:00+08,0,7,7,0,829238,829238,13.76,140.39,154.15
2021-07-12 00:00:00+08,0,6,6,0,708304,708304,0,114.07,114.07
2021-07-12 04:00:00+08,0,6,6,0,724820,724820,0,110.05,110.05
2021-07-12 08:00:00+08,0,6,6,0,724820,724820,0,134.05,134.05
2021-07-12 12:00:00+08,1,6,7,127076,724820,851896,2.09,158.05,160.14
2021-07-12 16:00:00+08,1,6,7,127076,724820,851896,6.09,182.05,188.14
2021-07-12 20:00:00+08,1,9,10,127076,908018,1035094,10.09,209.42,219.51
2021-07-13 00:00:00+08,1,9,10,127076,908018,1035094,14.09,245.42,259.51
2021-07-13 04:00:00+08,1,10,11,127076,926340,1053416,18.09,283.26,301.35
2021-07-13 08:00:00+08,1,10,11,127076,931672,1058748,22.09,288.13,310.22
2021-07-13 12:00:00+08,0,8,8,0,716670,716670,0,213.32,213.32
2021-07-13 16:00:00+08,0,7,7,0,564067,564067,0,173.19,173.19
2021-07-13 20:00:00+08,0,7,7,0,624567,624567,32.7,137.3,170
2021-07-14 00:00:00+08,0,8,8,0,726385,726385,32.7,166.2,198.9
2021-07-14 04:00:00+08,0,11,11,0,1071257,1071257,32.7,206.22,238.92
2021-07-14 08:00:00+08,0,10,10,0,933031,933031,32.68,141.26,173.94
2021-07-14 12:00:00+08,0,11,11,0,1079618,1079618,32.7,182.04,214.74
2021-07-14 16:00:00+08,0,11,11,0,1079618,1079618,32.7,226.04,258.74
2021-07-14 20:00:00+08,0,7,7,0,678311,678311,32.7,139.64,172.34
2021-07-15 00:00:00+08,0,7,7,0,678311,678311,32.7,167.64,200.34
2021-07-15 04:00:00+08,0,6,6,0,712150,712150,32.7,109.98,142.68
2021-07-15 08:00:00+08,1,7,8,118712,801281,919993,4,102,106
2021-07-15 12:00:00+08,1,7,8,118712,801281,919993,8,130,138
2021-07-15 16:00:00+08,1,6,7,71339,699463,770802,0.13,117.1,117.23
2021-07-15 20:00:00+08,1,8,9,71339,928562,999901,18.23,144.8,163.03
2021-07-16 00:00:00+08,1,8,9,71339,928562,999901,22.23,176.8,199.03
2021-07-16 04:00:00+08,1,7,8,71339,781784,853123,26.23,158.17,184.4
2021-07-16 08:00:00+08,1,9,10,71339,1027674,1099013,30.23,192.88,223.11
2021-07-16 12:00:00+08,1,9,10,71339,1085759,1157098,34.23,197.43,231.66
2021-07-16 16:00:00+08,1,8,9,71339,973243,1044582,38.18,198.11,236.29
2021-07-16 20:00:00+08,1,8,9,71339,949437,1020776,42.21,190.23,232.44
2021-07-17 00:00:00+08,1,9,10,71339,1012832,1084171,46.22,225.83,272.05
2021-07-17 04:00:00+08,1,8,9,71339,894120,965459,36.14,227.92,264.06
2021-07-17 08:00:00+08,2,8,10,190051,894120,1084171,42.33,259.92,302.25
2021-07-17 12:00:00+08,2,8,10,190051,894120,1084171,50.33,291.92,342.25
2021-07-17 16:00:00+08,1,7,8,118712,830725,949437,10.19,304.32,314.51
2021-07-17 20:00:00+08,1,8,9,118712,846989,965701,64.74,249.84,314.58
2021-07-18 00:00:00+08,1,8,9,118712,846989,965701,68.74,281.84,350.58
2021-07-18 04:00:00+08,0,8,8,0,846989,846989,50.54,313.84,364.38
2021-07-18 08:00:00+08,0,8,8,0,846989,846989,50.54,345.84,396.38
2021-07-18 12:00:00+08,1,5,6,59270,535858,595128,52.08,197.22,249.3
2021-07-18 16:00:00+08,1,5,6,59270,535858,595128,56.08,217.22,273.3
2021-07-18 20:00:00+08,1,6,7,59270,644432,703702,60.08,238.83,298.91
2021-07-19 00:00:00+08,0,6,6,0,567985,567985,50.54,196.65,247.19
2021-07-19 04:00:00+08,0,6,6,0,555916,555916,13.58,190.99,204.57
2021-07-19 08:00:00+08,0,6,6,0,504266,504266,13.59,139.54,153.13
2021-07-19 12:00:00+08,0,5,5,0,364931,364931,13.59,88.42,102.01
2021-07-19 16:00:00+08,0,5,5,0,391421,391421,0,95.36,95.36
2021-07-19 20:00:00+08,1,7,8,131034,708757,839791,3.8,72.6,76.4
2021-07-20 00:00:00+08,1,9,10,50600,784585,835185,2.53,107.19,109.72
2021-07-20 04:00:00+08,1,10,11,50600,915619,966219,17.54,143.98,161.52
2021-07-20 08:00:00+08,1,11,12,50600,950619,1001219,21.54,187.06,208.6
2021-07-20 12:00:00+08,2,10,12,136115,899990,1036105,28,194.45,222.45
2021-07-20 16:00:00+08,2,10,12,136115,899990,1036105,36,234.45,270.45
2021-07-20 20:00:00+08,1,9,10,85515,904823,990338,21.47,167.73,189.2
2021-07-21 00:00:00+08,1,9,10,85515,920423,1005938,50.69,185.97,236.66
2021-07-21 04:00:00+08,1,8,9,85515,811423,896938,54.68,188.85,243.53
2021-07-21 08:00:00+08,1,9,10,85515,850498,936013,58.7,186.94,245.64
2021-07-21 12:00:00+08,1,9,10,85515,937004,1022519,62.71,187.31,250.02
2021-07-21 16:00:00+08,1,8,9,85515,828705,914220,66.69,201.59,268.28
2021-07-21 20:00:00+08,1,11,12,85515,1021791,1107306,70.68,214.65,285.33
2021-07-22 00:00:00+08,1,12,13,85515,1064771,1150286,74.67,271.18,345.85
2021-07-22 04:00:00+08,1,12,13,85515,1064771,1150286,78.67,319.18,397.85
2021-07-22 08:00:00+08,1,12,13,85515,1109584,1195099,82.68,303.18,385.86
2021-07-22 12:00:00+08,1,12,13,85515,1205632,1291147,61.46,317.33,378.79
2021-07-22 16:00:00+08,1,13,14,85515,1316816,1402331,65.5,367.97,433.47
2021-07-22 20:00:00+08,1,11,12,85515,1134066,1219581,58.46,224.36,282.82
2021-07-23 00:00:00+08,2,12,14,224397,1242372,1466769,62.94,268.98,331.92
2021-07-23 04:00:00+08,0,12,12,0,1305168,1305168,0,271.12,271.12
2021-07-23 08:00:00+08,0,11,11,0,1274621,1274621,73.15,214.12,287.27
2021-07-23 12:00:00+08,0,10,10,0,1221482,1221482,73.15,240.33,313.48
2021-07-23 16:00:00+08,0,10,10,0,1221482,1221482,73.15,280.33,353.48
2021-07-23 20:00:00+08,0,10,10,0,1084490,1084490,73.14,205.24,278.38
2021-07-24 00:00:00+08,0,9,9,0,945111,945111,6.03,192.01,198.04
2021-07-24 04:00:00+08,0,10,10,0,1029799,1029799,6.03,231.53,237.56
2021-07-24 08:00:00+08,0,10,10,0,1029799,1029799,6.03,271.53,277.56
2021-07-24 12:00:00+08,0,8,8,0,836232,836232,6.04,237.68,243.72
2021-07-24 16:00:00+08,0,7,7,0,785432,785432,6.04,246.48,252.52
2021-07-24 20:00:00+08,0,8,8,0,886416,886416,6.03,228.04,234.07
2021-07-25 00:00:00+08,0,7,7,0,778110,778110,6.03,211.42,217.45
2021-07-25 04:00:00+08,0,7,7,0,778110,778110,6.03,239.42,245.45
2021-07-25 08:00:00+08,0,7,7,0,824404,824404,6.04,237.62,243.66
2021-07-25 12:00:00+08,0,7,7,0,824404,824404,6.04,265.62,271.66
2021-07-25 16:00:00+08,0,5,5,0,600834,600834,0,195.64,195.64
2021-07-25 20:00:00+08,0,4,4,0,454186,454186,0,132.16,132.16
2021-07-26 00:00:00+08,0,5,5,0,612564,612564,0,120.69,120.69
2021-07-26 04:00:00+08,0,5,5,0,612564,612564,0,140.69,140.69
2021-07-26 08:00:00+08,0,7,7,0,788890,788890,3.52,167.01,170.53
2021-07-26 12:00:00+08,0,6,6,0,685276,685276,3.54,164.06,167.6
2021-07-26 16:00:00+08,0,6,6,0,686793,686793,3.54,106.7,110.24
2021-07-26 20:00:00+08,0,6,6,0,600316,600316,3.54,83.02,86.56
2021-07-27 00:00:00+08,0,9,9,0,1039190,1039190,3.54,108.76,112.3
2021-07-27 04:00:00+08,0,10,10,0,1073385,1073385,3.54,148.72,152.26
2021-07-27 08:00:00+08,0,9,9,0,1056194,1056194,3.54,175.01,178.55
2021-07-27 12:00:00+08,0,8,8,0,989500,989500,3.54,180.12,183.66
2021-07-27 16:00:00+08,1,6,7,85384,728261,813645,3.85,128.7,132.55
2021-07-27 20:00:00+08,1,8,9,85384,896881,982265,7.86,155.58,163.44
2021-07-28 00:00:00+08,1,10,11,85384,1005754,1091138,11.86,209.4,221.26
2021-07-28 04:00:00+08,1,10,11,85384,1005754,1091138,15.86,249.4,265.26
2021-07-28 08:00:00+08,1,9,10,85384,896122,981506,16.32,237.98,254.3
2021-07-28 12:00:00+08,1,7,8,85384,795441,880825,20.31,225.29,245.6
2021-07-28 16:00:00+08,1,6,7,85384,710901,796285,24.31,182.28,206.59
2021-07-28 20:00:00+08,1,9,10,85384,978166,1063550,28.31,211.15,239.46
2021-07-29 00:00:00+08,1,9,10,85384,959196,1044580,32.31,201.4,233.71
2021-07-29 04:00:00+08,1,9,10,85384,959196,1044580,36.31,237.4,273.71
2021-07-29 08:00:00+08,1,11,12,85384,1036750,1122134,40.31,279.52,319.83
2021-07-29 12:00:00+08,0,11,11,0,1036750,1036750,0,323.52,323.52
2021-07-29 16:00:00+08,0,11,11,0,1087939,1087939,47.34,304.51,351.85
2021-07-29 20:00:00+08,0,11,11,0,1067439,1067439,47.34,325.68,373.02
2021-07-30 00:00:00+08,0,10,10,0,1033125,1033125,47.34,339.93,387.27
2021-07-30 04:00:00+08,0,8,8,0,918572,918572,47.34,348.25,395.59
2021-07-30 08:00:00+08,0,9,9,0,980181,980181,47.34,382.04,429.38
2021-07-30 12:00:00+08,0,8,8,0,864081,864081,47.34,376.38,423.72
2021-07-30 16:00:00+08,0,8,8,0,864081,864081,47.34,408.38,455.72
2021-07-30 20:00:00+08,0,12,12,0,1086668,1086668,47.31,447.99,495.3
2021-07-31 00:00:00+08,1,11,12,105358,990858,1096216,50.72,421.24,471.96
2021-07-31 04:00:00+08,0,12,12,0,1100434,1100434,47.31,469.09,516.4
2021-07-31 08:00:00+08,0,9,9,0,871367,871367,47.31,378.78,426.09
2021-07-31 12:00:00+08,0,10,10,0,1048818,1048818,50.92,332.02,382.94
2021-07-31 16:00:00+08,0,9,9,0,996810,996810,3.6,302.47,306.07
2021-07-31 20:00:00+08,0,11,11,0,1103430,1103430,3.6,229.9,233.5
2021-08-01 00:00:00+08,0,11,11,0,1043764,1043764,3.6,244.29,247.89
2021-08-01 04:00:00+08,0,11,11,0,1002699,1002699,33.94,164.97,198.91
2021-08-01 08:00:00+08,1,10,11,103567,984424,1087991,34.45,200.92,235.37
2021-08-01 12:00:00+08,1,10,11,103567,984424,1087991,38.45,240.92,279.37
2021-08-01 16:00:00+08,1,10,11,103567,1028839,1132406,42.46,256.25,298.71
2021-08-01 20:00:00+08,2,8,10,232127,854272,1086399,47.26,220.81,268.07
2021-08-02 00:00:00+08,2,9,11,232127,922526,1154653,55.25,255.27,310.52
2021-08-02 04:00:00+08,1,7,8,103567,813208,916775,50.85,214.35,265.2
2021-08-02 08:00:00+08,2,8,10,153655,941768,1095423,65.83,244.28,310.11
2021-08-02 12:00:00+08,2,7,9,153655,826068,979723,73.79,256.28,330.07
2021-08-02 16:00:00+08,2,6,8,153655,746456,900111,81.85,211.1,292.95
2021-08-02 20:00:00+08,2,11,13,153655,1072799,1226454,89.79,246.13,335.92
2021-08-03 00:00:00+08,1,10,11,50088,925778,975866,57.27,229.55,286.82
2021-08-03 04:00:00+08,1,10,11,50088,923987,974075,75.37,220.59,295.96
2021-08-03 08:00:00+08,1,11,12,50088,1070201,1120289,79.37,261.81,341.18
2021-08-03 12:00:00+08,1,11,12,50088,1156531,1206619,83.34,290.67,374.01
2021-08-03 16:00:00+08,1,9,10,50088,990089,1040177,76.51,278.99,355.5
2021-08-03 20:00:00+08,2,9,11,109711,1005393,1115104,83.75,214.16,297.91
2021-08-04 00:00:00+08,3,10,13,223819,1090261,1314080,94.27,250.94,345.21
2021-08-04 04:00:00+08,3,10,13,172718,1090261,1262979,103.17,290.94,394.11
2021-08-04 08:00:00+08,2,13,15,122630,1356005,1478635,73.98,337.18,411.16
2021-08-04 12:00:00+08,2,13,15,122630,1346823,1469453,131.93,348.05,479.98
2021-08-04 16:00:00+08,2,13,15,122630,1346823,1469453,139.93,400.05,539.98
2021-08-04 20:00:00+08,3,10,13,236569,1042433,1279002,149.51,322.01,471.52
2021-08-05 00:00:00+08,3,11,14,236569,1191483,1428052,161.51,362.57,524.08
2021-08-05 04:00:00+08,3,11,14,236569,1233580,1470149,173.59,366.14,539.73
2021-08-05 08:00:00+08,3,11,14,236569,1261947,1498516,185.57,388.61,574.18
2021-08-05 12:00:00+08,3,10,13,236569,1148058,1384627,197.51,365.98,563.49
2021-08-05 16:00:00+08,2,9,11,173562,1044491,1218053,125.69,345.83,471.52
2021-08-05 20:00:00+08,2,11,13,173562,1276738,1450300,124.19,354.05,478.24
2021-08-06 00:00:00+08,2,12,14,173562,1333935,1507497,132.18,401.09,533.27
2021-08-06 04:00:00+08,3,11,14,211463,1219827,1431290,134.54,401.46,536
2021-08-06 08:00:00+08,3,10,13,211463,1111380,1322843,146.52,407.81,554.33
2021-08-06 12:00:00+08,4,9,13,333601,1028516,1362117,119.32,413.02,532.34
2021-08-06 16:00:00+08,3,10,13,273978,1177239,1451217,64.09,450.66,514.75
2021-08-06 20:00:00+08,4,10,14,396937,1198171,1595108,151.01,431.86,582.87
2021-08-07 00:00:00+08,5,11,16,506672,1278051,1784723,167.12,478.54,645.66
2021-08-07 04:00:00+08,5,11,16,506672,1278051,1784723,187.12,522.54,709.66
2021-08-07 08:00:00+08,5,10,15,506672,1161119,1667791,207.13,493.27,700.4
2021-08-07 12:00:00+08,5,10,15,464101,1161119,1625220,218.4,533.27,751.67
2021-08-07 16:00:00+08,5,10,15,487200,1091500,1578700,212.35,478.53,690.88
2021-08-07 20:00:00+08,4,10,14,364241,1093815,1458056,238.32,458.33,696.65
2021-08-08 00:00:00+08,4,10,14,364241,1173146,1537387,232.89,408.56,641.45
2021-08-08 04:00:00+08,4,11,15,364241,1274346,1638587,248.86,449.1,697.96
2021-08-08 08:00:00+08,4,9,13,364241,978547,1342788,264.84,334.46,599.3
2021-08-08 12:00:00+08,4,8,12,364241,915347,1279588,280.85,352.82,633.67
2021-08-08 16:00:00+08,5,9,14,505597,1031047,1536644,300.52,385.36,685.88
2021-08-08 20:00:00+08,5,8,13,505597,914196,1419793,320.51,393.3,713.81
2021-08-09 00:00:00+08,4,9,13,360360,1068716,1429076,305.42,427.96,733.38
2021-08-09 04:00:00+08,4,9,13,360360,1068716,1429076,321.42,463.96,785.38
2021-08-09 08:00:00+08,4,10,14,360360,1150499,1510859,377.59,419.33,796.92
2021-08-09 12:00:00+08,4,10,14,360360,1150499,1510859,393.59,459.33,852.92
2021-08-09 16:00:00+08,4,9,13,360360,1032732,1393092,354.52,414.52,769.04
2021-08-09 20:00:00+08,4,9,13,360360,943843,1304203,370.49,424.93,795.42
2021-08-10 00:00:00+08,4,10,14,360360,1075079,1435439,386.57,462.21,848.78
2021-08-10 04:00:00+08,4,9,13,360360,965503,1325863,402.54,258.38,660.92
2021-08-10 08:00:00+08,4,8,12,360360,842544,1202904,389.96,237.75,627.71
2021-08-10 12:00:00+08,4,8,12,360360,842544,1202904,405.96,269.75,675.71
2021-08-10 16:00:00+08,3,6,9,322459,714533,1036992,312.75,218.29,531.04
2021-08-10 20:00:00+08,3,8,11,322459,842482,1164941,395.75,110.75,506.5
2021-08-11 00:00:00+08,3,9,12,262565,941548,1204113,351.04,146.64,497.68
2021-08-11 04:00:00+08,4,10,14,394503,1082904,1477407,424.12,186.44,610.56
2021-08-11 08:00:00+08,4,9,13,394503,1045003,1439506,329.07,212.25,541.32
2021-08-11 12:00:00+08,4,11,15,394503,1164971,1559474,345.06,250.9,595.96
2021-08-11 16:00:00+08,2,10,12,181103,1075644,1256747,328.88,252.71,581.59
2021-08-11 20:00:00+08,3,13,16,284994,1282504,1567498,377.73,251.76,629.49
2021-08-12 00:00:00+08,3,14,17,284994,1295567,1580561,389.73,308.67,698.4
2021-08-12 04:00:00+08,4,14,18,370431,1295567,1665998,403.76,364.67,768.43
2021-08-12 08:00:00+08,4,15,19,370431,1415522,1785953,419.72,387.75,807.47
2021-08-12 12:00:00+08,4,12,16,370431,1213777,1584208,435.73,319.43,755.16
2021-08-12 16:00:00+08,2,9,11,152601,1002103,1154704,239.52,246.37,485.89
2021-08-12 20:00:00+08,2,11,13,94138,1098942,1193080,423.66,261.69,685.35
2021-08-13 00:00:00+08,2,10,12,94138,996756,1090894,431.63,197.51,629.14
2021-08-13 04:00:00+08,2,12,14,94138,1186084,1280222,492.93,244.82,737.75
2021-08-13 08:00:00+08,2,12,14,94138,1132334,1226472,441.05,239.65,680.7
2021-08-13 12:00:00+08,2,12,14,94138,1132334,1226472,449.05,287.65,736.7
2021-08-13 16:00:00+08,4,11,15,320367,1110374,1430741,461.76,262.25,724.01
2021-08-13 20:00:00+08,4,9,13,320367,961007,1281374,439.45,183.06,622.51
2021-08-14 00:00:00+08,5,9,14,399817,961007,1360824,450.24,219.06,669.3
2021-08-14 04:00:00+08,7,10,17,601034,1048625,1649659,486.48,257.76,744.24
2021-08-14 08:00:00+08,8,10,18,766572,1048625,1815197,517.7,297.76,815.46
2021-08-14 12:00:00+08,9,11,20,882672,1194185,2076857,552.18,341.23,893.41
2021-08-14 16:00:00+08,7,9,16,757313,975164,1732477,511.24,270.27,781.51
2021-08-14 20:00:00+08,8,11,19,847947,1083370,1931317,606.4,228.73,835.13
2021-08-15 00:00:00+08,8,9,17,847947,847444,1695391,607.68,174.97,782.65
2021-08-15 04:00:00+08,8,10,18,847947,996436,1844383,639.68,213.38,853.06
2021-08-15 08:00:00+08,7,11,18,744279,1077686,1821965,636.59,256,892.59
2021-08-15 12:00:00+08,7,11,18,731847,1064182,1796029,674.56,262.52,937.08
2021-08-15 16:00:00+08,7,11,18,731847,1092664,1824511,721.14,269.42,990.56
2021-08-15 20:00:00+08,8,9,17,837009,909508,1746517,749.47,244.54,994.01
2021-08-16 00:00:00+08,8,8,16,837009,795569,1632578,589.35,202.95,792.3
2021-08-16 04:00:00+08,8,7,15,794854,762958,1557812,551.36,168.39,719.75
2021-08-16 08:00:00+08,8,8,16,794854,868120,1662974,593.32,198.74,792.06
2021-08-16 12:00:00+08,8,7,15,794854,804720,1599574,605.05,190.29,795.34
2021-08-16 16:00:00+08,7,7,14,656243,804720,1460963,561.38,218.29,779.67
2021-08-16 20:00:00+08,7,7,14,656243,709604,1365847,666.82,142.02,808.84
2021-08-17 00:00:00+08,7,7,14,656243,676312,1332555,694.82,124.78,819.6
2021-08-17 04:00:00+08,4,6,10,296403,572644,869047,515.3,109.85,625.15
2021-08-17 08:00:00+08,4,10,14,296403,1049659,1346062,708.19,142.35,850.54
2021-08-17 12:00:00+08,4,10,14,296403,1049659,1346062,724.19,182.35,906.54
2021-08-17 16:00:00+08,4,8,12,296403,916368,1212771,711.25,151.04,862.29
2021-08-17 20:00:00+08,3,10,13,180703,1119036,1299739,625.98,151.76,777.74
2021-08-18 00:00:00+08,3,10,13,180703,1090025,1270728,732.84,122.94,855.78
2021-08-18 04:00:00+08,3,10,13,180703,1090025,1270728,744.84,162.94,907.78
2021-08-18 08:00:00+08,3,11,14,180703,1162069,1342772,756.83,206.1,962.93
2021-08-18 12:00:00+08,3,11,14,180703,1162069,1342772,768.83,250.1,1018.93
2021-08-18 16:00:00+08,3,11,14,180703,1162069,1342772,780.83,294.1,1074.93
2021-08-18 20:00:00+08,3,11,14,180703,1111678,1292381,792.83,314.28,1107.11
2021-08-19 00:00:00+08,3,13,16,180703,1241671,1422374,804.85,361.8,1166.65
2021-08-19 04:00:00+08,3,13,16,180703,1241671,1422374,816.85,413.8,1230.65
2021-08-19 08:00:00+08,3,13,16,233839,1241671,1475510,718.41,465.8,1184.21
2021-08-19 12:00:00+08,3,12,15,233839,1097901,1331740,741.77,410.9,1152.67
2021-08-19 16:00:00+08,2,7,9,170832,652619,823451,588.6,235.95,824.55
2021-08-19 20:00:00+08,2,7,9,170832,757559,928391,592,176.3,768.3
2021-08-20 00:00:00+08,2,7,9,170832,794773,965605,600,153.81,753.81
2021-08-20 04:00:00+08,2,8,10,170832,856382,1027214,608.01,185.72,793.73
2021-08-20 08:00:00+08,2,8,10,170832,856382,1027214,615.98,217.75,833.73
2021-08-20 12:00:00+08,4,8,12,402860,856382,1259242,628.98,249.75,878.73
2021-08-20 16:00:00+08,3,8,11,299192,921550,1220742,495.11,254.33,749.44
2021-08-20 20:00:00+08,3,10,13,299192,1111534,1410726,543.81,271.49,815.3
2021-08-21 00:00:00+08,2,9,11,213755,945996,1159751,470.12,220.75,690.87
2021-08-21 04:00:00+08,2,9,11,213755,945996,1159751,478.12,256.75,734.87
2021-08-21 08:00:00+08,2,10,12,213755,1112569,1326324,416.64,257.04,673.68
2021-08-21 12:00:00+08,3,8,11,264530,889674,1154204,428.18,166,594.18
2021-08-21 16:00:00+08,4,7,11,317043,826524,1143567,443.98,175.06,619.04
2021-08-21 20:00:00+08,4,9,13,317043,1034577,1351620,459.97,183.57,643.54
2021-08-22 00:00:00+08,4,10,14,317043,1093929,1410972,475.98,219.99,695.97
2021-08-22 04:00:00+08,4,10,14,317043,1093929,1410972,491.98,259.99,751.97
2021-08-22 08:00:00+08,4,11,15,317043,993015,1310058,508,244.97,752.97
2021-08-22 12:00:00+08,4,10,14,317043,877315,1194358,524.02,243.51,767.53
2021-08-22 16:00:00+08,4,9,13,317043,907994,1225037,540,259.16,799.16
2021-08-22 20:00:00+08,3,8,11,264530,853317,1117847,487.54,220.11,707.65
2021-08-23 00:00:00+08,3,8,11,264530,853317,1117847,499.54,252.11,751.65
2021-08-23 04:00:00+08,4,6,10,282852,636676,919528,494.08,206.17,700.25
2021-08-23 08:00:00+08,4,6,10,282852,580353,863205,549.94,196.54,746.48
2021-08-23 12:00:00+08,4,5,9,282852,553328,836180,565.94,190.48,756.42
2021-08-23 16:00:00+08,3,5,8,264530,548867,813397,566.6,186.7,753.3
2021-08-23 20:00:00+08,4,6,10,367291,567189,934480,599.75,208.23,807.98
2021-08-24 00:00:00+08,4,6,10,367291,500025,867316,615.74,131.07,746.81
2021-08-24 04:00:00+08,4,7,11,314890,602786,917676,631.3,156.75,788.05
2021-08-24 08:00:00+08,4,9,13,314890,791905,1106795,647.27,188.21,835.48
2021-08-24 12:00:00+08,4,8,12,314890,739392,1054282,623.45,192.26,815.71
2021-08-24 16:00:00+08,4,7,11,314890,721070,1035960,621.64,202.73,824.37
2021-08-24 20:00:00+08,4,10,14,314890,1065611,1380501,637.62,206.84,844.46
2021-08-25 00:00:00+08,5,11,16,400722,1106815,1507537,654.68,198.51,853.19
2021-08-25 04:00:00+08,4,10,14,254131,962672,1216803,558.87,149.02,707.89
2021-08-25 08:00:00+08,4,10,14,254131,962672,1216803,574.87,189.02,763.89
2021-08-25 12:00:00+08,4,11,15,254131,1064544,1318675,713.5,195.03,908.53
2021-08-25 16:00:00+08,1,10,11,50775,979761,1030536,235.89,219.28,455.17
2021-08-25 20:00:00+08,1,11,12,50775,1053095,1103870,290.27,183.38,473.65
2021-08-26 00:00:00+08,1,12,13,50775,1120259,1171034,739.52,229.47,968.99
2021-08-26 04:00:00+08,1,12,13,50775,1049681,1100456,743.52,235.12,978.64
2021-08-26 08:00:00+08,1,12,13,50775,1049681,1100456,747.52,283.12,1030.64
2021-08-26 12:00:00+08,1,11,12,50775,1014977,1065752,751.52,305.48,1057
2021-08-26 16:00:00+08,1,8,9,50775,741495,792270,755.52,216.09,971.61
2021-08-26 20:00:00+08,1,9,10,50775,850333,901108,699.42,204.02,903.44
2021-08-27 00:00:00+08,2,11,13,110975,1020472,1131447,706.32,244.94,951.26
2021-08-27 04:00:00+08,2,12,14,110975,1132696,1243671,714.32,292.86,1007.18
2021-08-27 08:00:00+08,2,12,14,139494,1173790,1313284,579.77,328.95,908.72
2021-08-27 12:00:00+08,3,11,14,173757,996709,1170466,735.08,271.84,1006.92
2021-08-27 16:00:00+08,2,9,11,139494,902734,1042228,295.84,250.64,546.48
2021-08-27 20:00:00+08,2,11,13,139494,944546,1084040,312.78,220.15,532.93
2021-08-28 00:00:00+08,2,10,12,139494,893014,1032508,320.79,217.01,537.8
2021-08-28 04:00:00+08,2,11,13,139494,989994,1129488,328.79,258.44,587.23
2021-08-28 08:00:00+08,1,12,13,79294,1075814,1155108,301.91,306.31,608.22
2021-08-28 12:00:00+08,1,12,13,79294,1063032,1142326,343.13,313.48,656.61
2021-08-28 16:00:00+08,1,12,13,79294,1063032,1142326,347.13,361.48,708.61
2021-08-28 20:00:00+08,1,10,11,79294,925832,1005126,219.57,240.7,460.27
2021-08-29 00:00:00+08,1,9,10,79294,945664,1024958,41.02,204.63,245.65
2021-08-29 04:00:00+08,1,6,7,79294,602383,681677,45.02,108.32,153.34
2021-08-29 08:00:00+08,1,9,10,79294,924604,1003898,49.02,141.29,190.31
2021-08-29 12:00:00+08,1,8,9,79294,857805,937099,53.02,160.24,213.26
2021-08-29 16:00:00+08,1,8,9,79294,857805,937099,57.02,192.24,249.26
2021-08-29 20:00:00+08,1,8,9,79294,898502,977796,61.02,203.22,264.24
2021-08-30 00:00:00+08,2,9,11,183651,1000320,1183971,67.34,237.49,304.83
2021-08-30 04:00:00+08,2,9,11,183651,1000320,1183971,75.34,273.49,348.83
2021-08-30 08:00:00+08,2,9,11,183651,987376,1171027,83.33,275.83,359.16
2021-08-30 12:00:00+08,2,9,11,183651,987376,1171027,91.33,311.83,403.16
2021-08-30 16:00:00+08,4,9,13,337063,987376,1324439,100.68,347.83,448.51
2021-08-30 20:00:00+08,3,9,12,269483,987376,1256859,112.33,383.83,496.16
2021-08-31 00:00:00+08,2,8,10,183651,764352,948003,130.23,240.11,370.34
2021-08-31 04:00:00+08,2,8,10,183651,783365,967016,138.24,199.93,338.17
2021-08-31 08:00:00+08,2,9,11,183651,974869,1158520,146.23,187.32,333.55
2021-08-31 12:00:00+08,2,9,11,183651,974869,1158520,154.23,223.32,377.55
2021-08-31 16:00:00+08,2,8,10,183651,889037,1072688,155.35,241.2,396.55
2021-08-31 20:00:00+08,2,7,9,183651,813252,996903,155.35,185.64,340.99
2021-09-01 00:00:00+08,2,9,11,183651,980761,1164412,163.33,216.76,380.09
2021-09-01 04:00:00+08,2,11,13,227318,1202157,1429475,55.74,253.99,309.73
2021-09-01 08:00:00+08,2,11,13,227318,1208042,1435360,63.74,249.69,313.43
2021-09-01 12:00:00+08,2,11,13,227318,1125051,1352369,195.1,216.04,411.14
2021-09-01 16:00:00+08,2,9,11,227318,905367,1132685,203.1,152.02,355.12
2021-09-01 20:00:00+08,2,11,13,227318,1100715,1328033,211.09,172.24,383.33
2021-09-02 00:00:00+08,2,13,15,227318,1167644,1394962,219.09,218.85,437.94
2021-09-02 04:00:00+08,1,13,14,122961,1167644,1290605,148.76,270.85,419.61
2021-09-02 08:00:00+08,1,12,13,122961,1084592,1207553,232.89,260.41,493.3
2021-09-02 12:00:00+08,1,11,12,122961,1050430,1173391,236.89,283.02,519.91
2021-09-02 16:00:00+08,1,11,12,122961,1050430,1173391,240.89,327.02,567.91
2021-09-02 20:00:00+08,2,12,14,173067,1080661,1253728,248.25,372.99,621.24
2021-09-03 00:00:00+08,2,13,15,173067,1113716,1286783,256.25,421.36,677.61
2021-09-03 04:00:00+08,2,14,16,173067,1212565,1385632,264.26,475.64,739.9
2021-09-03 08:00:00+08,2,13,15,173067,1075813,1248880,272.23,430.41,702.64
2021-09-03 12:00:00+08,2,12,14,173067,1045582,1218649,280.23,464.44,744.67
2021-09-03 16:00:00+08,2,11,13,173067,966117,1139184,288.22,466.73,754.95
2021-09-03 20:00:00+08,2,10,12,173067,854034,1027101,296.21,405.02,701.23
2021-09-04 00:00:00+08,2,11,13,173067,1000730,1173797,304.21,447.7,751.91
2021-09-04 04:00:00+08,1,9,10,50106,790173,840279,115.47,368.04,483.51
2021-09-04 08:00:00+08,1,8,9,50106,843598,893704,194.35,322.88,517.23
2021-09-04 12:00:00+08,1,7,8,50106,780604,830710,198.36,337.18,535.54
2021-09-04 16:00:00+08,1,6,7,50106,730072,780178,202.35,300.04,502.39
2021-09-04 20:00:00+08,1,9,10,50106,1014221,1064327,206.35,331.42,537.77
2021-09-05 00:00:00+08,1,9,10,50106,1014221,1064327,210.35,367.42,577.77
2021-09-05 04:00:00+08,1,9,10,50106,995650,1045756,134.23,337.09,471.32
2021-09-05 08:00:00+08,2,11,13,131353,1164005,1295358,140.12,379.37,519.49
2021-09-05 12:00:00+08,2,10,12,131353,1046942,1178295,148.14,313.12,461.26
2021-09-05 16:00:00+08,2,9,11,131353,906796,1038149,156.14,244.95,401.09
2021-09-05 20:00:00+08,3,8,11,165548,815634,981182,164.13,192.09,356.22
2021-09-06 00:00:00+08,4,7,11,270984,739503,1010487,179.88,171.09,350.97
2021-09-06 04:00:00+08,5,7,12,417491,739503,1156994,195.91,199.09,395
2021-09-06 08:00:00+08,6,5,11,468120,588580,1056700,217.9,161.79,379.69
2021-09-06 12:00:00+08,6,4,10,468120,441884,910004,241.9,119.12,361.02
2021-09-06 16:00:00+08,6,3,9,468120,325891,794011,265.93,111.36,377.29
2021-09-06 20:00:00+08,7,2,9,520633,202930,723563,217.13,60.86,277.99
2021-09-07 00:00:00+08,9,2,11,741992,202930,944922,252.11,68.86,320.97
2021-09-07 04:00:00+08,9,2,11,763632,202930,966562,258.26,76.86,335.12
2021-09-07 08:00:00+08,10,3,13,866391,308366,1174757,330.41,87.39,417.8
2021-09-07 12:00:00+08,9,3,12,791938,308366,1100304,355.4,99.39,454.79
2021-09-07 16:00:00+08,8,3,11,636791,308366,945157,361.26,111.39,472.65
2021-09-07 20:00:00+08,9,7,16,721562,650386,1371948,433.47,132.21,565.68
2021-09-08 00:00:00+08,7,8,15,584278,797292,1381570,454.41,166.89,621.3
2021-09-08 04:00:00+08,7,10,17,584278,934576,1518854,520.78,204.88,725.66
2021-09-08 08:00:00+08,9,10,19,833866,934576,1768442,552.41,244.88,797.29
2021-09-08 12:00:00+08,9,11,20,833866,968890,1802756,588.41,286.48,874.89
2021-09-08 16:00:00+08,8,11,19,812905,968890,1781795,523.24,330.48,853.72
2021-09-08 20:00:00+08,8,9,17,812905,735092,1547997,634.44,123.82,758.26
2021-09-09 00:00:00+08,9,10,19,843110,816263,1659373,693.95,161.85,855.8
2021-09-09 04:00:00+08,9,10,19,843110,816263,1659373,729.95,201.85,931.8
2021-09-09 08:00:00+08,10,11,21,985138,846452,1831590,768.36,244.03,1012.39
2021-09-09 12:00:00+08,9,8,17,838631,649064,1487695,673.78,149.53,823.31
2021-09-09 16:00:00+08,9,6,15,867819,469475,1337294,497.21,96.67,593.88
2021-09-09 20:00:00+08,5,8,13,385435,495622,881057,529.37,98.23,627.6
2021-09-10 00:00:00+08,6,11,17,452599,952296,1404895,772.63,117.9,890.53
2021-09-10 04:00:00+08,5,11,16,385435,989242,1374677,809.92,131.4,941.32
2021-09-10 08:00:00+08,6,12,18,436035,1056041,1492076,830.81,178.03,1008.84
2021-09-10 12:00:00+08,4,11,15,210728,994432,1205160,674.64,208.16,882.8
2021-09-10 16:00:00+08,4,8,12,210728,828960,1039688,448.85,144.56,593.41
2021-09-10 20:00:00+08,4,11,15,210728,1231781,1442509,657.68,161.56,819.24
2021-09-11 00:00:00+08,5,11,16,277892,1231781,1509673,699.92,205.56,905.48
2021-09-11 04:00:00+08,6,11,17,423280,1231781,1655061,721.76,249.56,971.32
2021-09-11 08:00:00+08,6,11,17,423280,1231781,1655061,745.76,293.56,1039.32
2021-09-11 12:00:00+08,6,9,15,423280,999709,1422989,737.84,251.13,988.97
2021-09-11 16:00:00+08,6,9,15,423280,999709,1422989,761.84,287.13,1048.97
2021-09-11 20:00:00+08,6,9,15,423280,968212,1391492,785.85,261.97,1047.82
2021-09-12 00:00:00+08,7,9,16,533248,968212,1501460,813.21,297.97,1111.18
2021-09-12 04:00:00+08,7,8,15,582923,886965,1469888,607.29,300,907.29
2021-09-12 08:00:00+08,7,10,17,582923,935445,1518368,740.19,338.36,1078.55
2021-09-12 12:00:00+08,7,8,15,582923,807170,1390093,768.21,327.09,1095.3
2021-09-12 16:00:00+08,6,7,13,532323,806939,1339262,699.41,274.77,974.18
2021-09-12 20:00:00+08,6,8,14,532323,823487,1355810,724.53,237.84,962.37
2021-09-13 00:00:00+08,6,10,16,532323,995481,1527804,748.54,244.19,992.73
2021-09-13 04:00:00+08,7,10,17,606828,995481,1602309,773.61,284.19,1057.8
2021-09-13 08:00:00+08,7,9,16,606828,848974,1455802,711.29,242.5,953.79
2021-09-13 12:00:00+08,6,8,14,461440,775708,1237148,556.95,167.43,724.38
2021-09-13 16:00:00+08,7,10,17,484919,1067687,1552606,643.07,201.75,844.82
2021-09-13 20:00:00+08,7,11,18,456322,1183319,1639641,672.08,197.91,869.99
2021-09-14 00:00:00+08,10,11,21,584748,1183319,1768067,711.11,241.91,953.02
2021-09-14 04:00:00+08,9,11,20,482446,1148127,1630573,745.76,255.81,1001.57
2021-09-14 08:00:00+08,10,11,21,586013,1204892,1790905,734.38,232.81,967.19
2021-09-14 12:00:00+08,10,11,21,586013,1204892,1790905,774.38,276.81,1051.19
2021-09-14 16:00:00+08,8,9,17,522323,903756,1426079,531.59,176.74,708.33
2021-09-14 20:00:00+08,7,11,18,447818,1014519,1462337,747.9,178.24,926.14
2021-09-15 00:00:00+08,7,13,20,447818,1173021,1620839,775.83,227.08,1002.91
2021-09-15 04:00:00+08,7,14,21,447818,1247526,1695344,849.05,282.99,1132.04
2021-09-15 08:00:00+08,6,12,18,380654,1086261,1466915,623.7,251.83,875.53
2021-09-15 12:00:00+08,6,13,19,380654,1195950,1576604,780.11,286.26,1066.37
2021-09-15 16:00:00+08,6,11,17,380654,988147,1368801,804.09,248.54,1052.63
2021-09-15 20:00:00+08,6,13,19,380654,1212203,1592857,828.08,297.07,1125.15
2021-09-16 00:00:00+08,7,13,20,546076,1212203,1758279,852.52,349.07,1201.59
2021-09-16 04:00:00+08,8,13,21,659148,1278450,1937598,883.25,369.3,1252.55
2021-09-16 08:00:00+08,7,9,16,546076,970012,1516088,650.23,264.11,914.34
2021-09-16 12:00:00+08,5,10,15,423045,1091360,1514405,509.85,276.19,786.04
2021-09-16 16:00:00+08,3,10,13,348869,992190,1341059,456.09,276.65,732.74
2021-09-16 20:00:00+08,3,13,16,348869,1091128,1439997,552.87,248.08,800.95
2021-09-17 00:00:00+08,3,13,16,348869,1030848,1379717,432.55,262.86,695.41
2021-09-17 04:00:00+08,3,13,16,348869,1029940,1378809,444.57,231.86,676.43
2021-09-17 08:00:00+08,3,14,17,348869,1139908,1488777,587.04,284.78,871.82
2021-09-17 12:00:00+08,3,13,16,348869,1096928,1445797,599.04,313.11,912.15
2021-09-17 16:00:00+08,3,13,16,308302,1096928,1405230,528.46,365.11,893.57
2021-09-17 20:00:00+08,2,10,12,245302,806005,1051307,620.21,261.42,881.63
2021-09-18 00:00:00+08,4,11,15,411986,1045384,1457370,423.93,214.17,638.1
2021-09-18 04:00:00+08,3,10,13,246564,951352,1197916,387.47,153.02,540.49
2021-09-18 08:00:00+08,3,10,13,246564,1003702,1250266,445.52,148.66,594.18
2021-09-18 12:00:00+08,3,8,11,246564,931829,1178393,457.52,138.96,596.48
2021-09-18 16:00:00+08,2,7,9,166684,868829,1035513,305.4,152.81,458.21
2021-09-18 20:00:00+08,2,9,11,166684,1015187,1181871,471.72,186,657.72
2021-09-19 00:00:00+08,2,9,11,166684,1015187,1181871,479.72,222,701.72
2021-09-19 04:00:00+08,2,9,11,166684,1015187,1181871,487.72,258,745.72
2021-09-19 08:00:00+08,2,8,10,166684,981740,1148424,495.72,259.03,754.75
2021-09-19 12:00:00+08,3,8,11,270332,981740,1252072,506.05,291.03,797.08
2021-09-19 16:00:00+08,2,8,10,189085,994166,1183251,392.74,279.17,671.91
2021-09-19 20:00:00+08,2,12,14,189085,1208664,1397749,442.56,320.9,763.46
2021-09-20 00:00:00+08,3,10,13,262280,977004,1239284,453.51,290.81,744.32
2021-09-20 04:00:00+08,3,10,13,262280,977004,1239284,465.51,330.81,796.32
2021-09-20 08:00:00+08,5,10,15,443161,977004,1420165,478.25,370.81,849.06
2021-09-20 12:00:00+08,5,9,14,443161,937921,1381082,498.25,392.32,890.57
2021-09-20 16:00:00+08,6,8,14,555520,858041,1413561,363.45,381.14,744.59
2021-09-20 20:00:00+08,6,10,16,555520,1036738,1592258,256.98,306.88,563.86
2021-09-21 00:00:00+08,6,11,17,555520,1087332,1642852,281.02,258.6,539.62
2021-09-21 04:00:00+08,6,11,17,555520,1087332,1642852,305.02,302.6,607.62
2021-09-21 08:00:00+08,6,11,17,555520,1087332,1642852,329.02,346.6,675.62
2021-09-21 12:00:00+08,5,9,14,443161,982217,1425378,329.51,357.09,686.6
2021-09-21 16:00:00+08,6,8,14,564095,911065,1475160,377.53,299,676.53
2021-09-21 20:00:00+08,6,8,14,564095,833952,1398047,304.98,198.93,503.91
2021-09-22 00:00:00+08,5,10,15,490900,1053939,1544839,328.94,234.44,563.38
2021-09-22 04:00:00+08,5,9,14,490900,1001793,1492693,348.94,243.66,592.6
2021-09-22 08:00:00+08,5,10,15,490900,1106800,1597700,368.95,283.64,652.59
2021-09-22 12:00:00+08,6,10,16,541507,1031962,1573469,391.55,283.97,675.52
2021-09-22 16:00:00+08,7,8,15,635052,862406,1497458,416.3,279.35,695.65
2021-09-22 20:00:00+08,7,10,17,635052,979289,1614341,444.24,203.16,647.4
2021-09-23 00:00:00+08,7,10,17,635052,979289,1614341,472.24,243.16,715.4
2021-09-23 04:00:00+08,5,10,15,420573,1017424,1437997,448.59,228.64,677.23
2021-09-23 08:00:00+08,6,12,18,525931,1231903,1757834,524.78,272.99,797.77
2021-09-23 12:00:00+08,6,10,16,525931,1124546,1650477,497.86,259.27,757.13
2021-09-23 16:00:00+08,5,9,14,475324,1065179,1540503,491.26,276.36,767.62
2021-09-23 20:00:00+08,5,9,14,475324,961937,1437261,519.13,235.24,754.37
2021-09-24 00:00:00+08,5,9,14,475324,961937,1437261,539.13,271.24,810.37
2021-09-24 04:00:00+08,5,10,15,475324,999507,1474831,559.13,307.53,866.66
2021-09-24 08:00:00+08,5,10,15,475324,999507,1474831,579.13,347.53,926.66
2021-09-24 12:00:00+08,5,8,13,475324,744268,1219592,599.16,283.54,882.7
2021-09-24 16:00:00+08,5,7,12,475324,691129,1166453,619.17,293.81,912.98
2021-09-24 20:00:00+08,6,5,11,606682,366051,972733,641.38,121.1,762.48
2021-09-25 00:00:00+08,4,6,10,364127,512823,876950,418.74,141.15,559.89
2021-09-25 04:00:00+08,5,8,13,473148,758785,1231933,552.43,169.94,722.37
2021-09-25 08:00:00+08,5,8,13,473148,805887,1279035,665.19,118.8,783.99
2021-09-25 12:00:00+08,5,7,12,473148,831998,1305146,685.2,102.54,787.74
2021-09-25 16:00:00+08,4,6,10,364127,711064,1075191,649.6,71.76,721.36
2021-09-25 20:00:00+08,5,7,12,511033,820085,1331118,686.13,97.58,783.71
2021-09-26 00:00:00+08,5,8,13,511033,861668,1372701,706.13,126.73,832.86
2021-09-26 04:00:00+08,6,8,14,548307,861668,1409975,729,158.73,887.73
2021-09-26 08:00:00+08,7,7,14,689857,774062,1463919,754.34,164.16,918.5
2021-09-26 12:00:00+08,8,6,14,828739,732479,1561218,784.96,179.01,963.97
2021-09-26 16:00:00+08,8,6,14,828739,732479,1561218,816.96,203.01,1019.97
2021-09-26 20:00:00+08,9,9,18,908619,978144,1886763,852.32,233.13,1085.45
2021-09-27 00:00:00+08,9,9,18,908619,978144,1886763,888.32,269.13,1157.45
2021-09-27 04:00:00+08,9,8,17,908619,863413,1772032,783.49,220.69,1004.18
2021-09-27 08:00:00+08,10,8,18,1027433,863413,1890846,820.14,252.69,1072.83
2021-09-27 12:00:00+08,11,7,18,1077521,756358,1833879,861.75,225.91,1087.66
2021-09-27 16:00:00+08,9,5,14,904189,620526,1524715,641.44,185.14,826.58
2021-09-27 20:00:00+08,9,9,18,904189,969434,1873623,928.84,213.69,1142.53
2021-09-28 00:00:00+08,9,9,18,904189,969434,1873623,964.84,249.69,1214.53
2021-09-28 04:00:00+08,9,9,18,904189,969434,1873623,1000.84,285.69,1286.53
2021-09-28 08:00:00+08,9,9,18,904189,852798,1756987,1036.84,243.63,1280.47
2021-09-28 12:00:00+08,9,5,14,904189,538291,1442480,779.73,79.95,859.68
2021-09-28 16:00:00+08,6,4,10,668863,422298,1091161,609.94,60,669.94
2021-09-28 20:00:00+08,6,10,16,668863,954350,1623213,849,85.28,934.28
2021-09-29 00:00:00+08,7,10,17,749865,954350,1704215,880.52,125.28,1005.8
2021-09-29 04:00:00+08,7,10,17,749865,954350,1704215,908.52,165.28,1073.8
2021-09-29 08:00:00+08,7,10,17,749865,954350,1704215,936.52,205.28,1141.8
2021-09-29 12:00:00+08,7,9,16,749865,924214,1674079,964.51,215.29,1179.8
2021-09-29 16:00:00+08,7,9,16,749865,864048,1613913,992.51,229.23,1221.74
2021-09-29 20:00:00+08,6,8,14,664428,738349,1402777,733.65,189.99,923.64
2021-09-30 00:00:00+08,6,9,15,664428,859213,1523641,1015.28,194.12,1209.4
2021-09-30 04:00:00+08,5,9,14,545614,859213,1404827,970.62,230.12,1200.74
2021-09-30 08:00:00+08,5,8,13,545614,812341,1357955,1011.55,192.24,1203.79
2021-09-30 12:00:00+08,5,7,12,545614,680983,1226597,958.98,158.59,1117.57
2021-09-30 16:00:00+08,3,5,8,323062,541311,864373,693.58,117.55,811.13
2021-09-30 20:00:00+08,4,7,11,512009,688452,1200461,753.01,85.95,838.96
2021-10-01 00:00:00+08,5,9,14,549034,732610,1281644,889.97,115.57,1005.54
2021-10-01 04:00:00+08,5,9,14,549034,732610,1281644,909.97,151.57,1061.54
2021-10-01 08:00:00+08,5,11,16,549034,851357,1400391,929.96,191.45,1121.41
2021-10-01 12:00:00+08,5,11,16,549034,851357,1400391,949.96,235.45,1185.41
2021-10-01 16:00:00+08,4,9,13,410152,728646,1138798,435.2,221.85,657.05
2021-10-01 20:00:00+08,4,11,15,410152,920846,1330998,580.45,234.78,815.23
2021-10-02 00:00:00+08,4,11,15,410152,920846,1330998,596.45,278.78,875.23
2021-10-02 04:00:00+08,4,11,15,410152,1018482,1428634,612.44,303.28,915.72
2021-10-02 08:00:00+08,4,9,13,410152,851670,1261822,578.15,284.37,862.52
2021-10-02 12:00:00+08,3,6,9,373127,663182,1036309,484.17,148.63,632.8
2021-10-02 16:00:00+08,3,6,9,373127,637213,1010340,536.57,153.82,690.39
2021-10-02 20:00:00+08,3,7,10,373127,753206,1126333,548.57,179.84,728.41
2021-10-03 00:00:00+08,3,7,10,373127,753206,1126333,560.57,207.84,768.41
2021-10-03 04:00:00+08,3,8,11,285619,850186,1135805,517.77,238.13,755.9
2021-10-03 08:00:00+08,3,8,11,285619,879661,1165280,420.95,131.78,552.73
2021-10-03 12:00:00+08,3,9,12,285619,1026439,1312058,496.51,166.53,663.04
2021-10-03 16:00:00+08,3,9,12,285619,1026439,1312058,508.51,202.53,711.04
2021-10-03 20:00:00+08,3,11,14,285619,1215810,1501429,520.49,240.86,761.35
2021-10-04 00:00:00+08,3,11,14,285619,1215810,1501429,532.49,284.86,817.35
2021-10-04 04:00:00+08,4,11,15,343819,1215810,1559629,547.62,328.86,876.48
2021-10-04 08:00:00+08,4,9,13,343819,960935,1304754,434.4,273.43,707.83
2021-10-04 12:00:00+08,4,8,12,343819,830362,1174181,450.4,250.76,701.16
2021-10-04 16:00:00+08,4,8,12,343819,830362,1174181,466.4,282.76,749.16
2021-10-04 20:00:00+08,4,8,12,343819,834765,1178584,442,206.22,648.22
2021-10-05 00:00:00+08,4,7,11,343819,785762,1129581,458.03,172.13,630.16
2021-10-05 04:00:00+08,3,9,12,248504,967131,1215635,145.39,207.44,352.83
2021-10-05 08:00:00+08,3,12,15,248504,1260238,1508742,264.91,247.79,512.7
2021-10-05 12:00:00+08,4,12,16,358472,1260366,1618838,449.71,246.2,695.91
2021-10-05 16:00:00+08,3,12,15,227438,1260366,1487804,450.49,294.2,744.69
2021-10-05 20:00:00+08,3,13,16,227438,1313611,1541049,480.94,296.56,777.5
2021-10-06 00:00:00+08,3,12,15,227438,1300550,1527988,492.94,318.93,811.87
2021-10-06 04:00:00+08,3,12,15,227438,1221845,1449283,504.94,294.92,799.86
2021-10-06 08:00:00+08,3,12,15,227438,1265404,1492842,516.94,276.75,793.69
2021-10-06 12:00:00+08,3,12,15,227438,1340735,1568173,528.94,300.24,829.18
2021-10-06 16:00:00+08,3,11,14,227438,1192769,1420207,540.97,266.37,807.34
2021-10-06 20:00:00+08,3,13,16,227438,1410068,1637506,552.97,315.17,868.14
2021-10-07 00:00:00+08,2,12,14,117470,1329066,1446536,526.37,350.61,876.98
2021-10-07 04:00:00+08,0,10,10,0,1141317,1141317,252.23,308.79,561.02
2021-10-07 08:00:00+08,1,12,13,79443,1262199,1341642,435.48,302.35,737.83
2021-10-07 12:00:00+08,1,11,12,79443,1206890,1286333,488.36,267.47,755.83
2021-10-07 16:00:00+08,1,10,11,79443,1121177,1200620,492.36,279.48,771.84
2021-10-07 20:00:00+08,1,11,12,79443,1162845,1242288,496.34,297.88,794.22
2021-10-08 00:00:00+08,2,12,14,223593,1169729,1393322,503.54,342.33,845.87
2021-10-08 04:00:00+08,2,12,14,223593,1169729,1393322,511.54,390.33,901.87
2021-10-08 08:00:00+08,2,9,11,223593,747447,971040,267.32,224.58,491.9
2021-10-08 12:00:00+08,1,7,8,79443,584290,663733,260.15,201.06,461.21
2021-10-08 16:00:00+08,1,8,9,79443,815107,894550,181.54,199.15,380.69
2021-10-08 20:00:00+08,3,10,13,257051,978124,1235175,109.76,199.15,308.91
2021-10-09 00:00:00+08,3,12,15,257051,1121486,1378537,121.78,241.18,362.96
2021-10-09 04:00:00+08,3,12,15,257051,1121486,1378537,133.78,289.18,422.96
2021-10-09 08:00:00+08,3,12,15,257051,1121486,1378537,145.78,337.18,482.96
2021-10-09 12:00:00+08,2,8,10,129975,854281,984256,89.74,230.98,320.72
2021-10-09 16:00:00+08,2,7,9,129975,790881,920856,97.73,241.91,339.64
2021-10-09 20:00:00+08,2,9,11,129975,893460,1023435,132.29,246.92,379.21
2021-10-10 00:00:00+08,2,9,11,129975,893460,1023435,140.29,282.92,423.21
2021-10-10 04:00:00+08,2,8,10,129975,875243,1005218,148.29,310.55,458.84
2021-10-10 08:00:00+08,2,8,10,129975,881321,1011296,156.3,239.14,395.44
2021-10-10 12:00:00+08,1,8,9,50532,946112,996644,85.82,256.02,341.84
2021-10-10 16:00:00+08,1,8,9,50532,946112,996644,89.82,288.02,377.84
2021-10-10 20:00:00+08,1,8,9,50532,1002352,1052884,93.82,306.96,400.78
2021-10-11 00:00:00+08,1,8,9,50532,1002352,1052884,97.82,338.96,436.78
2021-10-11 04:00:00+08,1,8,9,50532,1002352,1052884,101.82,370.96,472.78
2021-10-11 08:00:00+08,1,8,9,50532,1002352,1052884,105.82,402.96,508.78
2021-10-11 12:00:00+08,1,7,8,50532,900573,951105,109.82,374.74,484.56
2021-10-11 16:00:00+08,1,4,5,50532,533054,583586,113.82,269.26,383.08
2021-10-11 20:00:00+08,1,7,8,50532,696360,746892,117.82,289.72,407.54
2021-10-12 00:00:00+08,1,6,7,100887,550972,651859,49.19,178.62,227.81
2021-10-12 04:00:00+08,0,9,9,0,855905,855905,130.98,205.37,336.35
2021-10-12 08:00:00+08,0,8,8,0,739465,739465,130.97,203.91,334.88
2021-10-12 12:00:00+08,1,7,8,63007,612389,675396,105.12,171.34,276.46
2021-10-12 16:00:00+08,1,6,7,63007,516162,579169,90.06,83.67,173.73
2021-10-12 20:00:00+08,2,7,9,185966,717956,903922,95.2,85.47,180.67
2021-10-13 00:00:00+08,1,10,11,63007,1010450,1073457,102.76,115.88,218.64
2021-10-13 04:00:00+08,1,9,10,63007,901450,964457,106.75,122.35,229.1
2021-10-13 08:00:00+08,1,11,12,63007,1039457,1102464,110.76,162.73,273.49
2021-10-13 12:00:00+08,1,9,10,63007,903093,966100,36.32,150.99,187.31
2021-10-13 16:00:00+08,1,8,9,63007,815475,878482,40.32,164.6,204.92
2021-10-13 20:00:00+08,1,8,9,63007,798627,861634,44.31,176.47,220.78
2021-10-14 00:00:00+08,1,10,11,63007,842586,905593,48.31,210.46,258.77
2021-10-14 04:00:00+08,2,9,11,209655,741699,951354,47.69,201.8,249.49
2021-10-14 08:00:00+08,2,11,13,209655,1008394,1218049,55.67,243.37,299.04
2021-10-14 12:00:00+08,2,10,12,209655,974232,1183887,63.67,257.78,321.45
2021-10-14 16:00:00+08,2,9,11,209655,870387,1080042,71.69,262.98,334.67
2021-10-14 20:00:00+08,2,9,11,209655,770012,979667,79.71,237.1,316.81
2021-10-15 00:00:00+08,2,9,11,209655,746740,956395,87.71,249.22,336.93
2021-10-15 04:00:00+08,1,8,9,63007,732937,795944,69.39,255.93,325.32
2021-10-15 08:00:00+08,1,7,8,63007,631119,694126,73.38,231.75,305.13
2021-10-15 12:00:00+08,1,6,7,63007,601669,664676,104.92,120.11,225.03
2021-10-15 16:00:00+08,1,5,6,63007,550800,613807,108.92,98.47,207.39
2021-10-15 20:00:00+08,1,8,9,63007,824197,887204,112.92,123.61,236.53
2021-10-16 00:00:00+08,1,8,9,63007,824197,887204,116.92,155.61,272.53
2021-10-16 04:00:00+08,1,7,8,63007,696837,759844,120.92,141.02,261.94
2021-10-16 08:00:00+08,2,7,9,103888,771200,875088,127.1,139.14,266.24
2021-10-16 12:00:00+08,2,6,8,103888,708000,811888,135.1,149.54,284.64
2021-10-16 16:00:00+08,2,6,8,103888,708000,811888,143.1,173.54,316.64
2021-10-16 20:00:00+08,2,6,8,103888,644436,748324,151.11,165.66,316.77
2021-10-17 00:00:00+08,2,7,9,103888,656254,760142,159.12,190.93,350.05
2021-10-17 04:00:00+08,3,7,10,141162,590777,731939,137.19,180.48,317.67
2021-10-17 08:00:00+08,3,6,9,141162,578959,720121,149.19,199.21,348.4
2021-10-17 12:00:00+08,3,5,8,141162,473414,614576,161.19,181.55,342.74
2021-10-17 16:00:00+08,2,3,5,78155,301753,379908,48.52,133.56,182.08
2021-10-17 20:00:00+08,1,6,7,37274,628034,665308,146.28,148.77,295.05
2021-10-18 00:00:00+08,1,6,7,37274,637531,674805,191.24,109.62,300.86
2021-10-18 04:00:00+08,1,7,8,37274,747163,784437,195.24,137.51,332.75
2021-10-18 08:00:00+08,1,7,8,37274,747163,784437,199.24,165.51,364.75
2021-10-18 12:00:00+08,1,7,8,37274,747163,784437,203.24,193.51,396.75
2021-10-18 16:00:00+08,1,6,7,37274,607828,645102,207.24,114.49,321.73
2021-10-18 20:00:00+08,1,9,10,37274,793504,830778,83.3,121.55,204.85
2021-10-19 00:00:00+08,2,11,13,88049,1026158,1114207,91.18,160.05,251.23
2021-10-19 04:00:00+08,2,10,12,88049,985277,1073326,58.21,174.81,233.02
2021-10-19 08:00:00+08,2,12,14,88049,1058830,1146879,66.22,218.63,284.85
2021-10-19 12:00:00+08,2,12,14,88049,1058830,1146879,74.22,266.63,340.85
2021-10-19 16:00:00+08,1,10,11,37274,920029,957303,62.34,230.26,292.6
2021-10-19 20:00:00+08,1,9,10,37274,872499,909773,88.93,185.68,274.61
2021-10-20 00:00:00+08,2,12,14,140965,1018681,1159646,94.76,230.8,325.56
2021-10-20 04:00:00+08,2,12,14,140965,1018681,1159646,102.76,278.8,381.56
2021-10-20 08:00:00+08,2,13,15,140965,1071469,1212434,110.78,329.8,440.58
2021-10-20 12:00:00+08,3,13,16,182942,1071469,1254411,121.29,381.8,503.09
2021-10-20 16:00:00+08,3,12,15,182942,986694,1169636,133.29,410.96,544.25
2021-10-20 20:00:00+08,3,10,13,182942,797394,980336,145.3,344.21,489.51
2021-10-21 00:00:00+08,3,9,12,182942,711562,894504,157.3,356.73,514.03
2021-10-21 04:00:00+08,1,6,7,41977,515408,557385,18.51,275.96,294.47
2021-10-21 08:00:00+08,1,8,9,41977,726722,768699,154.32,279.12,433.44
2021-10-21 12:00:00+08,1,7,8,41977,789537,831514,158.3,256.47,414.77
2021-10-21 16:00:00+08,1,5,6,41977,533482,575459,162.3,103.5,265.8
2021-10-21 20:00:00+08,1,7,8,41977,695750,737727,166.29,57.79,224.08
2021-10-22 00:00:00+08,3,10,13,145033,1140088,1285121,173.51,91.79,265.3
2021-10-22 04:00:00+08,2,10,12,127797,1140088,1267885,181.26,131.79,313.05
2021-10-22 08:00:00+08,2,11,13,127797,1157324,1285121,197.08,172.22,369.3
2021-10-22 12:00:00+08,2,11,13,127797,1126934,1254731,104.24,189.76,294
2021-10-22 16:00:00+08,2,12,14,171622,1230548,1402170,60.32,237.4,297.72
2021-10-22 20:00:00+08,2,12,14,171622,1210916,1382538,124.53,262.39,386.92
2021-10-23 00:00:00+08,2,13,15,123880,1274316,1398196,123.01,311.76,434.77
2021-10-23 04:00:00+08,2,12,14,123880,1212427,1336307,137.21,310.54,447.75
2021-10-23 08:00:00+08,3,12,15,270658,1212427,1483085,149.2,358.54,507.74
2021-10-23 12:00:00+08,3,11,14,270658,1205543,1476201,161.2,379.51,540.71
2021-10-23 16:00:00+08,1,10,11,85820,1082406,1168226,144.12,365.74,509.86
2021-10-23 20:00:00+08,1,8,9,85820,840908,926728,152.27,228.96,381.23
2021-10-24 00:00:00+08,1,9,10,85820,961779,1047599,100.05,202.32,302.37
2021-10-24 04:00:00+08,1,10,11,85820,980054,1065874,104.03,241.09,345.12
2021-10-24 08:00:00+08,1,12,13,85820,1117407,1203227,108.01,230.68,338.69
2021-10-24 12:00:00+08,1,13,14,85820,1233107,1318927,112.01,279.56,391.57
2021-10-24 16:00:00+08,1,10,11,85820,1021731,1107551,116.03,218.49,334.52
2021-10-24 20:00:00+08,1,9,10,85820,893631,979451,106.08,205.16,311.24
2021-10-25 00:00:00+08,0,8,8,0,823971,823971,15.64,138.81,154.45
2021-10-25 04:00:00+08,0,8,8,0,899358,899358,15.63,139.43,155.06
2021-10-25 08:00:00+08,0,9,9,0,985178,985178,94.97,175.06,270.03
2021-10-25 12:00:00+08,0,9,9,0,985178,985178,94.97,211.06,306.03
2021-10-25 16:00:00+08,0,9,9,0,985178,985178,94.97,247.06,342.03
2021-10-25 20:00:00+08,1,10,11,113889,1074048,1187937,97.57,222.44,320.01
2021-10-26 00:00:00+08,1,12,13,113889,1163959,1277848,101.57,266.02,367.59
2021-10-26 04:00:00+08,1,13,14,113889,1329334,1443223,105.58,317.18,422.76
2021-10-26 08:00:00+08,1,13,14,113889,1340494,1454383,30.24,343.55,373.79
2021-10-26 12:00:00+08,1,11,12,113889,1253732,1367621,18.61,302.8,321.41
2021-10-26 16:00:00+08,0,12,12,0,1399292,1399292,0,348.19,348.19
2021-10-26 20:00:00+08,0,13,13,0,1513181,1513181,24.01,398.79,422.8
2021-10-27 00:00:00+08,0,13,13,0,1518018,1518018,24.01,401.3,425.31
2021-10-27 04:00:00+08,1,12,13,35000,1402318,1437318,24.99,388.39,413.38
2021-10-27 08:00:00+08,1,13,14,35000,1409194,1444194,28.94,402.98,431.92
2021-10-27 12:00:00+08,2,11,13,138891,1187656,1326547,34.08,358.63,392.71
2021-10-27 16:00:00+08,2,11,13,138891,1187656,1326547,42.08,402.63,444.71
2021-10-27 20:00:00+08,3,10,13,179369,1102968,1282337,52.34,430.99,483.33
2021-10-28 00:00:00+08,2,10,12,144369,1070693,1215062,43.43,384.35,427.78
2021-10-28 04:00:00+08,2,12,14,144369,1236979,1381348,75.41,428.38,503.79
2021-10-28 08:00:00+08,1,12,13,103891,1128407,1232298,83.03,372.31,455.34
2021-10-28 12:00:00+08,0,10,10,0,948143,948143,61.91,345.27,407.18
2021-10-28 16:00:00+08,1,8,9,99066,783837,882903,62.92,279.85,342.77
2021-10-28 20:00:00+08,1,13,14,99066,970539,1069605,98.36,298.64,397
2021-10-29 00:00:00+08,2,16,18,151579,1204822,1356401,106.24,354.38,460.62
2021-10-29 04:00:00+08,2,14,16,151579,1067364,1218943,100.4,327.93,428.33
2021-10-29 08:00:00+08,2,14,16,157675,1098294,1255969,68.66,358.3,426.96
2021-10-29 12:00:00+08,2,12,14,157675,935445,1093120,76.62,319.14,395.76
2021-10-29 16:00:00+08,2,10,12,157675,910391,1068066,105.99,271.68,377.67
2021-10-29 20:00:00+08,1,11,12,105162,997738,1102900,88.12,241.92,330.04
2021-10-30 00:00:00+08,0,10,10,0,901890,901890,43.4,228.26,271.66
2021-10-30 04:00:00+08,0,11,11,0,1007052,1007052,62.02,270.9,332.92
2021-10-30 08:00:00+08,0,11,11,0,1007052,1007052,62.02,314.9,376.92
2021-10-30 12:00:00+08,1,9,10,50689,918706,969395,64.81,285.59,350.4
2021-10-30 16:00:00+08,1,8,9,50689,844906,895595,68.79,293.98,362.77
2021-10-30 20:00:00+08,1,9,10,50689,898644,949333,72.74,307.91,380.65
2021-10-31 00:00:00+08,1,7,8,50689,680756,731445,54.8,194.93,249.73
2021-10-31 04:00:00+08,1,8,9,50689,718480,769169,58.81,182.39,241.2
2021-10-31 08:00:00+08,2,7,9,112157,638648,750805,45.32,115.89,161.21
2021-10-31 12:00:00+08,2,6,8,112157,489925,602082,53.32,100.91,154.23
2021-10-31 16:00:00+08,2,4,6,112157,408558,520715,61.32,87.41,148.73
2021-10-31 20:00:00+08,2,4,6,112157,495105,607262,69.32,78.04,147.36
2021-11-01 00:00:00+08,2,5,7,112157,557112,669269,58.71,49.77,108.48
2021-11-01 04:00:00+08,2,5,7,112157,557112,669269,66.71,69.77,136.48
2021-11-01 08:00:00+08,2,6,8,112157,673963,786120,74.71,91.51,166.22
2021-11-01 12:00:00+08,2,6,8,112157,673963,786120,82.71,115.51,198.22
2021-11-01 16:00:00+08,1,7,8,61468,826307,887775,35.93,142.16,178.09
2021-11-01 20:00:00+08,2,8,10,163185,876996,1040181,97.36,172.27,269.63
2021-11-02 00:00:00+08,2,8,10,163185,876996,1040181,105.36,204.27,309.63
2021-11-02 04:00:00+08,3,8,11,196876,876996,1073872,114.23,236.27,350.5
2021-11-02 08:00:00+08,4,9,13,305182,1020431,1325613,128.65,217.06,345.71
2021-11-02 12:00:00+08,3,8,11,203465,903368,1106833,127.89,215.74,343.63
2021-11-02 16:00:00+08,2,7,9,141997,838128,980125,99.95,173.73,273.68
2021-11-02 20:00:00+08,2,9,11,141997,962603,1104600,169.43,205.64,375.07
2021-11-03 00:00:00+08,3,10,13,247355,1067685,1315040,180.08,244.51,424.59
2021-11-03 04:00:00+08,3,9,12,329364,1016996,1346360,112.8,250.4,363.2
2021-11-03 08:00:00+08,4,9,13,375633,989219,1364852,94.06,273.49,367.55
2021-11-03 12:00:00+08,4,9,13,375633,989219,1364852,110.06,309.49,419.55
2021-11-03 16:00:00+08,3,9,12,267327,884046,1151373,91.63,278.71,370.34
2021-11-03 20:00:00+08,2,10,12,161969,805359,967328,118.6,178.34,296.94
2021-11-04 00:00:00+08,2,13,15,161969,1150472,1312441,152.53,222.16,374.69
2021-11-04 04:00:00+08,2,14,16,161969,1252378,1414347,160.54,274.8,435.34
2021-11-04 08:00:00+08,2,13,15,161969,1206280,1368249,141.2,269.28,410.48
2021-11-04 12:00:00+08,1,11,12,46269,1154307,1200576,114.95,245.18,360.13
2021-11-04 16:00:00+08,1,8,9,46269,823718,869987,98.94,124.75,223.69
2021-11-04 20:00:00+08,1,11,12,46269,1044089,1090358,141.45,163.13,304.58
2021-11-05 00:00:00+08,1,12,13,46269,1007964,1054233,145.41,181.28,326.69
2021-11-05 04:00:00+08,2,12,14,81290,1007964,1089254,150.89,229.28,380.17
2021-11-05 08:00:00+08,2,12,14,81290,981235,1062525,121.29,241.7,362.99
2021-11-05 12:00:00+08,2,12,14,81290,981235,1062525,129.29,289.7,418.99
2021-11-05 16:00:00+08,0,12,12,0,981235,981235,64.45,337.7,402.15
2021-11-05 20:00:00+08,0,10,10,0,754887,754887,15.1,211,226.1
2021-11-06 00:00:00+08,0,13,13,0,1063843,1063843,78.7,257.67,336.37
2021-11-06 04:00:00+08,0,12,12,0,982266,982266,78.7,288.44,367.14
2021-11-06 08:00:00+08,0,12,12,0,1100162,1100162,78.7,220.13,298.83
2021-11-06 12:00:00+08,0,9,9,0,875485,875485,78.69,113.99,192.68
2021-11-06 16:00:00+08,0,9,9,0,900097,900097,78.69,129.51,208.2
2021-11-06 20:00:00+08,0,10,10,0,1048308,1048308,15.09,145.67,160.76
2021-11-07 00:00:00+08,0,10,10,0,1114487,1114487,0,156.71,156.71
2021-11-07 04:00:00+08,0,11,11,0,1051788,1051788,0,171.49,171.49
2021-11-07 08:00:00+08,0,10,10,0,943489,943489,0,188.1,188.1
2021-11-07 12:00:00+08,0,10,10,0,1062907,1062907,0,221.78,221.78
2021-11-07 16:00:00+08,0,10,10,0,1062907,1062907,0,261.78,261.78
2021-11-07 20:00:00+08,1,12,13,145237,1170728,1315965,3.4,302.96,306.36
2021-11-08 00:00:00+08,3,11,14,421320,1057250,1478570,14.11,321.52,335.63
2021-11-08 04:00:00+08,3,11,14,421320,1128183,1549503,26.09,340.36,366.45
2021-11-08 08:00:00+08,4,10,14,508938,1040577,1549515,39.76,343.96,383.72
2021-11-08 12:00:00+08,4,9,13,508938,930577,1439515,55.76,329.69,385.45
2021-11-08 16:00:00+08,2,7,9,236341,702927,939268,29.21,249.14,278.35
2021-11-08 20:00:00+08,3,11,14,286970,1073492,1360462,86.89,280.35,367.24
2021-11-09 00:00:00+08,3,10,13,286970,972292,1259262,98.91,274.92,373.83
2021-11-09 04:00:00+08,3,11,14,286970,1075960,1362930,110.89,318.1,428.99
2021-11-09 08:00:00+08,3,9,12,286970,968139,1255109,122.91,288.91,411.82
2021-11-09 12:00:00+08,3,9,12,286970,968139,1255109,134.91,324.91,459.82
2021-11-09 16:00:00+08,2,7,9,138247,838466,976713,103.38,302.03,405.41
2021-11-09 20:00:00+08,2,8,10,138247,856155,994402,157.16,180.48,337.64
2021-11-10 00:00:00+08,2,8,10,138247,837371,975618,165.16,125.85,291.01
2021-11-10 04:00:00+08,3,11,14,223115,1190968,1414083,174.87,164.79,339.66
2021-11-10 08:00:00+08,2,11,13,138247,1190968,1329215,181.13,208.79,389.92
2021-11-10 12:00:00+08,2,11,13,138247,1190968,1329215,189.13,252.79,441.92
2021-11-10 16:00:00+08,2,10,12,138247,952685,1090932,148.48,210.16,358.64
2021-11-10 20:00:00+08,2,11,13,138247,1005537,1143784,156.5,228.78,385.28
2021-11-11 00:00:00+08,2,12,14,138247,1102437,1240684,182.78,232.65,415.43
2021-11-11 04:00:00+08,2,11,13,138247,1021626,1159873,190.74,223.68,414.42
2021-11-11 08:00:00+08,2,11,13,138247,1021626,1159873,198.74,267.68,466.42
2021-11-11 12:00:00+08,2,11,13,138247,1027831,1166078,206.74,271.91,478.65
2021-11-11 16:00:00+08,1,8,9,50629,751396,802025,87.28,206.49,293.77
2021-11-11 20:00:00+08,1,8,9,50629,831793,882422,158.31,191.48,349.79
2021-11-12 00:00:00+08,1,8,9,50629,831793,882422,162.31,223.48,385.79
2021-11-12 04:00:00+08,4,8,12,311382,831793,1143175,171.42,255.48,426.9
2021-11-12 08:00:00+08,4,10,14,311382,959403,1270785,187.42,290.17,477.59
2021-11-12 12:00:00+08,4,9,13,311382,767055,1078437,118.18,277.02,395.2
2021-11-12 16:00:00+08,2,9,11,157992,767055,925047,27.04,313.02,340.06
2021-11-12 20:00:00+08,1,11,12,122961,888778,1011739,132.62,285.4,418.02
2021-11-13 00:00:00+08,1,12,13,122961,771005,893966,154.21,210.66,364.87
2021-11-13 04:00:00+08,1,12,13,122961,771005,893966,158.21,258.66,416.87
2021-11-13 08:00:00+08,2,12,14,269552,838890,1108442,163.04,286.48,449.52
2021-11-13 12:00:00+08,2,12,14,269552,794713,1064265,171,303.88,474.88
2021-11-13 16:00:00+08,2,10,12,269552,724835,994387,178.99,297.43,476.42
2021-11-13 20:00:00+08,2,11,13,269552,864732,1134284,187.02,318.55,505.57
2021-11-14 00:00:00+08,3,9,12,310030,658716,968746,195.08,207.02,402.1
2021-11-14 04:00:00+08,3,10,13,310030,678438,988468,189.42,161.8,351.22
2021-11-14 08:00:00+08,3,10,13,373200,725535,1098735,193.81,168.52,362.33
2021-11-14 12:00:00+08,3,11,14,373200,829203,1202403,205.82,210.3,416.12
2021-11-14 16:00:00+08,3,9,12,373200,701193,1074393,217.85,205.3,423.15
2021-11-14 20:00:00+08,3,10,13,373200,838982,1212182,152.6,181.44,334.04
2021-11-15 00:00:00+08,3,8,11,345444,711593,1057037,125.73,154.29,280.02
2021-11-15 04:00:00+08,4,8,12,388424,711593,1100017,140.66,186.29,326.95
2021-11-15 08:00:00+08,4,7,11,388424,639723,1028147,185.26,122.46,307.72
2021-11-15 12:00:00+08,4,7,11,388424,639723,1028147,201.26,150.46,351.72
2021-11-15 16:00:00+08,4,5,9,388424,532081,920505,197.81,118.29,316.1
2021-11-15 20:00:00+08,4,6,10,388424,673529,1061953,213.82,138.66,352.48
2021-11-16 00:00:00+08,3,7,10,265463,686590,952053,135.78,166.41,302.19
2021-11-16 04:00:00+08,3,7,10,265463,742733,1008196,242.65,165.56,408.21
2021-11-16 08:00:00+08,3,9,12,265463,844049,1109512,254.66,200.34,455
2021-11-16 12:00:00+08,3,11,14,265463,1045588,1311051,266.64,242.39,509.03
2021-11-16 16:00:00+08,3,9,12,277915,928859,1206774,223.56,212.87,436.43
2021-11-16 20:00:00+08,3,8,11,277915,855877,1133792,235.56,183.16,418.72
2021-11-17 00:00:00+08,3,11,14,277915,1123603,1401518,308.77,225.98,534.75
2021-11-17 04:00:00+08,3,10,13,277915,1049098,1327013,320.76,246.27,567.03
2021-11-17 08:00:00+08,3,11,14,277915,1106928,1384843,332.77,287.24,620.01
2021-11-17 12:00:00+08,3,11,14,277915,1106928,1384843,344.77,331.24,676.01
2021-11-17 16:00:00+08,2,10,12,234935,964906,1199841,293.83,306.83,600.66
2021-11-17 20:00:00+08,2,11,13,234935,1006764,1241699,368.11,323.82,691.93
2021-11-18 00:00:00+08,1,10,11,118835,914773,1033608,342.74,278.51,621.25
2021-11-18 04:00:00+08,1,11,12,118835,1098691,1217526,381.99,276.79,658.78
2021-11-18 08:00:00+08,1,11,12,118835,1098691,1217526,385.99,320.79,706.78
2021-11-18 12:00:00+08,1,10,11,118835,1040861,1159696,389.99,335.83,725.82
2021-11-18 16:00:00+08,2,10,12,260191,970129,1230320,397.76,323.57,721.33
2021-11-18 20:00:00+08,1,8,9,141356,780558,921914,199.06,252.56,451.62
2021-11-19 00:00:00+08,1,8,9,141356,737020,878376,108.21,214.53,322.74
2021-11-19 04:00:00+08,1,10,11,141356,880912,1022268,210.95,220.9,431.85
2021-11-19 08:00:00+08,1,9,10,141356,802644,944000,214.95,201.19,416.14
2021-11-19 12:00:00+08,1,8,9,141356,870882,1012238,157.77,119.45,277.22
2021-11-19 16:00:00+08,1,7,8,141356,754782,896138,126.48,113.36,239.84
2021-11-19 20:00:00+08,1,9,10,141356,933682,1075038,130.49,142.08,272.57
2021-11-20 00:00:00+08,2,12,14,204572,1263931,1468503,135.42,183.78,319.2
2021-11-20 04:00:00+08,2,13,15,204572,1381106,1585678,143.49,233.72,377.21
2021-11-20 08:00:00+08,1,13,14,63216,1381106,1444322,107.73,285.72,393.45
2021-11-20 12:00:00+08,1,12,13,63216,1370018,1433234,159.33,243.6,402.93
2021-11-20 16:00:00+08,1,11,12,63216,1290595,1353811,163.33,250.43,413.76
2021-11-20 20:00:00+08,1,11,12,63216,1225212,1288428,167.25,228.27,395.52
2021-11-21 00:00:00+08,1,11,12,63216,1225212,1288428,171.25,272.27,443.52
2021-11-21 04:00:00+08,1,13,14,63216,1347043,1410259,175.25,319.48,494.73
2021-11-21 08:00:00+08,1,12,13,63216,1286843,1350059,179.25,358.87,538.12
2021-11-21 12:00:00+08,1,12,13,63216,1307984,1371200,183.25,400.56,583.81
2021-11-21 16:00:00+08,2,10,12,113823,1075109,1188932,190.91,366.56,557.47
2021-11-21 20:00:00+08,2,9,11,113823,1034631,1148454,198.9,381.89,580.79
2021-11-22 00:00:00+08,2,7,9,113823,815317,929140,206.93,347.17,554.1
2021-11-22 04:00:00+08,3,6,9,164520,696482,861002,119.96,299.99,419.95
2021-11-22 08:00:00+08,3,6,9,164520,757513,922033,131.96,245.35,377.31
2021-11-22 12:00:00+08,3,7,10,164520,811670,976190,143.98,270.05,414.03
2021-11-22 16:00:00+08,3,7,10,164520,811670,976190,155.98,298.05,454.03
2021-11-22 20:00:00+08,3,6,9,164520,670314,834834,120.38,269.89,390.27
2021-11-23 00:00:00+08,3,7,10,164520,722136,886656,132.36,297.43,429.79
2021-11-23 04:00:00+08,2,7,9,113823,763357,877180,116.6,251.67,368.27
2021-11-23 08:00:00+08,2,11,13,113823,1035384,1149207,154.35,284.4,438.75
2021-11-23 12:00:00+08,2,12,14,113823,1189122,1302945,162.35,328.69,491.04
2021-11-23 16:00:00+08,2,12,14,113823,1189122,1302945,170.35,376.69,547.04
2021-11-23 20:00:00+08,3,12,15,135894,1145485,1281379,181.04,350.18,531.22
2021-11-24 00:00:00+08,2,10,12,72678,936587,1009265,96.1,261.39,357.49
2021-11-24 04:00:00+08,2,12,14,77418,1033965,1111383,196,304.79,500.79
2021-11-24 08:00:00+08,3,12,15,119392,911893,1031285,218.66,234.85,453.51
2021-11-24 12:00:00+08,3,12,15,119392,911893,1031285,230.66,282.85,513.51
2021-11-24 16:00:00+08,2,12,14,92581,911893,1004474,226.73,330.85,557.58
2021-11-24 20:00:00+08,2,13,15,92581,921513,1014094,254,355.13,609.13
2021-11-25 00:00:00+08,2,14,16,92581,998212,1090793,261.96,384.3,646.26
2021-11-25 04:00:00+08,2,14,16,92581,998212,1090793,269.96,440.3,710.26
2021-11-25 08:00:00+08,2,14,16,92581,998212,1090793,277.96,496.3,774.26
2021-11-25 12:00:00+08,2,13,15,92581,964050,1056631,285.99,519.14,805.13
2021-11-25 16:00:00+08,3,8,11,118601,518415,637016,267.34,320.24,587.58
2021-11-25 20:00:00+08,3,3,6,118601,127017,245618,161.38,139.7,301.08
2021-11-26 00:00:00+08,2,3,5,76627,127017,203644,132.73,151.7,284.43
2021-11-26 04:00:00+08,2,4,6,76627,231374,308001,140.73,167.31,308.04
2021-11-26 08:00:00+08,2,5,7,76627,273348,349975,193.43,187.26,380.69
2021-11-26 12:00:00+08,2,5,7,76627,273348,349975,201.43,207.26,408.69
2021-11-26 16:00:00+08,0,5,5,0,273348,273348,58.68,227.26,285.94
2021-11-26 20:00:00+08,0,11,11,0,668842,668842,89.3,258.52,347.82
2021-11-27 00:00:00+08,0,12,12,0,719449,719449,217,306.45,523.45
2021-11-27 04:00:00+08,0,12,12,0,719449,719449,217,354.45,571.45
2021-11-27 08:00:00+08,1,13,14,39083,733374,772457,220.25,344.92,565.17
2021-11-27 12:00:00+08,1,13,14,39083,692972,732055,224.26,381.42,605.68
2021-11-27 16:00:00+08,0,11,11,0,644881,644881,172.45,332.24,504.69
2021-11-27 20:00:00+08,0,12,12,0,834112,834112,187.14,330.81,517.95
2021-11-28 00:00:00+08,0,10,10,0,785254,785254,142.46,318.22,460.68
2021-11-28 04:00:00+08,0,10,10,0,757687,757687,142.46,340.63,483.09
2021-11-28 08:00:00+08,0,10,10,0,751554,751554,142.44,307.04,449.48
2021-11-28 12:00:00+08,1,11,12,50749,879756,930505,130.46,336.3,466.76
2021-11-28 16:00:00+08,1,8,9,50749,701631,752380,6.7,283.92,290.62
2021-11-28 20:00:00+08,1,6,7,50749,529861,580610,10.7,237.14,247.84
2021-11-29 00:00:00+08,1,8,9,50749,857475,908224,14.7,248.44,263.14
2021-11-29 04:00:00+08,4,8,12,434382,857475,1291857,27.68,280.44,308.12
2021-11-29 08:00:00+08,4,9,13,434382,936940,1371322,43.68,313.9,357.58
2021-11-29 12:00:00+08,4,11,15,434382,1078103,1512485,59.68,354.66,414.34
2021-11-29 16:00:00+08,4,9,13,434382,930668,1365050,75.68,326.6,402.28
2021-11-29 20:00:00+08,3,11,14,349599,1114857,1464456,72.57,365.77,438.34
2021-11-30 00:00:00+08,3,12,15,349599,1117693,1467292,106.11,389.37,495.48
2021-11-30 04:00:00+08,3,12,15,349599,1117693,1467292,118.11,437.37,555.48
2021-11-30 08:00:00+08,3,11,14,349599,1026693,1376292,130.11,397.95,528.06
2021-11-30 12:00:00+08,3,11,14,349599,1026693,1376292,142.11,441.95,584.06
2021-11-30 16:00:00+08,3,10,13,349599,1012890,1362489,154.11,455.85,609.96
2021-11-30 20:00:00+08,3,11,14,349599,1146109,1495708,144.57,477.93,622.5
2021-12-01 00:00:00+08,3,11,14,349599,1146109,1495708,156.57,521.93,678.5
2021-12-01 04:00:00+08,4,10,14,434434,1018749,1453183,172.26,523.32,695.58
2021-12-01 08:00:00+08,4,8,12,367923,900465,1268388,134.23,489.97,624.2
2021-12-01 12:00:00+08,4,6,10,367923,542385,910308,150.23,342.92,493.15
2021-12-01 16:00:00+08,2,5,7,197256,426685,623941,140.97,345.61,486.58
2021-12-01 20:00:00+08,2,8,10,197256,771477,968733,162.4,366.36,528.76
2021-12-02 00:00:00+08,2,10,12,197256,909521,1106777,190.36,367.26,557.62
2021-12-02 04:00:00+08,2,11,13,197256,1061864,1259120,271.35,409.88,681.23
2021-12-02 08:00:00+08,2,10,12,197256,953028,1150284,279.35,373.75,653.1
2021-12-02 12:00:00+08,2,10,12,197256,953028,1150284,287.35,413.75,701.1
2021-12-02 16:00:00+08,2,8,10,197256,833879,1031135,275.39,404.86,680.25
2021-12-02 20:00:00+08,3,11,14,247788,1055071,1302859,287.27,389.86,677.13
2021-12-03 00:00:00+08,3,9,12,247788,929629,1177417,299.29,154.54,453.83
2021-12-03 04:00:00+08,4,10,14,322241,962845,1285086,311.94,194.23,506.17
2021-12-03 08:00:00+08,4,10,14,322241,962845,1285086,327.94,234.23,562.17
2021-12-03 12:00:00+08,4,10,14,322241,844670,1166911,343.94,229.34,573.28
2021-12-03 16:00:00+08,2,10,12,197039,844670,1041709,220.56,269.34,489.9
2021-12-03 20:00:00+08,2,11,13,197039,970631,1167670,358.55,265.57,624.12
2021-12-04 00:00:00+08,2,13,15,197039,1191298,1388337,383.28,315.54,698.82
2021-12-04 04:00:00+08,2,13,15,197039,1222702,1419741,377.82,311.66,689.48
2021-12-04 08:00:00+08,2,13,15,197039,1083422,1280461,312.84,313.02,625.86
2021-12-04 12:00:00+08,2,14,16,197039,1210498,1407537,320.86,365.92,686.78
2021-12-04 16:00:00+08,2,10,12,197039,975851,1172890,198.87,256.98,455.85
2021-12-04 20:00:00+08,2,11,13,197039,1004882,1201921,206.87,224.37,431.24
2021-12-05 00:00:00+08,3,12,15,282476,1062867,1345343,217.88,253.68,471.56
2021-12-05 04:00:00+08,3,12,15,282476,1062867,1345343,229.88,301.68,531.56
2021-12-05 08:00:00+08,3,10,13,282476,971257,1253733,225.15,266.17,491.32
2021-12-05 12:00:00+08,3,11,14,282476,1004948,1287424,237.15,309.86,547.01
2021-12-05 16:00:00+08,4,10,14,354923,864802,1219725,251.16,261.48,512.64
2021-12-05 20:00:00+08,5,12,17,485496,1062190,1547686,271.04,304.02,575.06
2021-12-06 00:00:00+08,6,10,16,591979,812131,1404110,130.25,274.06,404.31
2021-12-06 04:00:00+08,6,11,17,591979,983862,1575841,154.24,301.71,455.95
2021-12-06 08:00:00+08,6,10,16,591979,913879,1505858,178.2,276.78,454.98
2021-12-06 12:00:00+08,6,11,17,591979,1060386,1652365,379.47,317.78,697.25
2021-12-06 16:00:00+08,5,8,13,477871,775281,1253152,384.03,271.12,655.15
2021-12-06 20:00:00+08,5,8,13,477871,810978,1288849,404.05,254.84,658.89
2021-12-07 00:00:00+08,5,9,14,477871,925086,1402957,447.69,290.69,738.38
2021-12-07 04:00:00+08,4,8,12,427339,823307,1250646,359.86,269.89,629.75
2021-12-07 08:00:00+08,4,10,14,427339,994136,1421475,375.85,306.12,681.97
2021-12-07 12:00:00+08,4,9,13,427339,844929,1272268,507.28,214.3,721.58
2021-12-07 16:00:00+08,2,9,11,203020,844929,1047949,414.27,250.3,664.57
2021-12-07 20:00:00+08,2,12,14,203020,1154331,1357351,467.44,289.14,756.58
2021-12-08 00:00:00+08,2,13,15,203020,1239768,1442788,546.56,340.99,887.55
2021-12-08 04:00:00+08,2,15,17,203020,1419709,1622729,554.57,397.59,952.16
2021-12-08 08:00:00+08,2,15,17,203020,1432841,1635861,562.57,421.79,984.36
2021-12-08 12:00:00+08,2,13,15,203020,1234045,1437065,546.99,425.3,972.29
2021-12-08 16:00:00+08,1,12,13,130573,1092023,1222596,480.96,413.6,894.56
2021-12-08 20:00:00+08,1,15,16,130573,1365978,1496551,562.84,463.44,1026.28
2021-12-09 00:00:00+08,1,14,15,130573,1397059,1527632,451.41,449,900.41
2021-12-09 04:00:00+08,3,15,18,325165,1490457,1815622,459.15,507.32,966.47
2021-12-09 08:00:00+08,3,15,18,325165,1490457,1815622,471.15,567.32,1038.47
2021-12-09 12:00:00+08,3,14,17,325165,1455753,1780918,483.15,593.09,1076.24
2021-12-09 16:00:00+08,3,11,14,325165,1162306,1487471,417.22,515.67,932.89
2021-12-09 20:00:00+08,4,12,16,405045,1274530,1679575,431.36,560.33,991.69
2021-12-10 00:00:00+08,6,10,16,511687,1124675,1636362,453.28,420.96,874.24
2021-12-10 04:00:00+08,6,12,18,511687,1189389,1701076,477.27,467.93,945.2
2021-12-10 08:00:00+08,6,13,19,511687,1273528,1785215,501.35,458.65,960
2021-12-10 12:00:00+08,6,12,18,511687,1216021,1727708,525.4,441.81,967.21
2021-12-10 16:00:00+08,6,11,17,511687,1100028,1611715,549.4,445,994.4
2021-12-10 20:00:00+08,6,9,15,511687,994848,1506535,573.39,452.5,1025.89
2021-12-11 00:00:00+08,5,10,15,431807,1057842,1489649,567.19,490.7,1057.89
2021-12-11 04:00:00+08,3,10,13,228787,1047684,1276471,386.24,358.25,744.49
2021-12-11 08:00:00+08,3,12,15,228787,1173337,1402124,487.95,317.2,805.15
2021-12-11 12:00:00+08,3,12,15,228787,1173337,1402124,499.95,365.2,865.15
2021-12-11 16:00:00+08,3,11,14,228787,1061113,1289900,511.92,368.56,880.48
2021-12-11 20:00:00+08,3,10,13,228787,1032088,1260875,523.96,330.51,854.47
2021-12-12 00:00:00+08,3,10,13,228787,987311,1216098,535.96,344.98,880.94
2021-12-12 04:00:00+08,3,10,13,228787,906504,1135291,370.68,249.53,620.21
2021-12-12 08:00:00+08,3,11,14,228787,976898,1205685,382.66,250.11,632.77
2021-12-12 12:00:00+08,4,10,14,269926,958681,1228607,398.35,281.44,679.79
2021-12-12 16:00:00+08,4,9,13,269926,854908,1124834,414.34,288.07,702.41
2021-12-12 20:00:00+08,4,7,11,269926,729894,999820,430.32,247.35,677.67
2021-12-13 00:00:00+08,5,8,13,341302,811065,1152367,448.35,276.82,725.17
2021-12-13 04:00:00+08,6,8,14,457295,763085,1220380,471.06,207.97,679.03
2021-12-13 08:00:00+08,5,9,14,423100,816123,1239223,277.26,191.46,468.72
2021-12-13 12:00:00+08,5,9,14,423100,770438,1193538,349.62,171.83,521.45
2021-12-13 16:00:00+08,6,8,14,533068,621446,1154514,372.01,146.05,518.06
2021-12-13 20:00:00+08,5,8,13,417075,689968,1107043,377.31,154.01,531.32
2021-12-14 00:00:00+08,5,10,15,417075,935470,1352545,419.61,166.56,586.17
2021-12-14 04:00:00+08,6,10,16,521924,902707,1424631,441.07,158.86,599.93
2021-12-14 08:00:00+08,6,12,18,521924,1127760,1649684,465.15,202.2,667.35
2021-12-14 12:00:00+08,6,12,18,521924,1127760,1649684,489.15,250.2,739.35
2021-12-14 16:00:00+08,5,11,16,417075,1076891,1493966,499.62,260.38,760
2021-12-14 20:00:00+08,5,11,16,417075,1074076,1491151,536.86,263.06,799.92
2021-12-15 00:00:00+08,5,12,17,417075,1017434,1434509,556.84,285.35,842.19
2021-12-15 04:00:00+08,5,15,20,417075,1259922,1676997,576.83,340.96,917.79
2021-12-15 08:00:00+08,5,14,19,417075,1218339,1635414,596.81,352.8,949.61
2021-12-15 12:00:00+08,6,13,19,571595,1108339,1679934,618.83,369.24,988.07
2021-12-15 16:00:00+08,6,12,18,571595,1099023,1670618,642.85,369.71,1012.56
2021-12-15 20:00:00+08,6,12,18,626421,1031222,1657643,400.69,256.48,657.17
2021-12-16 00:00:00+08,5,13,18,516453,1198215,1714668,528.23,283.08,811.31
2021-12-16 04:00:00+08,5,13,18,516453,1198215,1714668,548.23,335.08,883.31
2021-12-16 08:00:00+08,5,13,18,516453,1160401,1676854,634.49,280.35,914.84
2021-12-16 12:00:00+08,5,12,17,516453,1126128,1642581,654.51,291.54,946.05
2021-12-16 16:00:00+08,5,10,15,516453,953761,1470214,657.27,275.2,932.47
2021-12-16 20:00:00+08,5,11,16,516453,975044,1491497,677.27,181.83,859.1
2021-12-17 00:00:00+08,5,11,16,518984,975044,1494028,507.85,225.83,733.68
2021-12-17 04:00:00+08,4,14,18,413626,1236375,1650001,686.51,278.37,964.88
2021-12-17 08:00:00+08,4,14,18,413626,1291201,1704827,577.6,300.85,878.45
2021-12-17 12:00:00+08,3,15,18,342250,1332784,1675034,483.6,359.27,842.87
2021-12-17 16:00:00+08,3,14,17,342250,1282949,1625199,495.6,398.45,894.05
2021-12-17 20:00:00+08,3,13,16,342250,1189544,1531794,625.41,350.97,976.38
2021-12-18 00:00:00+08,3,14,17,342250,1222241,1564491,637.42,360.45,997.87
2021-12-18 04:00:00+08,3,14,17,342250,1222241,1564491,649.42,416.45,1065.87
2021-12-18 08:00:00+08,3,12,15,342250,1040706,1382956,661.48,387.49,1048.97
2021-12-18 12:00:00+08,3,7,10,342250,761653,1103903,555.61,258.77,814.38
2021-12-18 16:00:00+08,3,7,10,342250,761653,1103903,567.61,286.77,854.38
2021-12-18 20:00:00+08,3,8,11,342250,878889,1221139,579.64,314.97,894.61
2021-12-19 00:00:00+08,3,8,11,342250,794957,1137207,525.37,286.72,812.09
2021-12-19 04:00:00+08,3,11,14,342250,1002501,1344751,537.34,327.78,865.12
2021-12-19 08:00:00+08,4,10,14,486381,985304,1471685,550.38,365.22,915.6
2021-12-19 12:00:00+08,5,9,14,545651,959268,1504919,567.39,389.31,956.7
2021-12-19 16:00:00+08,5,7,12,545651,754943,1300594,550.31,271.03,821.34
2021-12-19 20:00:00+08,6,8,14,613368,866322,1479690,572.02,181.27,753.29
2021-12-20 00:00:00+08,5,7,12,466777,722262,1189039,329.52,91.65,421.17
2021-12-20 04:00:00+08,5,9,14,466777,977494,1444271,427.13,120.57,547.7
2021-12-20 08:00:00+08,5,9,14,466777,969740,1436517,447.13,153.09,600.22
2021-12-20 12:00:00+08,5,8,13,466777,906469,1373246,467.14,153.64,620.78
2021-12-20 16:00:00+08,5,8,13,466777,876373,1343150,487.13,150.52,637.65
2021-12-20 20:00:00+08,5,8,13,466777,818857,1285634,507.14,157.72,664.86
2021-12-21 00:00:00+08,5,7,12,466777,701621,1168398,527.14,137.53,664.67
2021-12-21 04:00:00+08,6,10,16,539224,1036733,1575957,547.37,174.27,721.64
2021-12-21 08:00:00+08,7,10,17,685996,1082471,1768467,573.53,178.29,751.82
2021-12-21 12:00:00+08,7,10,17,685996,1082471,1768467,601.53,218.29,819.82
2021-12-21 16:00:00+08,7,10,17,685996,1082471,1768467,629.53,258.29,887.82
2021-12-21 20:00:00+08,6,11,17,618279,1145843,1764122,657.29,251.16,908.45
2021-12-22 00:00:00+08,6,11,17,618279,1110852,1729131,681.28,247.46,928.74
2021-12-22 04:00:00+08,6,12,18,618279,1223085,1841364,705.28,294.1,999.38
2021-12-22 08:00:00+08,6,13,19,618279,1316483,1934762,729.28,345.19,1074.47
2021-12-22 12:00:00+08,6,13,19,618279,1316483,1934762,753.28,397.19,1150.47
2021-12-22 16:00:00+08,6,14,20,618279,1350797,1969076,777.28,451.41,1228.69
2021-12-22 20:00:00+08,6,12,18,618279,1232290,1850569,751.77,433.35,1185.12
2021-12-23 00:00:00+08,7,12,19,749637,1198089,1947726,777.46,419.46,1196.92
2021-12-23 04:00:00+08,7,11,18,749637,1104691,1854328,805.46,444.37,1249.83
2021-12-23 08:00:00+08,7,10,17,749637,957785,1707422,833.47,432.4,1265.87
2021-12-23 12:00:00+08,7,9,16,749637,923471,1673108,861.47,450.18,1311.65
2021-12-23 16:00:00+08,7,7,14,749637,748924,1498561,889.47,382.22,1271.69
2021-12-23 20:00:00+08,6,8,14,618279,775735,1394014,895.79,412,1307.79
2021-12-24 00:00:00+08,7,8,15,721970,748023,1469993,920.65,382.6,1303.25
2021-12-24 04:00:00+08,7,9,16,721970,738854,1460824,975.15,297.49,1272.64
2021-12-24 08:00:00+08,8,11,19,831602,896524,1728126,1007.12,338.17,1345.29
2021-12-24 12:00:00+08,8,12,20,831602,1042207,1873809,1039.1,385.6,1424.7
2021-12-24 16:00:00+08,7,10,17,721970,866730,1588700,1059.19,201.21,1260.4
2021-12-24 20:00:00+08,9,10,19,928406,829771,1758177,1032.2,129.1,1161.3
2021-12-25 00:00:00+08,11,8,19,1068800,763404,1832204,1074.52,124.97,1199.49
2021-12-25 04:00:00+08,11,8,19,1068800,763404,1832204,1118.52,156.97,1275.49
2021-12-25 08:00:00+08,11,8,19,1068800,763404,1832204,1162.52,188.97,1351.49
2021-12-25 12:00:00+08,11,8,19,1068800,763404,1832204,1206.52,220.97,1427.49
2021-12-25 16:00:00+08,11,8,19,1068800,763404,1832204,1250.52,252.97,1503.49
2021-12-25 20:00:00+08,11,8,19,1068800,763404,1832204,1294.52,284.97,1579.49
2021-12-26 00:00:00+08,12,8,20,1130409,763404,1893813,1339.04,316.97,1656.01
2021-12-26 04:00:00+08,12,8,20,1130409,763404,1893813,1387.04,348.97,1736.01
2021-12-26 08:00:00+08,12,8,20,1130409,763404,1893813,1435.04,380.97,1816.01
2021-12-26 12:00:00+08,12,8,20,1130409,763404,1893813,1483.04,412.97,1896.01
2021-12-26 16:00:00+08,11,8,19,1014416,763404,1777820,1484.02,444.97,1928.99
2021-12-26 20:00:00+08,11,12,23,1014416,1178256,2192672,1578.99,481.66,2060.65
2021-12-27 00:00:00+08,11,12,23,1014416,1178256,2192672,1622.99,529.66,2152.65
2021-12-27 04:00:00+08,12,12,24,1082017,1178256,2260273,1669.54,577.66,2247.2
2021-12-27 08:00:00+08,12,12,24,1082017,1178256,2260273,1717.54,625.66,2343.2
2021-12-27 12:00:00+08,12,9,21,1082017,863347,1945364,1765.56,490.39,2255.95
2021-12-27 16:00:00+08,11,8,19,1020408,755048,1775456,1773.04,504.75,2277.79
2021-12-27 20:00:00+08,10,6,16,985372,550787,1536159,1719.71,281.06,2000.77
2021-12-28 00:00:00+08,9,9,18,841241,756006,1597247,1667.73,314.75,1982.48
2021-12-28 04:00:00+08,9,10,19,841432,872446,1713878,1622.98,351.63,1974.61
2021-12-28 08:00:00+08,8,13,21,737741,1211672,1949413,1853.31,398.23,2251.54
2021-12-28 12:00:00+08,8,12,20,737741,1217127,1954868,1921.68,395.09,2316.77
2021-12-28 16:00:00+08,8,11,19,737741,1199891,1937632,1953.68,422.69,2376.37
2021-12-28 20:00:00+08,8,12,20,737741,1226541,1964282,1985.69,468.18,2453.87
2021-12-29 00:00:00+08,8,11,19,737741,1110548,1848289,1966.69,464.15,2430.84
2021-12-29 04:00:00+08,8,14,22,737741,1283679,2021420,1998.68,519.2,2517.88
2021-12-29 08:00:00+08,9,13,22,804774,1174982,1979756,2031.61,421.62,2453.23
2021-12-29 12:00:00+08,9,14,23,804774,1209686,2014460,2067.61,473.95,2541.56
2021-12-29 16:00:00+08,8,13,21,737173,1119243,1856416,1955.31,496.1,2451.41
2021-12-29 20:00:00+08,9,11,20,764044,977211,1741255,1993.26,337.86,2331.12
2021-12-30 00:00:00+08,8,11,19,697011,976764,1673775,2012.23,337.3,2349.53
2021-12-30 04:00:00+08,8,13,21,697011,1189254,1886265,2044.23,385.7,2429.93
2021-12-30 08:00:00+08,7,14,21,542491,1256287,1798778,1739.39,441.48,2180.87
2021-12-30 12:00:00+08,7,11,18,542491,1110969,1653460,1767.37,421.24,2188.61
2021-12-30 16:00:00+08,6,9,15,483221,955542,1438763,1526.37,368.16,1894.53
2021-12-30 20:00:00+08,7,10,17,541051,1076410,1617461,1825.27,389.55,2214.82
2021-12-31 00:00:00+08,7,10,17,541051,1076410,1617461,1853.27,429.55,2282.82
2021-12-31 04:00:00+08,7,12,19,541051,1237814,1778865,2255.44,475.14,2730.58
2021-12-31 08:00:00+08,8,12,20,581529,1237814,1819343,2283.82,523.14,2806.96
2021-12-31 12:00:00+08,9,12,21,712102,1237814,1949916,2318.6,571.14,2889.74
2021-12-31 16:00:00+08,9,12,21,712102,1237814,1949916,2354.6,619.14,2973.74
2021-12-31 20:00:00+08,9,8,17,729703,855358,1585061,1817.75,409.21,2226.96
2022-01-01 00:00:00+08,10,4,14,846798,493434,1340232,1585.88,158.23,1744.11
2022-01-01 04:00:00+08,10,4,14,868610,493434,1362044,1619.44,174.23,1793.67
2022-01-01 08:00:00+08,12,5,17,1069770,610529,1680299,1672.65,192.03,1864.68
2022-01-01 12:00:00+08,12,5,17,1069770,610529,1680299,1720.65,212.03,1932.68
2022-01-01 16:00:00+08,12,5,17,1069770,610529,1680299,1768.65,232.03,2000.68
2022-01-01 20:00:00+08,12,5,17,1069770,610529,1680299,1816.65,252.03,2068.68
2022-01-02 00:00:00+08,12,5,17,1069770,610529,1680299,1864.65,272.03,2136.68
2022-01-02 04:00:00+08,13,5,18,1132777,610529,1743306,1914.03,292.03,2206.06
2022-01-02 08:00:00+08,13,5,18,1132777,610529,1743306,1966.03,312.03,2278.06
2022-01-02 12:00:00+08,13,5,18,1109666,610529,1720195,1989.51,332.03,2321.54
2022-01-02 16:00:00+08,11,7,18,1042317,778809,1821126,1924.13,353.03,2277.16
2022-01-02 20:00:00+08,10,7,17,914957,778809,1693766,1930,381.03,2311.03
2022-01-03 00:00:00+08,12,9,21,1056260,933040,1989300,2111.72,412.89,2524.61
2022-01-03 04:00:00+08,13,9,22,1140861,933040,2073901,2159.25,448.89,2608.14
2022-01-03 08:00:00+08,13,10,23,1140861,1040095,2180956,2217.21,487.5,2704.71
2022-01-03 12:00:00+08,13,9,22,1140861,894535,2035396,2269.21,402.2,2671.41
2022-01-03 16:00:00+08,11,9,20,1041892,966123,2008015,1656.27,417.87,2074.14
2022-01-03 20:00:00+08,11,10,21,1041892,1007262,2049154,2239.61,454.23,2693.84
2022-01-04 00:00:00+08,13,10,23,1223769,970612,2194381,2389.37,464.5,2853.87
2022-01-04 04:00:00+08,13,8,21,1223769,885911,2109680,2241.82,465.84,2707.66
2022-01-04 08:00:00+08,13,8,21,1223769,885911,2109680,2293.82,497.84,2791.66
2022-01-04 12:00:00+08,14,7,21,1327336,768816,2096152,2339.42,452.03,2791.45
2022-01-04 16:00:00+08,14,6,20,1327336,582346,1909682,2395.42,344.7,2740.12
2022-01-04 20:00:00+08,12,7,19,1162515,575732,1738247,2300.15,337.37,2637.52
2022-01-05 00:00:00+08,12,8,20,1075279,609980,1685259,2302.85,367.12,2669.97
2022-01-05 04:00:00+08,11,9,20,1002832,752100,1754932,2152.87,354.26,2507.13
2022-01-05 08:00:00+08,11,10,21,1002832,892408,1895240,2021.58,354.38,2375.96
2022-01-05 12:00:00+08,10,9,19,856060,835211,1691271,1699.4,378.22,2077.62
2022-01-05 16:00:00+08,8,10,18,754547,869373,1623920,1680.14,416.51,2096.65
2022-01-05 20:00:00+08,8,12,20,754547,970886,1725433,1779.03,456.89,2235.92
2022-01-06 00:00:00+08,8,12,20,754547,866201,1620748,1436.91,363.07,1799.98
2022-01-06 04:00:00+08,7,13,20,622512,1064535,1687047,1746.51,387.56,2134.07
2022-01-06 08:00:00+08,9,14,23,829276,1196570,2025846,1837.07,441.26,2278.33
2022-01-06 12:00:00+08,9,12,21,829276,1080831,1910107,1873.08,434.59,2307.67
2022-01-06 16:00:00+08,9,12,21,829276,1080831,1910107,1909.08,482.59,2391.67
2022-01-06 20:00:00+08,9,11,20,829276,999294,1828570,1945.08,454.03,2399.11
2022-01-07 00:00:00+08,10,13,23,900635,1189081,2089716,1923.88,501.81,2425.69
2022-01-07 04:00:00+08,9,13,22,822689,1217185,2039874,1916.62,522.51,2439.13
2022-01-07 08:00:00+08,9,14,23,822689,1239185,2061874,1952.62,575.29,2527.91
2022-01-07 12:00:00+08,8,13,21,732055,1187514,1919569,1717.46,590.93,2308.39
2022-01-07 16:00:00+08,9,13,22,762260,1224563,1986823,1719.17,574.52,2293.69
2022-01-07 20:00:00+08,9,13,22,762260,1224563,1986823,1755.17,626.52,2381.69
2022-01-08 00:00:00+08,9,12,21,762260,1093990,1856250,1679.92,607.02,2286.94
2022-01-08 04:00:00+08,12,14,26,1007715,1421069,2428784,1721.24,659.24,2380.48
2022-01-08 08:00:00+08,12,14,26,1007715,1421069,2428784,1769.24,715.24,2484.48
2022-01-08 12:00:00+08,12,13,25,1007715,1312299,2320014,1817.24,731.12,2548.36
2022-01-08 16:00:00+08,12,14,26,1007715,1423483,2431198,1865.2,785.78,2650.98
2022-01-08 20:00:00+08,12,12,24,1026495,1269448,2295943,1795.49,743.29,2538.78
2022-01-09 00:00:00+08,13,11,24,1158530,1294046,2452576,1909.22,525.41,2434.63
2022-01-09 04:00:00+08,13,12,25,1158530,1260139,2418669,1868.3,475.41,2343.71
2022-01-09 08:00:00+08,13,13,26,1158530,1318950,2477480,1920.3,468.98,2389.28
2022-01-09 12:00:00+08,12,12,24,1026495,1301753,2328248,1960.09,514.98,2475.07
2022-01-09 16:00:00+08,12,12,24,1068322,1340247,2408569,1966.59,504.13,2470.72
2022-01-09 20:00:00+08,12,12,24,1068322,1340247,2408569,2014.59,552.13,2566.72
2022-01-10 00:00:00+08,13,12,25,1158596,1340247,2498843,2035.31,600.13,2635.44
2022-01-10 04:00:00+08,14,9,23,1216426,956425,2172851,1683.64,318.35,2001.99
2022-01-10 08:00:00+08,13,9,22,1119446,947995,2067441,1360.77,227.86,1588.63
2022-01-10 12:00:00+08,14,9,23,1242583,1003125,2245708,1502,229.91,1731.91
2022-01-10 16:00:00+08,12,9,21,1007108,1003125,2010233,1257.54,265.91,1523.45
2022-01-10 20:00:00+08,12,12,24,1007108,1311590,2318698,1547.02,306.33,1853.35
2022-01-11 00:00:00+08,12,14,26,1007108,1395132,2402240,1664.92,291.6,1956.52
2022-01-11 04:00:00+08,10,14,24,898589,1395132,2293721,1479.62,347.6,1827.22
2022-01-11 08:00:00+08,10,13,23,898589,1255351,2153940,1547.19,336.73,1883.92
2022-01-11 12:00:00+08,10,12,22,898589,1295132,2193721,1587.23,358.74,1945.97
2022-01-11 16:00:00+08,10,12,22,933903,1295132,2229035,1578.08,406.74,1984.82
2022-01-11 20:00:00+08,10,10,20,933903,1063172,1997075,1584.74,391.2,1975.94
2022-01-12 00:00:00+08,11,13,24,1018591,1308503,2327094,1907.16,441.88,2349.04
2022-01-12 04:00:00+08,10,12,22,877041,1245353,2122394,1732.93,418.43,2151.36
2022-01-12 08:00:00+08,10,12,22,877041,1240207,2117248,1994.73,391.43,2386.16
2022-01-12 12:00:00+08,10,11,21,877041,1099598,1976639,2034.72,333.69,2368.41
2022-01-12 16:00:00+08,9,9,18,826935,946783,1773718,1798.27,295.08,2093.35
2022-01-12 20:00:00+08,9,10,19,826935,1098763,1925698,1539,263.68,1802.68
2022-01-13 00:00:00+08,9,9,18,826935,982203,1809138,1726.77,238.25,1965.02
2022-01-13 04:00:00+08,10,9,19,928652,982203,1910855,1765.79,274.25,2040.04
2022-01-13 08:00:00+08,10,11,21,928652,1107659,2036311,1805.8,314.34,2120.14
2022-01-13 12:00:00+08,10,12,22,928652,1058994,1987646,1845.79,313.4,2159.19
2022-01-13 16:00:00+08,9,11,20,843964,1004837,1848801,1844.54,341.09,2185.63
2022-01-13 20:00:00+08,7,11,18,679240,862922,1542162,1383.06,290.85,1673.91
2022-01-14 00:00:00+08,7,12,19,679240,964639,1643879,1433.38,335.55,1768.93
2022-01-14 04:00:00+08,7,11,18,679240,984468,1663708,1747.14,345.44,2092.58
2022-01-14 08:00:00+08,7,9,16,679240,935006,1614246,1454.27,241.35,1695.62
2022-01-14 12:00:00+08,7,10,17,679240,974053,1653293,1437.82,267.29,1705.11
2022-01-14 16:00:00+08,6,11,17,558296,1084440,1642736,1262.1,308.33,1570.43
2022-01-14 20:00:00+08,7,12,19,669611,1177172,1846783,1496.14,318.48,1814.62
2022-01-15 00:00:00+08,7,12,19,669611,1297267,1966878,1524.15,339.48,1863.63
2022-01-15 04:00:00+08,7,13,20,692194,1347649,2039843,1372.24,390.53,1762.77
2022-01-15 08:00:00+08,8,13,21,719005,1314847,2033852,1305.8,410.94,1716.74
2022-01-15 12:00:00+08,7,12,19,595868,1307963,1903831,1214.31,435.97,1650.28
2022-01-15 16:00:00+08,7,11,18,530991,1177390,1708381,1109.75,415.63,1525.38
2022-01-15 20:00:00+08,7,11,18,530991,1154104,1685095,1266.12,339.28,1605.4
2022-01-16 00:00:00+08,7,10,17,530991,1012554,1543545,1072.35,294.88,1367.23
2022-01-16 04:00:00+08,7,11,18,530991,1156896,1687887,1245.78,337.78,1583.56
2022-01-16 08:00:00+08,7,11,18,530991,1158793,1689784,1251.58,325.44,1577.02
2022-01-16 12:00:00+08,7,6,13,530991,749330,1280321,1091.82,159.26,1251.08
2022-01-16 16:00:00+08,6,6,12,480459,749330,1229789,958.42,183.26,1141.68
2022-01-16 20:00:00+08,5,9,14,400994,998826,1399820,1115.37,209.96,1325.33
2022-01-17 00:00:00+08,5,10,15,400994,1071561,1472555,928.88,197.54,1126.42
2022-01-17 04:00:00+08,5,12,17,450024,1203539,1653563,937.1,243.09,1180.19
2022-01-17 08:00:00+08,4,13,17,384094,1256327,1640421,788.78,293.85,1082.63
2022-01-17 12:00:00+08,4,13,17,384094,1256327,1640421,804.78,345.85,1150.63
2022-01-17 16:00:00+08,2,13,15,255465,1256327,1511792,747.07,397.85,1144.92
2022-01-17 20:00:00+08,2,13,15,255465,1256327,1511792,755.07,449.85,1204.92
2022-01-18 00:00:00+08,2,13,15,255465,1256327,1511792,763.07,501.85,1264.92
2022-01-18 04:00:00+08,2,13,15,255465,1256327,1511792,771.07,553.85,1324.92
2022-01-18 08:00:00+08,2,10,12,255465,919189,1174654,650.59,405.41,1056
2022-01-18 12:00:00+08,2,10,12,255465,919189,1174654,658.59,445.41,1104
2022-01-18 16:00:00+08,2,6,8,255465,616905,872370,448.96,315.96,764.92
2022-01-18 20:00:00+08,2,7,9,255465,582528,837993,799.9,253.72,1053.62
2022-01-19 00:00:00+08,2,8,10,255465,599247,854712,807.9,235.11,1043.01
2022-01-19 04:00:00+08,2,7,9,255465,580972,836437,815.9,261.78,1077.68
2022-01-19 08:00:00+08,2,11,13,255465,944637,1200102,823.9,294,1117.9
2022-01-19 12:00:00+08,2,11,13,255465,899876,1155341,793.93,283.57,1077.5
2022-01-19 16:00:00+08,2,10,12,255465,847088,1102553,801.92,307.91,1109.83
2022-01-19 20:00:00+08,2,10,12,255465,870637,1126102,722.77,324.19,1046.96
2022-01-20 00:00:00+08,2,10,12,255465,870637,1126102,730.77,364.19,1094.96
2022-01-20 04:00:00+08,1,10,11,144150,870637,1014787,607.27,404.19,1011.46
2022-01-20 08:00:00+08,1,9,10,144150,620972,765122,465.85,211.77,677.62
2022-01-20 12:00:00+08,1,11,12,144150,925515,1069665,607.83,225.93,833.76
2022-01-20 16:00:00+08,1,10,11,144150,949130,1093280,611.84,209.04,820.88
2022-01-20 20:00:00+08,0,8,8,0,816377,816377,225.18,151.98,377.16
2022-01-21 00:00:00+08,1,9,10,41974,944477,986451,228.71,156.45,385.16
2022-01-21 04:00:00+08,3,10,13,255019,1088627,1343646,462.16,195.92,658.08
2022-01-21 08:00:00+08,2,11,13,161478,1182168,1343646,472.58,237.5,710.08
2022-01-21 12:00:00+08,2,11,13,161478,1182168,1343646,480.58,281.5,762.08
2022-01-21 16:00:00+08,2,12,14,161478,1189052,1350530,488.58,329.03,817.61
2022-01-21 20:00:00+08,2,12,14,161478,1154964,1316442,496.52,271,767.52
2022-01-22 00:00:00+08,2,10,12,150995,1030198,1181193,485.37,228.79,714.16
2022-01-22 04:00:00+08,3,12,15,273956,1239840,1513796,496.92,275.24,772.16
2022-01-22 08:00:00+08,4,13,17,314434,1359344,1673778,538.46,326.11,864.57
2022-01-22 12:00:00+08,4,13,17,314434,1359344,1673778,554.46,378.11,932.57
2022-01-22 16:00:00+08,3,11,14,273956,1206523,1480479,558.48,351.7,910.18
2022-01-22 20:00:00+08,5,9,14,418985,1004446,1423431,571.26,293.96,865.22
2022-01-23 00:00:00+08,3,9,12,270099,963462,1233561,551.61,303.54,855.15
2022-01-23 04:00:00+08,5,12,17,486263,1065519,1551782,490.57,283.56,774.13
2022-01-23 08:00:00+08,5,11,16,486263,1047302,1533565,510.57,324.75,835.32
2022-01-23 12:00:00+08,5,11,16,486263,1047302,1533565,530.57,368.75,899.32
2022-01-23 16:00:00+08,4,10,14,377242,1020706,1397948,404.39,326.37,730.76
2022-01-23 20:00:00+08,4,8,12,377242,813098,1190340,457.52,256.27,713.79
2022-01-24 00:00:00+08,4,8,12,377242,819735,1196977,473.53,263.15,736.68
2022-01-24 04:00:00+08,6,11,17,566347,1124550,1690897,492.07,301.42,793.49
2022-01-24 08:00:00+08,6,8,14,566347,892157,1458504,236.05,206.38,442.43
2022-01-24 12:00:00+08,6,6,12,566347,649040,1215387,260.05,125.15,385.2
2022-01-24 16:00:00+08,5,5,10,528230,529536,1057766,210.77,90.33,301.1
2022-01-24 20:00:00+08,6,7,13,655590,707894,1363484,282.75,111.22,393.97
2022-01-25 00:00:00+08,7,7,14,706219,707894,1414113,307.03,139.22,446.25
2022-01-25 04:00:00+08,7,8,15,690174,854686,1544860,329.08,170.44,499.52
2022-01-25 08:00:00+08,7,10,17,690174,1028459,1718633,366.38,178.93,545.31
2022-01-25 12:00:00+08,7,10,17,690174,1028459,1718633,394.38,218.93,613.31
2022-01-25 16:00:00+08,7,8,15,690174,763767,1453941,422.41,168.67,591.08
2022-01-25 20:00:00+08,5,11,16,454697,982585,1437282,293.91,204.22,498.13
2022-01-26 00:00:00+08,5,11,16,454697,1029251,1483948,263.06,221.44,484.5
2022-01-26 04:00:00+08,7,12,19,670769,1247492,1918261,455.89,252.44,708.33
2022-01-26 08:00:00+08,7,11,18,670769,1204512,1875281,483.88,274.71,758.59
2022-01-26 12:00:00+08,7,11,18,670769,1204512,1875281,511.88,318.71,830.59
2022-01-26 16:00:00+08,7,11,18,670769,1204512,1875281,539.88,362.71,902.59
2022-01-26 20:00:00+08,8,9,17,776205,951968,1728173,524.83,286.4,811.23
2022-01-27 00:00:00+08,8,10,18,776205,1101421,1877626,556.82,298.16,854.98
2022-01-27 04:00:00+08,9,10,19,863811,1101421,1965232,590.15,338.16,928.31
2022-01-27 08:00:00+08,9,12,21,863811,1161636,2025447,626.11,380.01,1006.12
2022-01-27 12:00:00+08,9,12,21,863811,1161636,2025447,662.11,428.01,1090.12
2022-01-27 16:00:00+08,8,12,20,776205,1161636,1937841,684.78,476.01,1160.79
2022-01-27 20:00:00+08,8,12,20,791372,1121882,1913254,639.97,460.19,1100.16
2022-01-28 00:00:00+08,8,10,18,791372,962519,1753891,671.97,396.61,1068.58
2022-01-28 04:00:00+08,8,12,20,712807,1073071,1785878,764.6,441.8,1206.4
2022-01-28 08:00:00+08,8,12,20,712807,1156436,1869243,832.27,454.36,1286.63
2022-01-28 12:00:00+08,8,11,19,712807,1033475,1746282,768.43,442.53,1210.96
2022-01-28 16:00:00+08,7,11,18,601492,1042849,1644341,695.88,469.23,1165.11
2022-01-28 20:00:00+08,8,10,18,681372,974167,1655539,745.54,328.08,1073.62
2022-01-29 00:00:00+08,9,13,22,747113,1134507,1881620,777.75,378.15,1155.9
2022-01-29 04:00:00+08,9,13,22,747113,1134507,1881620,813.75,430.15,1243.9
2022-01-29 08:00:00+08,9,12,21,747113,1127623,1874736,849.76,452.46,1302.22
2022-01-29 12:00:00+08,9,13,22,747113,1144020,1891133,885.77,503.35,1389.12
2022-01-29 16:00:00+08,9,13,22,747113,1144020,1891133,921.77,555.35,1477.12
2022-01-29 20:00:00+08,8,13,21,681372,1144020,1825392,937.56,607.35,1544.91
2022-01-30 00:00:00+08,8,13,21,681372,1144020,1825392,969.56,659.35,1628.91
2022-01-30 04:00:00+08,8,13,21,681372,1144020,1825392,1001.56,711.35,1712.91
2022-01-30 08:00:00+08,8,13,21,681372,1144020,1825392,1033.56,763.35,1796.91
2022-01-30 12:00:00+08,8,13,21,681372,1144020,1825392,1065.56,815.35,1880.91
2022-01-30 16:00:00+08,8,13,21,681372,1144020,1825392,1097.56,867.35,1964.91
2022-01-30 20:00:00+08,8,12,20,681372,1003779,1685151,1129.53,775.26,1904.79
2022-01-31 00:00:00+08,9,13,22,794850,1130855,1925705,1161.6,823.39,1984.99
2022-01-31 04:00:00+08,9,12,21,794850,1050585,1845435,1197.6,819.85,2017.45
2022-01-31 08:00:00+08,9,12,21,794850,1066491,1861341,1289.55,808.87,2098.42
2022-01-31 12:00:00+08,9,11,20,794850,981786,1776636,1325.55,770.81,2096.36
2022-01-31 16:00:00+08,8,9,17,709413,917356,1626769,1179.22,641.68,1820.9
2022-01-31 20:00:00+08,8,12,20,709413,1191095,1900508,1397.34,681.6,2078.94
2022-02-01 00:00:00+08,8,11,19,742522,1042372,1784894,1408.59,652.39,2060.98
2022-02-01 04:00:00+08,8,11,19,644311,1050414,1694725,1283.54,605.64,1889.18
2022-02-01 08:00:00+08,8,13,21,644311,1182016,1826327,1222.85,552.07,1774.92
2022-02-01 12:00:00+08,9,13,22,694399,1205371,1899770,1410.04,404.15,1814.19
2022-02-01 16:00:00+08,9,14,23,694399,1350759,2045158,1446.05,459.78,1905.83
2022-02-01 20:00:00+08,9,12,21,694399,1268621,1963020,1426.07,396.63,1822.7
2022-02-02 00:00:00+08,10,11,21,780196,1205745,1985941,1464.36,399.78,1864.14
2022-02-02 04:00:00+08,10,12,22,801902,1317969,2119871,1498.9,446.72,1945.62
2022-02-02 08:00:00+08,10,12,22,801902,1306786,2108688,1546.28,382.96,1929.24
2022-02-02 12:00:00+08,10,12,22,801902,1306786,2108688,1586.28,430.96,2017.24
2022-02-02 16:00:00+08,11,13,24,852509,1341100,2193609,1626.6,481.1,2107.7
2022-02-02 20:00:00+08,11,9,20,852509,979442,1831951,1644.98,379.3,2024.28
2022-02-03 00:00:00+08,11,9,20,852509,979442,1831951,1688.98,415.3,2104.28
2022-02-03 04:00:00+08,9,10,19,775009,1014902,1789911,1277.04,328.48,1605.52
2022-02-03 08:00:00+08,9,11,20,775009,1055572,1830581,1684.33,303.66,1987.99
2022-02-03 12:00:00+08,9,11,20,775009,1055572,1830581,1720.33,347.66,2067.99
2022-02-03 16:00:00+08,9,11,20,723083,1055572,1778655,1690.78,391.66,2082.44
2022-02-03 20:00:00+08,9,11,20,723083,1055572,1778655,1726.78,435.66,2162.44
2022-02-04 00:00:00+08,9,8,17,636592,763282,1399874,1288.77,332.6,1621.37
2022-02-04 04:00:00+08,9,11,20,636592,1033006,1669598,1614.55,249.61,1864.16
2022-02-04 08:00:00+08,9,11,20,636592,1049056,1685648,1643.18,242.97,1886.15
2022-02-04 12:00:00+08,9,12,21,636592,1195643,1832235,1765.73,287.74,2053.47
2022-02-04 16:00:00+08,8,12,20,585895,1197276,1783171,1569.93,261.46,1831.39
2022-02-04 20:00:00+08,8,9,17,585895,1009776,1595671,1230.67,198.68,1429.35
2022-02-05 00:00:00+08,7,9,16,568738,895098,1463836,1320.5,152.87,1473.37
2022-02-05 04:00:00+08,7,10,17,568738,912255,1480993,1373.78,191.65,1565.43
2022-02-05 08:00:00+08,7,12,19,568738,1128575,1697313,1401.79,234.47,1636.26
2022-02-05 12:00:00+08,7,12,19,568738,1228603,1797341,1429.75,248.46,1678.21
2022-02-05 16:00:00+08,7,11,18,568738,1126756,1695494,1457.76,264.24,1722
2022-02-05 20:00:00+08,7,11,18,568738,1039023,1607761,1485.74,225.32,1711.06
2022-02-06 00:00:00+08,6,10,16,518131,988326,1506457,1197.59,241.38,1438.97
2022-02-06 04:00:00+08,5,12,17,399296,1065801,1465097,1075.72,287.33,1363.05
2022-02-06 08:00:00+08,6,11,17,545887,1063831,1609718,1013.27,250.66,1263.93
2022-02-06 12:00:00+08,7,12,19,557705,1125440,1683145,1038.76,298.21,1336.97
2022-02-06 16:00:00+08,7,11,18,557705,1058170,1615875,1066.77,313.76,1380.53
2022-02-06 20:00:00+08,6,12,18,545887,1071798,1617685,1093.64,302.1,1395.74
2022-02-07 00:00:00+08,6,11,17,545887,924777,1470664,1117.63,292.76,1410.39
2022-02-07 04:00:00+08,7,12,19,659826,1160064,1819890,1144.43,313.89,1458.32
2022-02-07 08:00:00+08,8,12,20,732808,1166521,1899329,1167.29,349.28,1516.57
2022-02-07 12:00:00+08,8,12,20,732808,1166521,1899329,1199.29,397.28,1596.57
2022-02-07 16:00:00+08,8,10,18,644417,911098,1555515,1113.97,283.77,1397.74
2022-02-07 20:00:00+08,9,6,15,662692,648291,1310983,1146.84,203.08,1349.92
2022-02-08 00:00:00+08,10,6,16,808252,648291,1456543,1185.83,227.08,1412.91
2022-02-08 04:00:00+08,9,7,16,789977,794882,1584859,1260.27,253.39,1513.66
2022-02-08 08:00:00+08,10,7,17,929312,794882,1724194,1296.77,281.39,1578.16
2022-02-08 12:00:00+08,10,6,16,929312,744275,1673587,1255.36,250.47,1505.83
2022-02-08 16:00:00+08,9,6,15,871112,744275,1615387,1268.51,274.47,1542.98
2022-02-08 20:00:00+08,8,7,15,798130,737641,1535771,1265.3,255.59,1520.89
2022-02-09 00:00:00+08,9,8,17,903137,795361,1698498,1328.83,237.43,1566.26
2022-02-09 04:00:00+08,9,9,18,903137,868343,1771480,1408.37,273.1,1681.47
2022-02-09 08:00:00+08,9,11,20,903137,982826,1885963,1444.36,313.93,1758.29
2022-02-09 12:00:00+08,9,10,19,903137,898055,1801192,1480.37,341.75,1822.12
2022-02-09 16:00:00+08,8,9,17,823257,749005,1572262,1232.13,275.36,1507.49
2022-02-09 20:00:00+08,9,7,16,953830,563006,1516836,1035.37,203.62,1238.99
2022-02-10 00:00:00+08,9,11,20,953830,886324,1840154,1360.05,242.6,1602.65
2022-02-10 04:00:00+08,9,14,23,953830,1078849,2032679,1396.07,291.56,1687.63
2022-02-10 08:00:00+08,12,14,26,1226355,1078849,2305204,1442.46,347.56,1790.02
2022-02-10 12:00:00+08,12,13,25,1226355,1065046,2291401,1490.46,374.19,1864.65
2022-02-10 16:00:00+08,13,12,25,1267494,1006278,2273772,1538.82,406.77,1945.59
2022-02-10 20:00:00+08,13,11,24,1267494,990584,2258078,1590.87,349.72,1940.59
2022-02-11 00:00:00+08,13,13,26,1267494,1181508,2449002,1599.26,353.81,1953.07
2022-02-11 04:00:00+08,12,11,23,1121934,985873,2107807,1572.33,282.99,1855.32
2022-02-11 08:00:00+08,13,13,26,1194381,1138317,2332698,1704.01,331.58,2035.59
2022-02-11 12:00:00+08,13,12,25,1194381,1080117,2274498,1724.83,319.86,2044.69
2022-02-11 16:00:00+08,12,11,23,1086878,933526,2020404,1504.78,281.53,1786.31
2022-02-11 20:00:00+08,12,9,21,1086878,688907,1775785,1552.83,219.43,1772.26
2022-02-12 00:00:00+08,12,11,23,1086878,864448,1951326,1834.89,212.66,2047.55
2022-02-12 04:00:00+08,11,12,23,981871,1029986,2011857,1806.5,259.35,2065.85
2022-02-12 08:00:00+08,11,11,22,981871,998447,1980318,1929.83,238.01,2167.84
2022-02-12 12:00:00+08,11,9,20,981871,861521,1843392,1973.85,200.79,2174.64
2022-02-12 16:00:00+08,10,8,18,931783,854637,1786420,1748.64,201.25,1949.89
2022-02-12 20:00:00+08,9,9,18,837122,1039469,1876591,1566.87,189.9,1756.77
2022-02-13 00:00:00+08,8,13,21,769958,1255902,2025860,1592.46,239.47,1831.93
2022-02-13 04:00:00+08,8,10,18,769958,1012245,1782203,1253.7,160.07,1413.77
2022-02-13 08:00:00+08,8,11,19,769958,1079409,1849367,1575.21,203.23,1778.44
2022-02-13 12:00:00+08,8,11,19,769958,1079409,1849367,1607.21,247.23,1854.44
2022-02-13 16:00:00+08,7,11,18,684443,1179386,1863829,1555.27,272.43,1827.7
2022-02-13 20:00:00+08,9,11,20,843559,1185458,2029017,1674.2,267.99,1942.19
2022-02-14 00:00:00+08,8,11,19,775363,1238231,2013594,1344.14,288.39,1632.53
2022-02-14 04:00:00+08,9,11,20,842943,1238231,2081174,1379.92,332.39,1712.31
2022-02-14 08:00:00+08,9,10,19,842943,1130728,1973671,1181.85,317.68,1499.53
2022-02-14 12:00:00+08,8,10,18,792254,1114141,1906395,1301.54,319.29,1620.83
2022-02-14 16:00:00+08,7,9,16,652919,1005371,1658290,1181.01,315.42,1496.43
2022-02-14 20:00:00+08,6,10,16,522346,1042139,1564485,1112.04,303.91,1415.95
2022-02-15 00:00:00+08,6,9,15,522346,956624,1478970,1048.23,315.81,1364.04
2022-02-15 04:00:00+08,7,10,17,552596,1114694,1667290,1186.52,310.28,1496.8
2022-02-15 08:00:00+08,8,10,18,656953,1114694,1771647,1216.13,350.28,1566.41
2022-02-15 12:00:00+08,8,10,18,633361,1114694,1748055,1208.71,390.28,1598.99
2022-02-15 16:00:00+08,8,10,18,633361,1114694,1748055,1240.71,430.28,1670.99
2022-02-15 20:00:00+08,7,9,16,548526,996205,1544731,1215.59,288.93,1504.52
2022-02-16 00:00:00+08,8,11,19,653375,1134279,1787654,1430.31,272.14,1702.45
2022-02-16 04:00:00+08,7,10,17,548526,1031418,1579944,1455.37,260.78,1716.15
2022-02-16 08:00:00+08,8,11,19,589004,1136267,1725271,1496.01,303.04,1799.05
2022-02-16 12:00:00+08,8,10,18,589004,1068071,1657075,1426.33,296.93,1723.26
2022-02-16 16:00:00+08,6,9,15,480946,983236,1464182,1374.51,315.46,1689.97
2022-02-16 20:00:00+08,6,10,16,480946,982867,1463813,1431.34,329.18,1760.52
2022-02-17 00:00:00+08,6,12,18,480946,1118876,1599822,1455.35,374.17,1829.52
2022-02-17 04:00:00+08,5,10,15,376589,882082,1258671,1433.68,268.06,1701.74
2022-02-17 08:00:00+08,6,11,17,489801,986439,1476240,1502.77,309.65,1812.42
2022-02-17 12:00:00+08,6,11,17,489801,986439,1476240,1526.77,353.65,1880.42
2022-02-17 16:00:00+08,6,8,14,489801,749521,1239322,1260.14,246.16,1506.3
2022-02-17 20:00:00+08,6,10,16,489801,849088,1338889,1217.37,254.09,1471.46
2022-02-18 00:00:00+08,6,11,17,489801,956613,1446414,1114.71,163.85,1278.56
2022-02-18 04:00:00+08,6,11,17,489801,981842,1471643,1138.7,178.89,1317.59
2022-02-18 08:00:00+08,6,13,19,489801,1005723,1495524,1153.98,180.15,1334.13
2022-02-18 12:00:00+08,6,13,19,489801,1005723,1495524,1177.98,232.15,1410.13
2022-02-18 16:00:00+08,6,13,19,489801,1005723,1495524,1201.98,284.15,1486.13
2022-02-18 20:00:00+08,7,13,20,516451,1005723,1522174,1227.55,336.15,1563.7
2022-02-19 00:00:00+08,5,9,14,376589,734923,1111512,1160.85,263.04,1423.89
2022-02-19 04:00:00+08,5,9,14,376589,668032,1044621,1189.34,268.68,1458.02
2022-02-19 08:00:00+08,5,10,15,376589,781244,1157833,1255.06,307.98,1563.04
2022-02-19 12:00:00+08,6,8,14,492289,723491,1215780,1277.71,277.17,1554.88
2022-02-19 16:00:00+08,5,5,10,373475,502083,875558,1075.01,186.53,1261.54
2022-02-19 20:00:00+08,4,7,11,257775,693354,951129,1130.86,115.49,1246.35
2022-02-20 00:00:00+08,4,9,13,257775,968552,1226327,1160.24,102.8,1263.04
2022-02-20 04:00:00+08,5,10,15,373875,1069752,1443627,1179.56,142.55,1322.11
2022-02-20 08:00:00+08,5,11,16,373875,1213895,1587770,1199.56,185.47,1385.03
2022-02-20 12:00:00+08,5,11,16,373875,1213895,1587770,1219.56,229.47,1449.03
2022-02-20 16:00:00+08,5,10,15,373875,1187245,1561120,1231.04,236.42,1467.46
2022-02-20 20:00:00+08,5,9,14,373875,1074033,1447908,1205.33,237.11,1442.44
2022-02-21 00:00:00+08,5,9,14,373875,1074033,1447908,1225.33,273.11,1498.44
2022-02-21 04:00:00+08,5,9,14,373875,1074033,1447908,1245.33,309.11,1554.44
2022-02-21 08:00:00+08,7,10,17,634490,1125855,1760345,1266.85,346.9,1613.75
2022-02-21 12:00:00+08,9,10,19,838537,1125855,1964392,1298.95,386.9,1685.85
2022-02-21 16:00:00+08,9,9,18,838537,1030045,1868582,1334.93,344.26,1679.19
2022-02-21 20:00:00+08,10,7,17,943895,735385,1679280,1374.25,283.5,1657.75
2022-02-22 00:00:00+08,10,8,18,943895,777308,1721203,1400.79,270.1,1670.89
2022-02-22 04:00:00+08,9,8,17,829787,859476,1689263,1420.08,247.91,1667.99
2022-02-22 08:00:00+08,9,9,18,829787,920944,1750731,1456.08,281.24,1737.32
2022-02-22 12:00:00+08,9,9,18,829787,940423,1770210,1517.07,304.95,1822.02
2022-02-22 16:00:00+08,8,9,17,713687,940423,1654110,1489.78,340.95,1830.73
2022-02-22 20:00:00+08,9,11,20,765466,1141211,1906677,1592.4,377.44,1969.84
2022-02-23 00:00:00+08,9,12,21,765466,1175525,1940991,1628.41,421.96,2050.37
2022-02-23 04:00:00+08,9,11,20,765466,1141658,1907124,1664.4,403.6,2068
2022-02-23 08:00:00+08,11,11,22,918032,1141658,2059690,1702.04,447.6,2149.64
2022-02-23 12:00:00+08,11,9,20,876883,977464,1854347,1696.17,368.07,2064.24
2022-02-23 16:00:00+08,10,7,17,811718,858462,1670180,1687.38,367.1,2054.48
2022-02-23 20:00:00+08,10,10,20,811718,994411,1806129,1783.83,303.55,2087.38
2022-02-24 00:00:00+08,10,9,19,811718,849174,1660892,1823.83,297.55,2121.38
2022-02-24 04:00:00+08,10,10,20,811718,1006250,1817968,1863.83,333.57,2197.4
2022-02-24 08:00:00+08,11,12,23,953740,1066985,2020725,1812.97,297.17,2110.14
2022-02-24 12:00:00+08,12,12,24,1004515,1066985,2071500,1857.17,345.17,2202.34
2022-02-24 16:00:00+08,11,12,23,900255,1066985,1967240,1148.54,393.17,1541.71
2022-02-24 20:00:00+08,11,11,22,900255,1059585,1959840,1562.63,381.49,1944.12
2022-02-25 00:00:00+08,13,13,26,983349,1050882,2034231,1724.94,197.56,1922.5
2022-02-25 04:00:00+08,14,15,29,1088894,1204273,2293167,1872.53,253.6,2126.13
2022-02-25 08:00:00+08,14,15,29,1088894,1204273,2293167,1928.53,313.6,2242.13
2022-02-25 12:00:00+08,14,15,29,1088894,1306170,2395064,1984.48,345.64,2330.12
2022-02-25 16:00:00+08,14,12,26,1088894,1070568,2159462,2040.52,279.71,2320.23
2022-02-25 20:00:00+08,15,13,28,1152294,1187128,2339422,2097.4,307.77,2405.17
2022-02-26 00:00:00+08,15,13,28,1152294,1187128,2339422,2157.4,359.77,2517.17
2022-02-26 04:00:00+08,16,13,29,1259776,1075228,2335004,2221.16,368.02,2589.18
2022-02-26 08:00:00+08,16,12,28,1259776,1013402,2273178,2285.17,313.31,2598.48
2022-02-26 12:00:00+08,16,10,26,1259776,886457,2146233,2005.81,284.37,2290.18
2022-02-26 16:00:00+08,12,6,18,1076522,694788,1771310,1360,204.3,1564.3
2022-02-26 20:00:00+08,11,8,19,1025704,808184,1833888,1004.3,148.39,1152.69
2022-02-27 00:00:00+08,11,11,22,1025704,961699,1987403,1760.08,190.38,1950.46
2022-02-27 04:00:00+08,11,12,23,1025704,1012799,2038503,1804.05,238.22,2042.27
2022-02-27 08:00:00+08,12,11,23,1111594,919401,2030995,1851.49,248.88,2100.37
2022-02-27 12:00:00+08,12,11,23,1111594,919401,2030995,1899.49,292.88,2192.37
2022-02-27 16:00:00+08,11,9,20,1045657,834076,1879733,1834.69,281.01,2115.7
2022-02-27 20:00:00+08,10,8,18,964486,681787,1646273,1745.52,268.8,2014.32
2022-02-28 00:00:00+08,11,7,18,1068154,651537,1719691,1506.66,273.59,1780.25
2022-02-28 04:00:00+08,11,8,19,1068154,756061,1824215,1663.78,279.83,1943.61
2022-02-28 08:00:00+08,11,8,19,1068154,756061,1824215,1707.78,311.83,2019.61
2022-02-28 12:00:00+08,12,5,17,1209510,605985,1815495,1324.73,247.3,1572.03
2022-02-28 16:00:00+08,11,5,16,1158735,605985,1764720,1272.52,267.3,1539.82
2022-02-28 20:00:00+08,11,4,15,1158735,448909,1607644,1316.52,175.28,1491.8
2022-03-01 00:00:00+08,10,6,16,1053190,610071,1663261,1369.19,196.44,1565.63
2022-03-01 04:00:00+08,11,5,16,1170426,471644,1642070,1299.17,168.24,1467.41
2022-03-01 08:00:00+08,11,7,18,1170426,726181,1896607,1443.83,191.89,1635.72
2022-03-01 12:00:00+08,11,7,18,1170426,759552,1929978,1487.82,211.43,1699.25
2022-03-01 16:00:00+08,11,7,18,1170426,759552,1929978,1531.82,239.43,1771.25
2022-03-01 20:00:00+08,8,6,14,874407,656750,1531157,809.65,132.17,941.82
2022-03-02 00:00:00+08,8,9,17,874407,1047781,1922188,1245.18,161.24,1406.42
2022-03-02 04:00:00+08,9,11,20,945783,1202319,2148102,1454.68,201.01,1655.69
2022-03-02 08:00:00+08,10,11,21,1111205,1202319,2313524,1492.78,245.01,1737.79
2022-03-02 12:00:00+08,10,11,21,1111205,1202319,2313524,1532.78,289.01,1821.79
2022-03-02 16:00:00+08,11,10,21,1213623,1107839,2321462,1573.99,311.5,1885.49
2022-03-02 20:00:00+08,10,11,21,1096387,1133859,2230246,1574.98,351.74,1926.72
2022-03-03 00:00:00+08,11,10,21,1199954,1082080,2282034,1441.18,372.12,1813.3
2022-03-03 04:00:00+08,12,12,24,1259224,1234020,2493244,1536.67,417.31,1953.98
2022-03-03 08:00:00+08,11,10,21,1117202,997354,2114556,1407.66,284.99,1692.65
2022-03-03 12:00:00+08,11,10,21,1117202,1113356,2230558,1624.2,309.63,1933.83
2022-03-03 16:00:00+08,11,9,20,1117202,964364,2081566,1668.24,292.88,1961.12
2022-03-03 20:00:00+08,11,10,21,1117202,1076880,2194082,1712.26,329.74,2042
2022-03-04 00:00:00+08,11,8,19,1117202,936631,2053833,1655.59,280.66,1936.25
2022-03-04 04:00:00+08,10,9,19,1031312,901591,1932903,1580.1,242.25,1822.35
2022-03-04 08:00:00+08,10,12,22,1031312,1160081,2191393,1741.81,282.39,2024.2
2022-03-04 12:00:00+08,9,11,20,865890,1054723,1920613,1530.39,268.38,1798.77
2022-03-04 16:00:00+08,7,8,15,654740,656534,1311274,1084.96,160.45,1245.41
2022-03-04 20:00:00+08,6,10,16,583345,928195,1511540,1058.56,153.94,1212.5
2022-03-05 00:00:00+08,7,13,20,687036,1224933,1911969,1205.61,199.86,1405.47
2022-03-05 04:00:00+08,7,14,21,687036,1296328,1983364,1466.67,255.73,1722.4
2022-03-05 08:00:00+08,7,14,21,687036,1296328,1983364,1494.67,311.73,1806.4
2022-03-05 12:00:00+08,8,12,20,818322,1203554,2021876,1403.11,302.67,1705.78
2022-03-05 16:00:00+08,8,12,20,818322,1203554,2021876,1435.11,350.67,1785.78
2022-03-05 20:00:00+08,7,9,16,712964,956239,1669203,1216.15,234.46,1450.61
2022-03-06 00:00:00+08,9,9,18,867164,934051,1801215,1504.47,221.12,1725.59
2022-03-06 04:00:00+08,9,11,20,867164,1175962,2043126,1540.47,263.87,1804.34
2022-03-06 08:00:00+08,11,11,22,1028460,1175962,2204422,1582.52,307.87,1890.39
2022-03-06 12:00:00+08,11,10,21,1028460,1104567,2133027,1393.53,316.01,1709.54
2022-03-06 16:00:00+08,10,8,18,897174,892003,1789177,1244.04,254.51,1498.55
2022-03-06 20:00:00+08,9,8,17,879938,840142,1720080,1128.91,161.61,1290.52
2022-03-07 00:00:00+08,9,7,16,824402,736474,1560876,888.77,142.33,1031.1
2022-03-07 04:00:00+08,9,9,18,854844,914004,1768848,986.79,150.43,1137.22
2022-03-07 08:00:00+08,9,10,19,854844,985380,1840224,1146.94,188.12,1335.06
2022-03-07 12:00:00+08,9,10,19,854844,985380,1840224,1182.94,228.12,1411.06
2022-03-07 16:00:00+08,9,8,17,854844,926561,1781405,1198.9,232.3,1431.2
2022-03-07 20:00:00+08,10,8,18,927291,961269,1888560,1238.46,239.87,1478.33
2022-03-08 00:00:00+08,12,8,20,1032430,912499,1944929,1284.67,227.87,1512.54
2022-03-08 04:00:00+08,12,9,21,1032430,1028492,2060922,1332.65,261.06,1593.71
2022-03-08 08:00:00+08,12,11,23,1032430,1105992,2138422,1380.69,300.48,1681.17
2022-03-08 12:00:00+08,12,10,22,1032430,1002219,2034649,1428.69,309.07,1737.76
2022-03-08 16:00:00+08,12,10,22,1032430,1002219,2034649,1476.69,349.07,1825.76
2022-03-08 20:00:00+08,12,9,21,1032430,870933,1903363,1492.88,338.76,1831.64
2022-03-09 00:00:00+08,11,8,19,928762,822234,1750996,1345.92,304.79,1650.71
2022-03-09 04:00:00+08,10,9,19,901891,871240,1773131,1437.32,308.91,1746.23
2022-03-09 08:00:00+08,9,9,18,851359,897917,1749276,1139.31,264.9,1404.21
2022-03-09 12:00:00+08,9,11,20,851359,975320,1826679,1294.8,306.88,1601.68
2022-03-09 16:00:00+08,8,9,17,749541,808638,1558179,1267.69,281.18,1548.87
2022-03-09 20:00:00+08,8,8,16,749541,776389,1525930,1296.15,258.18,1554.33
2022-03-10 00:00:00+08,10,11,21,965485,1061508,2026993,1401.13,300.4,1701.53
2022-03-10 04:00:00+08,9,9,18,866636,842442,1709078,1375.92,186.46,1562.38
2022-03-10 08:00:00+08,9,11,20,866636,1054363,1920999,1418.74,225.86,1644.6
2022-03-10 12:00:00+08,9,12,21,866636,1194509,2061145,1454.74,273.28,1728.02
2022-03-10 16:00:00+08,6,12,18,643278,1178139,1821417,1064.41,294.08,1358.49
2022-03-10 20:00:00+08,6,11,17,643278,1134227,1777505,1146.49,284.12,1430.61
2022-03-11 00:00:00+08,8,11,19,711659,1089829,1801488,1282.77,287.4,1570.17
2022-03-11 04:00:00+08,8,12,20,711659,1059281,1770940,1393.53,302.78,1696.31
2022-03-11 08:00:00+08,7,12,19,693384,1173085,1866469,1415.03,334.83,1749.86
2022-03-11 12:00:00+08,7,13,20,693384,1140156,1833540,1453.89,348.77,1802.66
2022-03-11 16:00:00+08,6,12,18,589693,1038338,1628031,1251.64,357.04,1608.68
2022-03-11 20:00:00+08,6,13,19,589693,1151491,1741184,1264.77,394.58,1659.35
2022-03-12 00:00:00+08,6,13,19,503336,1113826,1617162,1245.43,331.96,1577.39
2022-03-12 04:00:00+08,6,15,21,503336,1377942,1881278,1323.86,387.49,1711.35
2022-03-12 08:00:00+08,6,14,20,503336,1318672,1822008,1160.28,411.59,1571.87
2022-03-12 12:00:00+08,6,13,19,503336,1311788,1815124,1184.28,434.29,1618.57
2022-03-12 16:00:00+08,7,13,20,648863,1290171,1939034,1210.22,468.47,1678.69
2022-03-12 20:00:00+08,7,13,20,648863,1276633,1925496,1159.43,482,1641.43
2022-03-13 00:00:00+08,9,13,22,842556,1276633,2119189,1191.73,534,1725.73
2022-03-13 04:00:00+08,9,13,22,842556,1276633,2119189,1227.75,586.02,1813.77
2022-03-13 08:00:00+08,9,12,21,842556,1260236,2102792,1263.75,592.17,1855.92
2022-03-13 12:00:00+08,9,12,21,842556,1260236,2102792,1299.75,640.17,1939.92
2022-03-13 16:00:00+08,9,11,20,842556,1218653,2061209,1335.75,661.64,1997.39
2022-03-13 20:00:00+08,9,10,19,842556,1077718,1920274,1371.71,569.31,1941.02
2022-03-14 00:00:00+08,9,10,19,842556,1071558,1914114,1407.63,521.26,1928.89
2022-03-14 04:00:00+08,9,10,19,842556,1096339,1938895,1269.02,417.85,1686.87
2022-03-14 08:00:00+08,10,10,20,872761,1096339,1969100,1307.89,457.85,1765.74
2022-03-14 12:00:00+08,10,8,18,872761,839098,1711859,1293.48,341.33,1634.81
2022-03-14 16:00:00+08,8,8,16,739837,839098,1578935,1027.45,373.33,1400.78
2022-03-14 20:00:00+08,8,10,18,739837,1003757,1743594,1217.03,287.64,1504.67
2022-03-15 00:00:00+08,7,11,18,709632,984171,1693803,1318.13,307.73,1625.86
2022-03-15 04:00:00+08,7,11,18,709632,984171,1693803,1346.13,351.73,1697.86
2022-03-15 08:00:00+08,7,11,18,709632,984171,1693803,1374.13,395.73,1769.86
2022-03-15 12:00:00+08,8,11,19,769115,984171,1753286,1404.45,439.73,1844.18
2022-03-15 16:00:00+08,6,10,16,615442,928870,1544312,1018.45,438.33,1456.78
2022-03-15 20:00:00+08,7,10,17,759573,991094,1750667,1426.14,274,1700.14
2022-03-16 00:00:00+08,7,11,18,759573,1118659,1878232,1384.44,200.6,1585.04
2022-03-16 04:00:00+08,6,11,17,666028,1102257,1768285,1354.85,216.41,1571.26
2022-03-16 08:00:00+08,6,11,17,666028,1032541,1698569,1421.02,153.21,1574.23
2022-03-16 12:00:00+08,7,12,19,751465,1137193,1888658,1446.42,199.11,1645.53
2022-03-16 16:00:00+08,7,12,19,751465,1137193,1888658,1474.42,247.11,1721.53
2022-03-16 20:00:00+08,7,11,18,751465,962446,1713911,1502.41,223.39,1725.8
2022-03-17 00:00:00+08,8,12,20,801997,1014607,1816604,1533.34,271.14,1804.48
2022-03-17 04:00:00+08,8,11,19,861585,964501,1826086,1226.64,285.81,1512.45
2022-03-17 08:00:00+08,7,9,16,729550,822780,1552330,1251.03,279.15,1530.18
2022-03-17 12:00:00+08,7,12,19,729550,1126229,1855779,1520.61,321.86,1842.47
2022-03-17 16:00:00+08,7,10,17,729550,1000268,1729818,1548.61,306.5,1855.11
2022-03-17 20:00:00+08,7,12,19,696473,1077294,1773767,1544.69,311.64,1856.33
2022-03-18 00:00:00+08,7,10,17,696473,880182,1576655,1220.65,266.43,1487.08
2022-03-18 04:00:00+08,7,12,19,696473,1022966,1719439,1288.76,266.9,1555.66
2022-03-18 08:00:00+08,7,13,20,696473,1029850,1726323,1316.76,316.27,1633.03
2022-03-18 12:00:00+08,5,13,18,534572,1029850,1564422,889.24,368.27,1257.51
2022-03-18 16:00:00+08,5,10,15,534572,939021,1473593,909.24,354.72,1263.96
2022-03-18 20:00:00+08,5,9,14,534572,834369,1368941,929.24,336.84,1266.08
2022-03-19 00:00:00+08,6,14,20,597579,1113297,1710876,1209.08,249.66,1458.74
2022-03-19 04:00:00+08,7,14,21,743139,1113297,1856436,1233.64,305.66,1539.3
2022-03-19 08:00:00+08,7,14,21,743139,1113297,1856436,1261.64,361.66,1623.3
2022-03-19 12:00:00+08,6,13,19,690779,1106413,1797192,1248.08,388.29,1636.37
2022-03-19 16:00:00+08,6,13,19,670700,1062670,1733370,1250.61,402.05,1652.66
2022-03-19 20:00:00+08,7,13,20,765180,1062670,1827850,1278.5,454.05,1732.55
2022-03-20 00:00:00+08,7,8,15,765180,738434,1503614,992.45,303.51,1295.96
2022-03-20 04:00:00+08,6,9,15,670700,861165,1531865,1097.42,258.06,1355.48
2022-03-20 08:00:00+08,7,10,17,812728,891400,1704128,1124.25,297.18,1421.43
2022-03-20 12:00:00+08,7,10,17,812728,891400,1704128,1152.25,337.18,1489.43
2022-03-20 16:00:00+08,7,10,17,812728,891400,1704128,1180.25,377.18,1557.43
2022-03-20 20:00:00+08,7,9,16,783194,743825,1527019,970.09,271.55,1241.64
2022-03-21 00:00:00+08,7,9,16,783194,648252,1431446,998.04,260.24,1258.28
2022-03-21 04:00:00+08,6,10,16,720187,793779,1513966,1174.14,300.1,1474.24
2022-03-21 08:00:00+08,6,9,15,720187,676085,1396272,1080.26,233.83,1314.09
2022-03-21 12:00:00+08,6,9,15,720187,746622,1466809,1162.72,210.53,1373.25
2022-03-21 16:00:00+08,6,9,15,720187,746622,1466809,1186.72,246.53,1433.25
2022-03-21 20:00:00+08,5,9,14,576056,768135,1344191,1053.73,244.66,1298.39
2022-03-22 00:00:00+08,7,9,16,707943,852187,1560130,684.46,208.88,893.34
2022-03-22 04:00:00+08,7,10,17,707943,1079890,1787833,863.11,230.09,1093.2
2022-03-22 08:00:00+08,8,11,19,825723,1148253,1973976,892.27,272.44,1164.71
2022-03-22 12:00:00+08,7,10,17,680163,1020893,1701056,843.68,228.49,1072.17
2022-03-22 16:00:00+08,7,10,17,680163,1020926,1701089,752.82,230.07,982.89
2022-03-22 20:00:00+08,7,10,17,680163,1022479,1702642,780.87,206.34,987.21
2022-03-23 00:00:00+08,7,10,17,680163,1022479,1702642,808.87,246.34,1055.21
2022-03-23 04:00:00+08,6,10,16,649710,1022479,1672189,751.16,286.34,1037.5
2022-03-23 08:00:00+08,7,9,16,766773,921562,1688335,804.86,254.86,1059.72
2022-03-23 12:00:00+08,7,8,15,766773,898419,1665192,832.85,209.12,1041.97
2022-03-23 16:00:00+08,7,9,16,766773,983124,1749897,860.86,243.96,1104.82
2022-03-23 20:00:00+08,7,9,16,751754,911673,1663427,851.81,225.26,1077.07
2022-03-24 00:00:00+08,6,10,16,635761,1019400,1655161,753.55,192.99,946.54
2022-03-24 04:00:00+08,6,11,17,635761,983627,1619388,777.56,185.59,963.15
2022-03-24 08:00:00+08,6,12,18,635761,1099620,1735381,885.35,233.4,1118.75
2022-03-24 12:00:00+08,8,11,19,834865,1048826,1883691,914.6,240.81,1155.41
2022-03-24 16:00:00+08,6,10,16,585513,964121,1549634,920.53,257.98,1178.51
2022-03-24 20:00:00+08,6,11,17,585513,974018,1559531,944.53,275.81,1220.34
2022-03-25 00:00:00+08,6,11,17,502693,1072669,1575362,965.63,264.82,1230.45
2022-03-25 04:00:00+08,7,10,17,560523,927109,1487632,907.59,247.4,1154.99
2022-03-25 08:00:00+08,7,12,19,560523,1051056,1611579,981.6,291.18,1272.78
2022-03-25 12:00:00+08,7,11,18,560523,1000449,1560972,1009.59,299.21,1308.8
2022-03-25 16:00:00+08,7,10,17,560523,884456,1444979,953.81,307.39,1261.2
2022-03-25 20:00:00+08,7,9,16,560523,876141,1436664,981.86,279.01,1260.87
2022-03-26 00:00:00+08,8,11,19,617720,1111766,1729486,1010.67,316.89,1327.56
2022-03-26 04:00:00+08,8,11,19,617720,1111766,1729486,1042.67,360.89,1403.56
2022-03-26 08:00:00+08,8,12,20,617720,1312140,1929860,1074.65,370.9,1445.55
2022-03-26 12:00:00+08,8,10,18,617720,1052016,1669736,955.98,254.1,1210.08
2022-03-26 16:00:00+08,8,9,17,617720,1045132,1662852,987.97,261.08,1249.05
2022-03-26 20:00:00+08,8,11,19,617720,1222434,1840154,993.81,257.46,1251.27
2022-03-27 00:00:00+08,8,11,19,617720,1184534,1802254,985.11,229.48,1214.59
2022-03-27 04:00:00+08,9,11,20,689096,1184534,1873630,1020.16,273.48,1293.64
2022-03-27 08:00:00+08,9,10,19,689096,1182524,1871620,1056.18,260.19,1316.37
2022-03-27 12:00:00+08,9,10,19,689096,1182524,1871620,1092.18,300.19,1392.37
2022-03-27 16:00:00+08,9,10,19,689096,1161120,1850216,1128.18,321.21,1449.39
2022-03-27 20:00:00+08,9,10,19,689096,1111875,1800971,1164.21,310.99,1475.2
2022-03-28 00:00:00+08,9,10,19,689096,1111875,1800971,1200.21,350.99,1551.2
2022-03-28 04:00:00+08,10,9,19,723291,1087937,1811228,1238.39,321.54,1559.93
2022-03-28 08:00:00+08,10,8,18,723291,942700,1665991,1278.36,301.16,1579.52
2022-03-28 12:00:00+08,8,7,15,617672,796109,1413781,1187.53,245.52,1433.05
2022-03-28 16:00:00+08,7,8,15,565159,870614,1435773,1116.21,273.79,1390
2022-03-28 20:00:00+08,8,11,19,711931,1028746,1740677,1385.47,310.04,1695.51
2022-03-29 00:00:00+08,8,11,19,711931,1028746,1740677,1417.47,354.04,1771.51
2022-03-29 04:00:00+08,8,11,19,711931,1028746,1740677,1449.47,398.04,1847.51
2022-03-29 08:00:00+08,10,10,20,950883,897388,1848271,1484.55,392.28,1876.83
2022-03-29 12:00:00+08,9,9,18,851933,826012,1677945,1219.98,415.65,1635.63
2022-03-29 16:00:00+08,8,6,14,817738,599530,1417268,1126.19,325.39,1451.58
2022-03-29 20:00:00+08,9,8,17,903540,684728,1588268,1427.41,201.03,1628.44
2022-03-30 00:00:00+08,10,10,20,1005257,795436,1800693,1490.35,237.07,1727.42
2022-03-30 04:00:00+08,10,8,18,1005257,640062,1645319,1424.84,186.35,1611.19
2022-03-30 08:00:00+08,10,8,18,1005257,640062,1645319,1464.84,218.35,1683.19
2022-03-30 12:00:00+08,9,8,17,889264,591048,1480312,1475.54,149.73,1625.27
2022-03-30 16:00:00+08,6,7,13,561703,599850,1161553,1145.31,143.27,1288.58
2022-03-30 20:00:00+08,6,8,14,561703,732152,1293855,1252.35,123.33,1375.68
2022-03-31 00:00:00+08,7,11,18,689063,1026264,1715327,1326.91,163.57,1490.48
2022-03-31 04:00:00+08,7,11,18,689063,1026264,1715327,1354.91,207.57,1562.48
2022-03-31 08:00:00+08,6,11,17,594519,1026264,1620783,1123.16,251.57,1374.73
2022-03-31 12:00:00+08,6,11,17,594519,1002475,1596994,1376.11,228.82,1604.93
2022-03-31 16:00:00+08,6,10,16,594519,952082,1546601,1360.31,209.81,1570.12
2022-03-31 20:00:00+08,6,13,19,594519,1171768,1766287,1384.32,252.06,1636.38
2022-04-01 00:00:00+08,6,13,19,594519,1182970,1777489,1408.28,278.88,1687.16
2022-04-01 04:00:00+08,5,13,18,492802,1138943,1631745,1217.44,301.21,1518.65
2022-04-01 08:00:00+08,5,14,19,492802,1240660,1733462,1317.96,355.6,1673.56
2022-04-01 12:00:00+08,7,13,20,583569,1188510,1772079,1340.56,393.69,1734.25
2022-04-01 16:00:00+08,7,10,17,583569,1045884,1629453,1368.6,334.08,1702.68
2022-04-01 20:00:00+08,7,11,18,583569,987404,1570973,1364.36,323.67,1688.03
2022-04-02 00:00:00+08,7,11,18,583569,1009920,1593489,1392.36,341.12,1733.48
2022-04-02 04:00:00+08,8,10,18,618605,905320,1523925,1423.91,353.59,1777.5
2022-04-02 08:00:00+08,8,11,19,618605,1035775,1654380,1455.95,395.2,1851.15
2022-04-02 12:00:00+08,8,11,19,618605,1035775,1654380,1487.95,439.2,1927.15
2022-04-02 16:00:00+08,8,11,19,618605,1035775,1654380,1519.95,483.2,2003.15
2022-04-02 20:00:00+08,8,10,18,660434,1063000,1723434,1215.42,426.41,1641.83
2022-04-03 00:00:00+08,8,9,17,660434,836749,1497183,1358.64,328.51,1687.15
2022-04-03 04:00:00+08,7,10,17,618460,982963,1601423,1319.84,367.2,1687.04
2022-04-03 08:00:00+08,7,10,17,618460,974308,1592768,1420.89,371.08,1791.97
2022-04-03 12:00:00+08,7,10,17,618460,974308,1592768,1448.89,411.08,1859.97
2022-04-03 16:00:00+08,7,7,14,634511,635094,1269605,1389.48,304.98,1694.46
2022-04-03 20:00:00+08,7,9,16,634511,878361,1512872,1380.87,216.13,1597
2022-04-04 00:00:00+08,7,9,16,674208,813526,1487734,1351.8,143.95,1495.75
2022-04-04 04:00:00+08,6,10,16,641271,882166,1523437,1234.85,156.8,1391.65
2022-04-04 08:00:00+08,6,11,17,641271,915103,1556374,1324.03,200.05,1524.08
2022-04-04 12:00:00+08,6,10,16,641271,880067,1521338,1304.18,228.34,1532.52
2022-04-04 16:00:00+08,5,9,14,520327,840984,1361311,1311.85,248.61,1560.46
2022-04-04 20:00:00+08,5,10,15,520327,926943,1447270,1413.23,174.01,1587.24
2022-04-05 00:00:00+08,5,10,15,520327,1009999,1530326,1367.95,194.79,1562.74
2022-04-05 04:00:00+08,5,10,15,520327,1009345,1529672,1387.96,185.4,1573.36
2022-04-05 08:00:00+08,5,11,16,520327,1053795,1574122,1407.99,191.56,1599.55
2022-04-05 12:00:00+08,7,11,18,599805,1053795,1653600,1433.28,235.56,1668.84
2022-04-05 16:00:00+08,8,9,17,712321,867820,1580141,1464.66,213.63,1678.29
2022-04-05 20:00:00+08,8,11,19,712321,1068747,1781068,1496.68,210.94,1707.62
2022-04-06 00:00:00+08,8,11,19,712321,1068747,1781068,1528.68,254.94,1783.62
2022-04-06 04:00:00+08,7,12,19,570299,1209356,1779655,977,302.12,1279.12
2022-04-06 08:00:00+08,7,10,17,570299,962790,1533089,1004.98,257.25,1262.23
2022-04-06 12:00:00+08,7,10,17,570299,962790,1533089,1032.98,297.25,1330.23
2022-04-06 16:00:00+08,6,9,15,543649,873450,1417099,1481.08,255.49,1736.57
2022-04-06 20:00:00+08,6,10,16,543649,826785,1370434,1508.05,204.64,1712.69
2022-04-07 00:00:00+08,7,11,18,614905,930399,1545304,1532.65,245.42,1778.07
2022-04-07 04:00:00+08,6,12,18,557075,1047250,1604325,1422.41,292.41,1714.82
2022-04-07 08:00:00+08,6,11,17,557075,944190,1501265,1587.4,242.04,1829.44
2022-04-07 12:00:00+08,7,9,16,623622,882902,1506524,1614.29,227.84,1842.13
2022-04-07 16:00:00+08,7,7,14,623622,747611,1371233,1608.58,194.81,1803.39
2022-04-07 20:00:00+08,7,7,14,623622,734031,1357653,1636.56,199.49,1836.05
2022-04-08 00:00:00+08,7,8,15,623622,757390,1381012,1664.56,227.51,1892.07
2022-04-08 04:00:00+08,6,7,13,496262,699560,1195822,1354.89,238.31,1593.2
2022-04-08 08:00:00+08,7,8,15,562956,750092,1313048,1561.04,154.19,1715.23
2022-04-08 12:00:00+08,7,9,16,562956,871026,1433982,1589.02,190.18,1779.2
2022-04-08 16:00:00+08,5,8,13,440613,847667,1288280,1454.44,210.17,1664.61
2022-04-08 20:00:00+08,5,10,15,440613,1016892,1457505,1641.92,223.38,1865.3
2022-04-09 00:00:00+08,5,11,16,440613,1080287,1520900,1661.91,265.21,1927.12
2022-04-09 04:00:00+08,6,13,19,518559,1244247,1762806,1683.2,314.42,1997.62
2022-04-09 08:00:00+08,5,12,17,451865,1227090,1678955,1680.88,340.17,2021.05
2022-04-09 12:00:00+08,5,13,18,451865,1293784,1745649,1728.79,390.58,2119.37
2022-04-09 16:00:00+08,7,11,18,535499,1081919,1617418,1709.3,333.91,2043.21
2022-04-09 20:00:00+08,8,14,22,588287,1418661,2006948,1740.92,367.37,2108.29
2022-04-10 00:00:00+08,8,13,21,588287,1273084,1861371,1772.9,310.9,2083.8
2022-04-10 04:00:00+08,8,14,22,588287,1419507,2007794,1804.91,362.96,2167.87
2022-04-10 08:00:00+08,8,11,19,588287,1184828,1773115,1117.51,247.7,1365.21
2022-04-10 12:00:00+08,8,11,19,588287,1184828,1773115,1149.51,291.7,1441.21
2022-04-10 16:00:00+08,11,11,22,917392,1184828,2102220,1187.94,335.7,1523.64
2022-04-10 20:00:00+08,11,12,23,917392,1269533,2186925,1231.97,382.36,1614.33
2022-04-11 00:00:00+08,11,12,23,917392,1269533,2186925,1275.97,430.36,1706.33
2022-04-11 04:00:00+08,11,11,22,1020583,1142173,2162756,1089.47,408.55,1498.02
2022-04-11 08:00:00+08,11,9,20,1020583,932080,1952663,1170.45,324.58,1495.03
2022-04-11 12:00:00+08,11,8,19,1020583,850618,1871201,1214.43,317.94,1532.37
2022-04-11 16:00:00+08,10,7,17,967146,765913,1733059,1058.82,327.28,1386.1
2022-04-11 20:00:00+08,9,11,20,889200,1036170,1925370,1211.63,229.87,1441.5
2022-04-12 00:00:00+08,10,13,23,982741,1130547,2113288,1320.04,246.7,1566.74
2022-04-12 04:00:00+08,11,13,24,1127083,1130547,2257630,1361.73,298.7,1660.43
2022-04-12 08:00:00+08,11,13,24,1127083,1130547,2257630,1405.73,350.7,1756.43
2022-04-12 12:00:00+08,11,12,23,1127083,1077719,2204802,1297.75,385.36,1683.11
2022-04-12 16:00:00+08,11,8,19,1127083,826101,1953184,1236.23,290.85,1527.08
2022-04-12 20:00:00+08,10,10,20,1033542,1011178,2044720,1256.31,266.28,1522.59
2022-04-13 00:00:00+08,10,9,19,1139512,960796,2100308,1217.56,276.22,1493.78
2022-04-13 04:00:00+08,10,9,19,1139512,1003640,2143152,1232,283.14,1515.14
2022-04-13 08:00:00+08,12,9,21,1287356,1009766,2297122,1363.98,289.42,1653.4
2022-04-13 12:00:00+08,12,10,22,1287356,1044470,2331826,1411.98,325.94,1737.92
2022-04-13 16:00:00+08,13,10,23,1410779,1044470,2455249,1313.36,365.94,1679.3
2022-04-13 20:00:00+08,14,10,24,1440915,1003141,2444056,1490.69,340.07,1830.76
2022-04-14 00:00:00+08,14,11,25,1524668,1056004,2580672,1542.69,380.8,1923.49
2022-04-14 04:00:00+08,13,12,25,1446768,1091426,2538194,1519.77,320.42,1840.19
2022-04-14 08:00:00+08,13,11,24,1446768,980538,2427306,1572.65,281.18,1853.83
2022-04-14 12:00:00+08,12,12,24,1334252,1089308,2423560,1409.37,326.62,1735.99
2022-04-14 16:00:00+08,11,10,21,1178273,896752,2075025,1363.63,207.95,1571.58
2022-04-14 20:00:00+08,10,10,20,1128185,1026493,2154678,1552.52,169.93,1722.45
2022-04-15 00:00:00+08,10,11,21,1128185,1182472,2310657,1685.57,212.83,1898.4
2022-04-15 04:00:00+08,10,13,23,1128185,1246363,2374548,1806.1,264.07,2070.17
2022-04-15 08:00:00+08,9,14,23,1021130,1253247,2274377,1731.83,317.87,2049.7
2022-04-15 12:00:00+08,9,15,24,1021130,1360302,2381432,1883.71,376.26,2259.97
2022-04-15 16:00:00+08,8,12,20,954121,1095365,2049486,1715.91,313.11,2029.02
2022-04-15 20:00:00+08,7,13,20,812093,1256921,2069014,1161.68,344.16,1505.84
2022-04-16 00:00:00+08,7,14,21,812093,1398949,2211042,1830.37,398.28,2228.65
2022-04-16 04:00:00+08,8,14,22,917100,1398949,2316049,1861.71,454.28,2315.99
2022-04-16 08:00:00+08,9,13,22,1014080,1286433,2300513,1675.48,472.11,2147.59
2022-04-16 12:00:00+08,9,13,22,1014080,1372947,2387027,1711.49,498,2209.49
2022-04-16 16:00:00+08,8,9,17,891119,1014197,1905316,1592.93,297.69,1890.62
2022-04-16 20:00:00+08,8,12,20,891119,1342327,2233446,1701.27,339.19,2040.46
2022-04-17 00:00:00+08,9,11,20,976634,1275318,2251952,1681.93,357.47,2039.4
2022-04-17 04:00:00+08,10,10,20,1018755,1197418,2216173,1633.98,331.96,1965.94
2022-04-17 08:00:00+08,10,10,20,1018755,1197418,2216173,1673.98,371.96,2045.94
2022-04-17 12:00:00+08,10,9,19,1018755,1104020,2122775,1713.98,384.26,2098.24
2022-04-17 16:00:00+08,10,9,19,1018755,1104020,2122775,1753.98,420.26,2174.24
2022-04-17 20:00:00+08,12,7,19,1119872,875891,1995763,1798.79,350.26,2149.05
2022-04-18 00:00:00+08,12,7,19,1119872,875891,1995763,1846.79,378.26,2225.05
2022-04-18 04:00:00+08,12,6,18,1119872,767541,1887413,1894.79,349.38,2244.17
2022-04-18 08:00:00+08,13,6,19,1172660,767541,1940201,1945.76,373.38,2319.14
2022-04-18 12:00:00+08,13,6,19,1172660,767541,1940201,1997.76,397.38,2395.14
2022-04-18 16:00:00+08,12,6,18,1130539,767541,1898080,2010.47,421.38,2431.85
2022-04-18 20:00:00+08,12,11,23,1130539,1155207,2285746,2099.44,455.95,2555.39
2022-04-19 00:00:00+08,11,12,23,1063506,1321173,2384679,2009.5,502.08,2511.58
2022-04-19 04:00:00+08,11,12,23,1129532,1321173,2450705,2033.51,550.08,2583.59
2022-04-19 08:00:00+08,11,13,24,1129532,1373961,2503493,2101.54,600.99,2702.53
2022-04-19 12:00:00+08,11,13,24,1129532,1373961,2503493,2145.54,652.99,2798.53
2022-04-19 16:00:00+08,11,13,24,1129532,1373961,2503493,2189.54,704.99,2894.53
2022-04-19 20:00:00+08,11,13,24,1129532,1373961,2503493,2233.54,756.99,2990.53
2022-04-20 00:00:00+08,11,10,21,1129532,1204447,2333979,2236.62,669.62,2906.24
2022-04-20 04:00:00+08,10,10,20,1066532,1186792,2253324,2388.06,674.99,3063.05
2022-04-20 08:00:00+08,9,9,18,947718,1065338,2013056,2433.35,615.56,3048.91
2022-04-20 12:00:00+08,9,9,18,947718,1077097,2024815,2387.07,530.54,2917.61
2022-04-20 16:00:00+08,9,9,18,947718,1077097,2024815,2423.07,566.54,2989.61
2022-04-20 20:00:00+08,9,8,17,904539,946532,1851071,1457.67,341.51,1799.18
2022-04-21 00:00:00+08,9,10,19,904539,1186616,2091155,1770.91,230.15,2001.06
2022-04-21 04:00:00+08,9,10,19,904539,1279418,2183957,1746.57,250.09,1996.66
2022-04-21 08:00:00+08,14,11,25,1211406,1350080,2561486,1791.84,269.1,2060.94
2022-04-21 12:00:00+08,14,11,25,1211406,1350080,2561486,1847.84,313.1,2160.94
2022-04-21 16:00:00+08,12,10,22,1143903,1227119,2371022,1807.36,239.43,2046.79
2022-04-21 20:00:00+08,12,12,24,1143903,1294622,2438525,1878.57,284.39,2162.96
2022-04-22 00:00:00+08,12,12,24,1143903,1294622,2438525,1926.57,332.39,2258.96
2022-04-22 04:00:00+08,12,13,25,1143903,1345491,2489394,1974.54,384.05,2358.59
2022-04-22 08:00:00+08,11,15,26,1063092,1386537,2449629,1802.79,439.07,2241.86
2022-04-22 12:00:00+08,12,14,26,1177200,1359512,2536712,1836.54,481.11,2317.65
2022-04-22 16:00:00+08,11,10,21,1063311,935462,1998773,1510.65,309.07,1819.72
2022-04-22 20:00:00+08,10,11,21,1025194,941426,1966620,1524.23,257.78,1782.01
2022-04-23 00:00:00+08,10,12,22,961269,946229,1907498,1764.52,261.69,2026.21
2022-04-23 04:00:00+08,10,13,23,961269,1009629,1970898,1804.49,313.33,2117.82
2022-04-23 08:00:00+08,10,13,23,961269,1211246,2172515,2011.63,321.64,2333.27
2022-04-23 12:00:00+08,10,13,23,961269,1211246,2172515,2051.63,373.64,2425.27
2022-04-23 16:00:00+08,9,13,22,894105,1244568,2138673,2024.33,381.28,2405.61
2022-04-23 20:00:00+08,8,12,20,808590,1096684,1905274,1861.6,333.62,2195.22
2022-04-24 00:00:00+08,9,13,22,893373,1211246,2104619,2000.89,360.37,2361.26
2022-04-24 04:00:00+08,9,12,21,893373,1101143,1994516,2036.89,379.34,2416.23
2022-04-24 08:00:00+08,9,11,20,893373,1048899,1942272,2072.9,336.49,2409.39
2022-04-24 12:00:00+08,9,11,20,893373,1048899,1942272,2108.9,380.49,2489.39
2022-04-24 16:00:00+08,7,9,16,698590,900680,1599270,1833.94,358.1,2192.04
2022-04-24 20:00:00+08,8,9,17,854441,904652,1759093,1649.52,352.3,2001.82
2022-04-25 00:00:00+08,8,10,18,854441,991541,1845982,1766.84,360.43,2127.27
2022-04-25 04:00:00+08,8,10,18,854441,991541,1845982,1798.84,400.43,2199.27
2022-04-25 08:00:00+08,10,11,21,1028102,1007938,2036040,1832.53,442.85,2275.38
2022-04-25 12:00:00+08,10,9,19,1028102,707986,1736088,1621.33,272.78,1894.11
2022-04-25 16:00:00+08,11,8,19,1185178,657211,1842389,1662.67,274.97,1937.64
2022-04-25 20:00:00+08,9,8,17,986679,591463,1578142,1113.76,191.99,1305.75
2022-04-26 00:00:00+08,10,10,20,1037211,789962,1827173,1499.44,227.31,1726.75
2022-04-26 04:00:00+08,10,10,20,965941,869846,1835787,1527.08,239.62,1766.7
2022-04-26 08:00:00+08,10,10,20,932103,1010525,1942628,1491.42,254.91,1746.33
2022-04-26 12:00:00+08,8,11,19,762991,1124633,1887624,1363.55,297.36,1660.91
2022-04-26 16:00:00+08,9,9,18,882350,1043665,1926015,1381.42,301.32,1682.74
2022-04-26 20:00:00+08,9,11,20,882350,1212920,2095270,1608.41,270.85,1879.26
2022-04-27 00:00:00+08,9,11,20,882350,1212920,2095270,1644.41,314.85,1959.26
2022-04-27 04:00:00+08,9,11,20,882350,1212920,2095270,1680.41,358.85,2039.26
2022-04-27 08:00:00+08,9,11,20,882350,1256078,2138428,1582.35,392.29,1974.64
2022-04-27 12:00:00+08,10,10,20,899507,1149166,2048673,1479.04,418.3,1897.34
2022-04-27 16:00:00+08,9,10,19,743656,1149166,1892822,1448.33,458.3,1906.63
2022-04-27 20:00:00+08,9,11,20,743656,1283315,2026971,1558.9,473.57,2032.47
2022-04-28 00:00:00+08,9,13,22,743656,1320242,2063898,1427.8,288.88,1716.68
2022-04-28 04:00:00+08,9,13,22,743656,1320242,2063898,1463.8,340.88,1804.68
2022-04-28 08:00:00+08,9,12,21,743656,1214697,1958353,1499.77,332.44,1832.21
2022-04-28 12:00:00+08,9,11,20,743656,1149967,1893623,1535.74,340.01,1875.75
2022-04-28 16:00:00+08,8,11,19,726499,1149967,1876466,1540.91,384.01,1924.92
2022-04-28 20:00:00+08,6,9,15,574085,832871,1406956,1299.72,283.98,1583.7
2022-04-29 00:00:00+08,6,10,16,574085,950971,1525056,1521.42,299.58,1821
2022-04-29 04:00:00+08,5,10,15,475019,950971,1425990,1343.52,339.58,1683.1
2022-04-29 08:00:00+08,5,11,16,475019,903435,1378454,1568.04,272.72,1840.76
2022-04-29 12:00:00+08,5,10,15,475019,759093,1234112,1255.08,232,1487.08
2022-04-29 16:00:00+08,5,6,11,475019,499652,974671,1242.16,109.94,1352.1
2022-04-29 20:00:00+08,5,11,16,475019,957339,1432358,1262.15,140.67,1402.82
2022-04-30 00:00:00+08,6,13,19,509267,1206625,1715892,1142.05,166.04,1308.09
2022-04-30 04:00:00+08,6,13,19,509267,1206625,1715892,1166.05,218.04,1384.09
2022-04-30 08:00:00+08,6,12,18,509267,1147168,1656435,1136.13,212.57,1348.7
2022-04-30 12:00:00+08,7,13,20,675258,1262868,1938126,1162.45,262.25,1424.7
2022-04-30 16:00:00+08,7,12,19,675258,1199468,1874726,1190.45,294.46,1484.91
2022-04-30 20:00:00+08,7,14,21,675258,1277665,1952923,1218.43,346.49,1564.92
2022-05-01 00:00:00+08,7,13,20,675258,1263862,1939120,1246.45,374.2,1620.65
2022-05-01 04:00:00+08,10,12,22,985713,1164796,2150509,1073.85,380.83,1454.68
2022-05-01 08:00:00+08,11,12,23,1018929,1164796,2183725,1117.15,428.83,1545.98
2022-05-01 12:00:00+08,10,10,20,968397,993200,1961597,1026.85,415.48,1442.33
2022-05-01 16:00:00+08,11,9,20,1049974,837349,1887323,996.1,363.31,1359.41
2022-05-01 20:00:00+08,12,9,21,1159709,847380,2007089,1180.39,343.23,1523.62
2022-05-02 00:00:00+08,11,10,21,1126493,945916,2072409,1209.15,314.43,1523.58
2022-05-02 04:00:00+08,11,9,20,1126493,956938,2083431,1253.14,253.31,1506.45
2022-05-02 08:00:00+08,11,10,21,1126493,1039231,2165724,1321.36,237.23,1558.59
2022-05-02 12:00:00+08,13,10,23,1365183,1039231,2404414,1372.2,277.23,1649.43
2022-05-02 16:00:00+08,12,10,22,1330935,1039231,2370166,1356.51,317.23,1673.74
2022-05-02 20:00:00+08,11,11,22,1211431,1073479,2284910,1293.81,358.89,1652.7
2022-05-03 00:00:00+08,11,11,22,1211431,1159767,2371198,1497.65,384.46,1882.11
2022-05-03 04:00:00+08,12,12,24,1278601,1278602,2557203,1548.95,429.72,1978.67
2022-05-03 08:00:00+08,11,11,22,1132010,1151526,2283536,1544.95,393.08,1938.03
2022-05-03 12:00:00+08,11,11,22,1132010,1267882,2399892,1644.78,400.98,2045.76
2022-05-03 16:00:00+08,11,10,21,1132010,1140522,2272532,1688.84,399.48,2088.32
2022-05-03 20:00:00+08,10,9,19,1064840,1029437,2094277,1576.63,347.46,1924.09
2022-05-04 00:00:00+08,9,9,18,925933,951625,1877558,1110.34,341.69,1452.03
2022-05-04 04:00:00+08,10,11,21,1027751,1157702,2185453,1678.73,383.47,2062.2
2022-05-04 08:00:00+08,9,11,20,801532,1157702,1959234,1620.4,427.47,2047.87
2022-05-04 12:00:00+08,9,11,20,801532,1287595,2089127,1694.71,319.04,2013.75
2022-05-04 16:00:00+08,9,11,20,801532,1287595,2089127,1730.71,363.04,2093.75
2022-05-04 20:00:00+08,10,11,21,853225,1236451,2089676,1769.97,383.1,2153.07
2022-05-05 00:00:00+08,9,10,19,726149,1080949,1807098,1746.91,305.41,2052.32
2022-05-05 04:00:00+08,9,11,20,726149,1208025,1934174,1849.01,346.37,2195.38
2022-05-05 08:00:00+08,9,12,21,726149,1279281,2005430,1885.01,392.05,2277.06
2022-05-05 12:00:00+08,9,12,21,726149,1251461,1977610,1920.99,405.71,2326.7
2022-05-05 16:00:00+08,10,11,21,792746,1184291,1977037,1937.04,414.14,2351.18
2022-05-05 20:00:00+08,9,11,20,706940,1124094,1831034,1744.01,366.92,2110.93
2022-05-06 00:00:00+08,9,12,21,706940,1209900,1916840,2016.5,411.48,2427.98
2022-05-06 04:00:00+08,10,12,22,733887,1209900,1943787,2053.55,459.48,2513.03
2022-05-06 08:00:00+08,10,12,22,733887,1209900,1943787,2093.55,507.48,2601.03
2022-05-06 12:00:00+08,11,11,22,751123,1176209,1927332,2134.69,513.49,2648.18
2022-05-06 16:00:00+08,9,10,19,763133,1056705,1819838,1793.23,468.88,2262.11
2022-05-06 20:00:00+08,8,11,19,711440,929624,1641064,1984.02,361.46,2345.48
2022-05-07 00:00:00+08,9,12,21,819867,981317,1801184,2070.07,406.64,2476.71
2022-05-07 04:00:00+08,9,12,21,819867,981317,1801184,2106.07,454.64,2560.71
2022-05-07 08:00:00+08,6,11,17,581282,935834,1517116,1616.45,460.61,2077.06
2022-05-07 12:00:00+08,7,10,17,611532,997095,1608627,1716.73,437.45,2154.18
2022-05-07 16:00:00+08,7,11,18,611532,1014331,1625863,1770.1,481.24,2251.34
2022-05-07 20:00:00+08,7,11,18,611532,986966,1598498,1787.48,447.32,2234.8
2022-05-08 00:00:00+08,7,13,20,611532,1117946,1729478,1815.48,495.87,2311.35
2022-05-08 04:00:00+08,7,13,20,611532,1117946,1729478,1843.48,547.87,2391.35
2022-05-08 08:00:00+08,9,13,22,732094,1117946,1850040,1875.57,599.87,2475.44
2022-05-08 12:00:00+08,9,13,22,732094,1117946,1850040,1911.57,651.87,2563.44
2022-05-08 16:00:00+08,9,12,21,732094,990870,1722964,1881.53,618.87,2500.4
2022-05-08 20:00:00+08,9,10,19,732094,896735,1628829,1647.24,535.79,2183.03
2022-05-09 00:00:00+08,8,8,16,665497,777772,1443269,1548.15,482.64,2030.79
2022-05-09 04:00:00+08,8,8,16,665497,697778,1363275,1609.29,378.49,1987.78
2022-05-09 08:00:00+08,8,7,15,665497,558871,1224368,1133.29,284.3,1417.59
2022-05-09 12:00:00+08,9,8,17,806134,733910,1540044,1166.9,274.17,1441.07
2022-05-09 16:00:00+08,7,8,15,685572,733910,1419482,1134.77,306.17,1440.94
2022-05-09 20:00:00+08,7,11,18,685572,911662,1597234,1234.71,320.23,1554.94
2022-05-10 00:00:00+08,7,10,17,685572,837209,1522781,1262.72,309.34,1572.06
2022-05-10 04:00:00+08,7,10,17,685572,837209,1522781,1290.72,349.34,1640.06
2022-05-10 08:00:00+08,7,9,16,685572,819973,1505545,1293.35,321.55,1614.9
2022-05-10 12:00:00+08,7,9,16,685572,819973,1505545,1321.35,357.55,1678.9
2022-05-10 16:00:00+08,7,7,14,685572,709862,1395434,1349.32,307.48,1656.8
2022-05-10 20:00:00+08,6,10,16,605302,982393,1587695,941.3,303.07,1244.37
2022-05-11 00:00:00+08,7,10,17,762378,1010297,1772675,1286.97,313.16,1600.13
2022-05-11 04:00:00+08,7,11,18,762378,1048913,1811291,1314.98,354.77,1669.75
2022-05-11 08:00:00+08,8,14,22,814401,1316488,2130889,1558.36,408.3,1966.66
2022-05-11 12:00:00+08,8,14,22,814401,1316488,2130889,1590.36,464.3,2054.66
2022-05-11 16:00:00+08,7,14,21,784151,1316488,2100639,1519.29,520.3,2039.59
2022-05-11 20:00:00+08,7,12,19,784151,1012688,1796839,1615.48,397.09,2012.57
2022-05-12 00:00:00+08,7,11,18,784151,1000870,1785021,1643.46,425.45,2068.91
2022-05-12 04:00:00+08,9,10,19,1011014,919735,1930749,1674.56,372.5,2047.06
2022-05-12 08:00:00+08,9,12,21,1011014,1205657,2216671,1710.53,415.84,2126.37
2022-05-12 12:00:00+08,10,12,22,1160064,1205657,2365721,1749.37,463.84,2213.21
2022-05-12 16:00:00+08,10,9,19,1160064,1056521,2216585,1329.08,412.39,1741.47
2022-05-12 20:00:00+08,11,9,20,1198680,948499,2147179,1370.81,408.48,1779.29
2022-05-13 00:00:00+08,11,10,21,1198680,1013386,2212066,1414.82,445.02,1859.84
2022-05-13 04:00:00+08,10,10,20,1160064,934484,2094548,1449.04,430.41,1879.45
2022-05-13 08:00:00+08,11,11,22,1260951,986634,2247585,1490.41,470.81,1961.22
2022-05-13 12:00:00+08,12,10,22,1378014,882943,2260957,1538.16,449.44,1987.6
2022-05-13 16:00:00+08,13,10,23,1508587,882943,2391530,1587.47,489.44,2076.91
2022-05-13 20:00:00+08,13,10,23,1508587,892654,2401241,1639.47,505.36,2144.83
2022-05-14 00:00:00+08,14,9,23,1559119,781040,2340159,1481.77,478.86,1960.63
2022-05-14 04:00:00+08,15,10,25,1724657,897140,2621797,1538.7,517.36,2056.06
2022-05-14 08:00:00+08,16,9,25,1715919,890256,2606175,1580.08,526.58,2106.66
2022-05-14 12:00:00+08,17,9,26,1779119,890256,2669375,1646.43,562.58,2209.01
2022-05-14 16:00:00+08,17,9,26,1779119,890256,2669375,1714.43,598.58,2313.01
2022-05-14 20:00:00+08,18,9,27,1926025,890256,2816281,1782.76,634.58,2417.34
2022-05-15 00:00:00+08,20,9,29,2152816,890256,3043072,1858.33,670.58,2528.91
2022-05-15 04:00:00+08,18,6,24,1981765,641178,2622943,1877.52,508.98,2386.5
2022-05-15 08:00:00+08,16,9,25,1788544,716610,2505154,1593.27,184.46,1777.73
2022-05-15 12:00:00+08,18,11,29,1903355,909831,2813186,2034.89,225.34,2260.23
2022-05-15 16:00:00+08,18,11,29,1903355,909831,2813186,2106.89,269.34,2376.23
2022-05-15 20:00:00+08,18,10,28,1903355,875669,2779024,2178.89,295.57,2474.46
2022-05-16 00:00:00+08,17,9,26,1874252,849649,2723901,2025.19,316.34,2341.53
2022-05-16 04:00:00+08,17,5,22,1874252,512289,2386541,2067.22,103.58,2170.8
2022-05-16 08:00:00+08,18,10,28,1881380,961261,2842641,2251.35,139.78,2391.13
2022-05-16 12:00:00+08,19,9,28,1948065,909590,2857655,2296.73,153.05,2449.78
2022-05-16 16:00:00+08,18,8,26,1774328,821982,2596310,2160.42,154.63,2315.05
2022-05-16 20:00:00+08,18,11,29,1771732,1014135,2785867,2280.72,143.3,2424.02
2022-05-17 00:00:00+08,17,12,29,1654669,1253290,2907959,2495.22,173.96,2669.18
2022-05-17 04:00:00+08,17,13,30,1654669,1370353,3025022,2652.34,224.51,2876.85
2022-05-17 08:00:00+08,17,13,30,1654669,1370353,3025022,2720.34,276.51,2996.85
2022-05-17 12:00:00+08,18,13,31,1734951,1370353,3105304,2791.12,328.51,3119.63
2022-05-17 16:00:00+08,16,12,28,1601703,1269466,2871169,2401.35,322,2723.35
2022-05-17 20:00:00+08,16,11,27,1601703,1190640,2792343,2757.97,280.86,3038.83
2022-05-18 00:00:00+08,17,12,29,1788376,1134950,2923326,2685.44,286.8,2972.24
2022-05-18 04:00:00+08,17,13,30,1788376,1201635,2990011,2794.82,335.16,3129.98
2022-05-18 08:00:00+08,18,13,31,1927258,1201635,3128893,2866.82,387.16,3253.98
2022-05-18 12:00:00+08,18,13,31,1927258,1201635,3128893,2938.82,439.16,3377.98
2022-05-18 16:00:00+08,17,13,30,1854276,1201635,3055911,2933.3,491.16,3424.46
2022-05-18 20:00:00+08,15,13,28,1574421,1134499,2708920,2815.59,455.96,3271.55
2022-05-19 00:00:00+08,14,13,27,1465994,1368153,2834147,2770.48,432.16,3202.64
2022-05-19 04:00:00+08,14,13,27,1465994,1368153,2834147,2826.48,484.16,3310.64
2022-05-19 08:00:00+08,14,13,27,1465994,1395003,2860997,2786.11,500.72,3286.83
2022-05-19 12:00:00+08,15,13,28,1619514,1395003,3014517,2845.93,552.72,3398.65
2022-05-19 16:00:00+08,13,12,25,1430779,1253453,2684232,2341.77,502.56,2844.33
2022-05-19 20:00:00+08,12,10,22,1315079,972669,2287748,2320.68,349.78,2670.46
2022-05-20 00:00:00+08,12,11,23,1315079,1172237,2487316,2578.82,291,2869.82
2022-05-20 04:00:00+08,13,12,25,1365185,1229407,2594592,2629.28,307.48,2936.76
2022-05-20 08:00:00+08,14,12,26,1436476,1229407,2665883,2681.58,355.48,3037.06
2022-05-20 12:00:00+08,14,11,25,1436476,1156425,2592901,2657.81,361.71,3019.52
2022-05-20 16:00:00+08,13,11,24,1365185,1156425,2521610,2705.51,405.71,3111.22
2022-05-20 20:00:00+08,13,9,22,1263826,822329,2086155,2357.67,241,2598.67
2022-05-21 00:00:00+08,13,10,23,1279833,874490,2154323,2410.47,278.03,2688.5
2022-05-21 04:00:00+08,12,8,20,1176972,736781,1913753,1588.28,190.38,1778.66
2022-05-21 08:00:00+08,12,11,23,1176972,949670,2126642,1990.18,228.99,2219.17
2022-05-21 12:00:00+08,11,10,21,1019896,942786,1962682,1784.65,237.16,2021.81
2022-05-21 16:00:00+08,11,10,21,1019896,942786,1962682,1828.65,277.16,2105.81
2022-05-21 20:00:00+08,11,10,21,1019896,942786,1962682,1872.65,317.16,2189.81
2022-05-22 00:00:00+08,12,8,20,1071675,757205,1828880,1794.57,229.67,2024.24
2022-05-22 04:00:00+08,12,12,24,1048073,1167428,2215501,1964.29,268.56,2232.85
2022-05-22 08:00:00+08,13,13,26,1216900,1376364,2593264,2160.98,294.79,2455.77
2022-05-22 12:00:00+08,13,12,25,1216900,1275164,2492064,2212.95,287.41,2500.36
2022-05-22 16:00:00+08,13,13,26,1216900,1356411,2573311,2276.34,338.92,2615.26
2022-05-22 20:00:00+08,13,12,25,1216900,1285120,2502020,2318.59,340.31,2658.9
2022-05-23 00:00:00+08,13,12,25,1216900,1283226,2500126,2016.75,330.85,2347.6
2022-05-23 04:00:00+08,15,11,26,1450074,1198391,2648465,2071.32,352.12,2423.44
2022-05-23 08:00:00+08,16,10,26,1553847,1059509,2613356,2115.44,291.44,2406.88
2022-05-23 12:00:00+08,16,10,26,1553847,1059509,2613356,2179.44,331.44,2510.88
2022-05-23 16:00:00+08,13,9,22,1413836,905989,2319825,1650.85,307.73,1958.58
2022-05-23 20:00:00+08,12,12,24,1333554,1082225,2415779,2109.74,262.84,2372.58
2022-05-24 00:00:00+08,12,13,25,1333554,1229017,2562571,2157.74,311.99,2469.73
2022-05-24 04:00:00+08,11,13,24,1191534,1204450,2395984,1991.5,321.59,2313.09
2022-05-24 08:00:00+08,11,13,24,1191534,1200533,2392067,2260.39,323.55,2583.94
2022-05-24 12:00:00+08,11,13,24,1191534,1200533,2392067,2304.39,375.55,2679.94
2022-05-24 16:00:00+08,10,11,21,1078322,983012,2061334,2187.42,323.66,2511.08
2022-05-24 20:00:00+08,11,13,24,1128854,1197416,2326270,2303.09,326.02,2629.11
2022-05-25 00:00:00+08,13,13,26,1345527,1197416,2542943,2350.69,378.02,2728.71
2022-05-25 04:00:00+08,14,13,27,1423427,1197416,2620843,2404.29,430.02,2834.31
2022-05-25 08:00:00+08,15,15,30,1576941,1262457,2839398,2462.46,489.08,2951.54
2022-05-25 12:00:00+08,15,12,27,1621265,1078695,2699960,2133.27,383.25,2516.52
2022-05-25 16:00:00+08,15,15,30,1621265,1278241,2899506,2283.92,436.19,2720.11
2022-05-25 20:00:00+08,15,14,29,1631607,1196994,2828601,2311.01,416.68,2727.69
2022-05-26 00:00:00+08,15,14,29,1631607,1284393,2916000,2395.14,415.77,2810.91
2022-05-26 04:00:00+08,15,13,28,1631607,1327907,2959514,2284.29,395.1,2679.39
2022-05-26 08:00:00+08,15,13,28,1570926,1327907,2898833,2144.61,447.1,2591.71
2022-05-26 12:00:00+08,14,12,26,1467359,1297570,2764929,2102.02,467.24,2569.26
2022-05-26 16:00:00+08,13,11,24,1350264,1245791,2596055,1981.08,490.44,2471.52
2022-05-26 20:00:00+08,11,11,22,1123249,1092203,2215452,1892.07,327.06,2219.13
2022-05-27 00:00:00+08,11,10,21,1123249,914328,2037577,1775.94,246.13,2022.07
2022-05-27 04:00:00+08,11,12,23,1123249,1115012,2238261,1953.87,203.81,2157.68
2022-05-27 08:00:00+08,11,14,25,1123249,1331922,2455171,1997.87,255.72,2253.59
2022-05-27 12:00:00+08,12,14,26,1197726,1331922,2529648,2044.35,311.72,2356.07
2022-05-27 16:00:00+08,14,14,28,1291570,1331922,2623492,2097.84,367.72,2465.56
2022-05-27 20:00:00+08,14,13,27,1291570,1215822,2507392,2153.86,380.11,2533.97
2022-05-28 00:00:00+08,15,13,28,1414529,1258927,2673456,2211.36,414.18,2625.54
2022-05-28 04:00:00+08,15,13,28,1414529,1258927,2673456,2271.36,466.18,2737.54
2022-05-28 08:00:00+08,15,12,27,1354973,1252043,2607016,2037.59,486.46,2524.05
2022-05-28 12:00:00+08,15,11,26,1354973,1136343,2491316,2066.69,500.75,2567.44
2022-05-28 16:00:00+08,14,11,25,1328162,1136343,2464505,2100.11,544.75,2644.86
2022-05-28 20:00:00+08,15,11,26,1393526,1145918,2539444,2188.07,541.26,2729.33
2022-05-29 00:00:00+08,15,12,27,1393526,1261618,2655144,2248.14,588.92,2837.06
2022-05-29 04:00:00+08,14,9,23,1342994,943020,2286014,1890.11,408.77,2298.88
2022-05-29 08:00:00+08,14,9,23,1342994,868400,2211394,1922.02,366.72,2288.74
2022-05-29 12:00:00+08,14,11,25,1342994,1064320,2407314,2410.33,408.24,2818.57
2022-05-29 16:00:00+08,14,7,21,1342994,684642,2027636,2306.77,188.65,2495.42
2022-05-29 20:00:00+08,14,9,23,1342994,793030,2136024,2362.75,220.28,2583.03
2022-05-30 00:00:00+08,14,9,23,1342994,793030,2136024,2418.75,256.28,2675.03
2022-05-30 04:00:00+08,15,8,23,1456066,553674,2009740,2476.29,195.29,2671.58
2022-05-30 08:00:00+08,16,9,25,1595401,616668,2212069,2538.58,231,2769.58
2022-05-30 12:00:00+08,15,7,22,1455089,559119,2014208,2205.67,192.55,2398.22
2022-05-30 16:00:00+08,14,5,19,1389725,355979,1745704,2001.18,121.02,2122.2
2022-05-30 20:00:00+08,13,5,18,1266766,362582,1629348,1929.68,81.6,2011.28
2022-05-31 00:00:00+08,13,8,21,1266766,735821,2002587,2445.53,107.12,2552.65
2022-05-31 04:00:00+08,15,8,23,1388034,735821,2123855,2502.87,139.12,2641.99
2022-05-31 08:00:00+08,15,7,22,1388034,713845,2101879,2562.87,157.63,2720.5
2022-05-31 12:00:00+08,15,5,20,1388034,490274,1878308,2299.57,94.27,2393.84
2022-05-31 16:00:00+08,15,3,18,1388034,373239,1761273,2308.55,53.51,2362.06
2022-05-31 20:00:00+08,17,6,23,1610857,623653,2234510,2373.63,71.01,2444.64
2022-06-01 00:00:00+08,16,7,23,1503283,725500,2228783,2040.21,96.36,2136.57
2022-06-01 04:00:00+08,16,10,26,1503283,951484,2454767,2104.23,135.3,2239.53
2022-06-01 08:00:00+08,17,12,29,1647343,1009147,2656490,2403.43,142.88,2546.31
2022-06-01 12:00:00+08,17,11,28,1647343,1119339,2766682,2471.43,163.65,2635.08
2022-06-01 16:00:00+08,15,10,25,1527469,1034564,2562033,2319.09,185.08,2504.17
2022-06-01 20:00:00+08,15,15,30,1527469,1314398,2841867,2604.15,232.05,2836.2
2022-06-02 00:00:00+08,15,15,30,1527469,1314398,2841867,2664.15,292.05,2956.2
2022-06-02 04:00:00+08,16,13,29,1570449,1221130,2791579,2583.36,310.74,2894.1
2022-06-02 08:00:00+08,15,14,29,1416935,1278450,2695385,2453.19,363.6,2816.79
2022-06-02 12:00:00+08,14,14,28,1349334,1278450,2627784,2469.81,419.6,2889.41
2022-06-02 16:00:00+08,14,14,28,1349334,1278450,2627784,2525.81,475.6,3001.41
2022-06-02 20:00:00+08,15,11,26,1427602,1135543,2563145,2595.31,366.99,2962.3
2022-06-03 00:00:00+08,16,11,27,1494875,1135543,2630418,2656.5,410.99,3067.49
2022-06-03 04:00:00+08,16,12,28,1494875,1149293,2644168,2932.91,408.7,3341.61
2022-06-03 08:00:00+08,14,11,25,1342130,1071393,2413523,2630.89,419.45,3050.34
2022-06-03 12:00:00+08,15,11,26,1410502,1093720,2504222,2859.06,448.65,3307.71
2022-06-03 16:00:00+08,14,10,24,1324682,963147,2287829,2469.67,424.12,2893.79
2022-06-03 20:00:00+08,14,15,29,1324682,1228902,2553584,3004.2,423.03,3427.23
2022-06-04 00:00:00+08,14,15,29,1324682,1228902,2553584,3060.2,483.03,3543.23
2022-06-04 04:00:00+08,15,15,30,1357619,1224295,2581914,3068.98,514.18,3583.16
2022-06-04 08:00:00+08,16,13,29,1420688,1058953,2479641,2859.13,398.72,3257.85
2022-06-04 12:00:00+08,15,13,28,1310720,1028146,2338866,2593.24,341.5,2934.74
2022-06-04 16:00:00+08,14,10,24,1270661,784686,2055347,2490.96,239.16,2730.12
2022-06-04 20:00:00+08,14,12,26,1270661,1060810,2331471,2676.16,237.06,2913.22
2022-06-05 00:00:00+08,15,11,26,1412683,980392,2393075,2825.93,194.98,3020.91
2022-06-05 04:00:00+08,18,12,30,1735699,1031186,2766885,2889.48,241.71,3131.19
2022-06-05 08:00:00+08,19,12,31,1807094,1031186,2838280,2962.2,289.71,3251.91
2022-06-05 12:00:00+08,19,10,29,1807094,878580,2685674,2585.52,268.19,2853.71
2022-06-05 16:00:00+08,17,9,26,1697081,804103,2501184,2186.98,254.34,2441.32
2022-06-05 20:00:00+08,17,10,27,1712415,798416,2510831,2550.26,261.61,2811.87
2022-06-06 00:00:00+08,16,9,25,1581381,726509,2307890,2587.56,220.35,2807.91
2022-06-06 04:00:00+08,16,11,27,1581381,973243,2554624,2680.06,260.77,2940.83
2022-06-06 08:00:00+08,18,9,27,1742643,837012,2579655,2747.27,237.82,2985.09
2022-06-06 12:00:00+08,19,9,28,1828453,837012,2665465,2822.66,273.82,3096.48
2022-06-06 16:00:00+08,17,10,27,1716222,1064169,2780391,2587.25,292.74,2879.99
2022-06-06 20:00:00+08,17,12,29,1716222,1176400,2892622,2882.17,336.17,3218.34
2022-06-07 00:00:00+08,16,10,26,1630412,1005307,2635719,2834.26,310.58,3144.84
2022-06-07 04:00:00+08,16,11,27,1630412,1091117,2721529,2917.5,350.77,3268.27
2022-06-07 08:00:00+08,16,10,26,1606476,1058180,2664656,2760.07,380.75,3140.82
2022-06-07 12:00:00+08,17,10,27,1673323,1058180,2731503,2629.99,420.75,3050.74
2022-06-07 16:00:00+08,16,9,25,1601928,944188,2546116,2571.52,313.87,2885.39
2022-06-07 20:00:00+08,15,9,24,1498280,961889,2460169,2409.02,258.32,2667.34
2022-06-08 00:00:00+08,15,11,26,1498280,1259897,2758177,2679.17,219,2898.17
2022-06-08 04:00:00+08,15,12,27,1498280,1363545,2861825,2808.57,265.8,3074.37
2022-06-08 08:00:00+08,14,13,27,1438876,1396619,2835495,2845.4,316.38,3161.78
2022-06-08 12:00:00+08,15,11,26,1455273,1207357,2662630,2612.57,237.27,2849.84
2022-06-08 16:00:00+08,16,10,26,1526649,1122652,2649301,2673.04,259.95,2932.99
2022-06-08 20:00:00+08,16,11,27,1526649,1206773,2733422,2717.91,262.47,2980.38
2022-06-09 00:00:00+08,15,11,26,1463580,1194782,2658362,2644.12,280.7,2924.82
2022-06-09 04:00:00+08,15,12,27,1463580,1229096,2692676,2704.13,325.06,3029.19
2022-06-09 08:00:00+08,15,13,28,1463580,1292165,2755745,2883.78,375.53,3259.31
2022-06-09 12:00:00+08,14,12,26,1395208,1178226,2573434,2796.13,355.97,3152.1
2022-06-09 16:00:00+08,12,10,22,1275143,988249,2263392,2675.75,362.88,3038.63
2022-06-09 20:00:00+08,12,13,25,1275143,1225730,2500873,3023.01,348.12,3371.13
2022-06-10 00:00:00+08,14,13,27,1414544,1225730,2640274,3076.88,400.12,3477
2022-06-10 04:00:00+08,14,14,28,1414544,1250461,2665005,3132.87,434.44,3567.31
2022-06-10 08:00:00+08,14,14,28,1414544,1250461,2665005,3188.87,490.44,3679.31
2022-06-10 12:00:00+08,13,13,26,1298465,1095239,2393704,2640.69,476.78,3117.47
2022-06-10 16:00:00+08,13,11,24,1203339,903246,2106585,2435.03,440.28,2875.31
2022-06-10 20:00:00+08,13,14,27,1203339,1210360,2413699,2874.06,381.79,3255.85
2022-06-11 00:00:00+08,15,13,28,1400462,1193963,2594425,2898.31,407.34,3305.65
2022-06-11 04:00:00+08,15,12,27,1400462,1141802,2542264,2958.27,431.71,3389.98
2022-06-11 08:00:00+08,15,11,26,1400462,1073430,2473892,2864.23,442.16,3306.39
2022-06-11 12:00:00+08,15,10,25,1400462,1066546,2467008,2924.22,451.09,3375.31
2022-06-11 16:00:00+08,17,8,25,1536860,904302,2441162,2985.09,381.97,3367.06
2022-06-11 20:00:00+08,16,8,24,1392800,863804,2256604,2797.93,290.4,3088.33
2022-06-12 00:00:00+08,16,8,24,1380673,863804,2244477,2812.23,322.4,3134.63
2022-06-12 04:00:00+08,15,9,24,1249387,1043352,2292739,2883.96,325.83,3209.79
2022-06-12 08:00:00+08,15,9,24,1249387,1070970,2320357,2950.06,302.33,3252.39
2022-06-12 12:00:00+08,16,8,24,1380421,954977,2335398,3012.35,296.34,3308.69
2022-06-12 16:00:00+08,16,10,26,1380421,1068615,2449036,3076.35,329.97,3406.32
2022-06-12 20:00:00+08,16,10,26,1380421,1139006,2519427,2692.7,322.27,3014.97
2022-06-13 00:00:00+08,16,9,25,1380421,992228,2372649,2676.29,309.71,2986
2022-06-13 04:00:00+08,16,8,24,1380421,888580,2269001,2670.94,222.91,2893.85
2022-06-13 08:00:00+08,18,8,26,1647729,888580,2536309,2740.23,254.91,2995.14
2022-06-13 12:00:00+08,19,7,26,1709929,862560,2572489,2814.43,266.41,3080.84
2022-06-13 16:00:00+08,15,3,18,1331341,433291,1764632,2205.36,96.72,2302.08
2022-06-13 20:00:00+08,15,8,23,1331341,879272,2210613,2786.37,77.11,2863.48
2022-06-14 00:00:00+08,16,8,24,1384985,879272,2264257,2849.31,109.11,2958.42
2022-06-14 04:00:00+08,15,8,23,1338727,879272,2217999,2800.54,141.11,2941.65
2022-06-14 08:00:00+08,16,9,25,1454720,969906,2424626,2917.74,176.03,3093.77
2022-06-14 12:00:00+08,15,10,25,1404188,1066886,2471074,2964.02,213.71,3177.73
2022-06-14 16:00:00+08,15,8,23,1404188,962032,2366220,2947.67,210.74,3158.41
2022-06-14 20:00:00+08,16,11,27,1421424,1137460,2558884,3098.94,247.09,3346.03
2022-06-15 00:00:00+08,17,13,30,1521080,1361483,2882563,3012.01,318.36,3330.37
2022-06-15 04:00:00+08,17,13,30,1521080,1361483,2882563,3080.01,370.36,3450.37
2022-06-15 08:00:00+08,17,14,31,1521080,1432859,2953939,3304.71,426.19,3730.9
2022-06-15 12:00:00+08,17,14,31,1521080,1432859,2953939,3372.71,482.19,3854.9
2022-06-15 16:00:00+08,18,14,32,1738363,1432859,3171222,3425.74,538.19,3963.93
2022-06-15 20:00:00+08,16,12,28,1467578,1051045,2518623,3044.44,398.67,3443.11
2022-06-16 00:00:00+08,16,14,30,1467578,1270838,2738416,3164.78,397.31,3562.09
2022-06-16 04:00:00+08,16,14,30,1467578,1270838,2738416,3228.78,453.31,3682.09
2022-06-16 08:00:00+08,18,15,33,1666082,1376366,3042448,3296.26,512.47,3808.73
2022-06-16 12:00:00+08,18,14,32,1666082,1325834,2991916,3277.13,530.94,3808.07
2022-06-16 16:00:00+08,17,11,28,1626664,1025710,2652374,2812.83,397.55,3210.38
2022-06-16 20:00:00+08,17,13,30,1626664,1106718,2733382,3003.72,444.2,3447.92
2022-06-17 00:00:00+08,16,12,28,1558947,1072014,2630961,2812.93,466.83,3279.76
2022-06-17 04:00:00+08,17,13,30,1660765,1078898,2739663,2880.46,518.4,3398.86
2022-06-17 08:00:00+08,17,13,30,1660765,1078898,2739663,2948.46,570.4,3518.86
2022-06-17 12:00:00+08,17,12,29,1660765,1039480,2700245,2893.51,605.15,3498.66
2022-06-17 16:00:00+08,13,8,21,1224713,860810,2085523,2643.97,460.41,3104.38
2022-06-17 20:00:00+08,13,10,23,1224713,1000872,2225585,2992.84,360.84,3353.68
2022-06-18 00:00:00+08,13,12,25,1273711,1206239,2479950,3095.34,358.98,3454.32
2022-06-18 04:00:00+08,14,15,29,1419271,1342794,2762065,3225.26,336.78,3562.04
2022-06-18 08:00:00+08,14,14,28,1419271,1335910,2755181,3281.28,365.19,3646.47
2022-06-18 12:00:00+08,14,12,26,1419271,1225127,2644398,3270.24,311.79,3582.03
2022-06-18 16:00:00+08,15,11,26,1486441,1162127,2648568,3327.34,338.47,3665.81
2022-06-18 20:00:00+08,13,13,26,1353698,1208884,2562582,2551.29,344.42,2895.71
2022-06-19 00:00:00+08,12,12,24,1222664,1124163,2346827,2290.45,340.2,2630.65
2022-06-19 04:00:00+08,12,14,26,1222664,1351300,2573964,3086.76,394.26,3481.02
2022-06-19 08:00:00+08,13,14,27,1335098,1351300,2686398,3138.22,450.26,3588.48
2022-06-19 12:00:00+08,13,14,27,1335098,1351300,2686398,3190.22,506.26,3696.48
2022-06-19 16:00:00+08,13,11,24,1335098,1125237,2460335,2946.65,371.89,3318.54
2022-06-19 20:00:00+08,13,11,24,1335098,1091066,2426164,2410.55,373.18,2783.73
2022-06-20 00:00:00+08,13,12,25,1335098,1315118,2650216,2462.48,389.77,2852.25
2022-06-20 04:00:00+08,13,11,24,1335098,1280845,2615943,2514.48,404.69,2919.17
2022-06-20 08:00:00+08,13,11,24,1335098,1280845,2615943,2566.48,448.69,3015.17
2022-06-20 12:00:00+08,14,10,24,1438766,1165145,2603911,2621.45,433.42,3054.87
2022-06-20 16:00:00+08,15,10,25,1489541,1246947,2736488,2681.12,453.12,3134.24
2022-06-20 20:00:00+08,16,10,26,1636562,1179268,2815830,2583.93,452.48,3036.41
2022-06-21 00:00:00+08,16,11,27,1636562,1230137,2866699,2647.98,493.27,3141.25
2022-06-21 04:00:00+08,18,11,29,1856223,1230137,3086360,2714.86,537.27,3252.13
2022-06-21 08:00:00+08,20,10,30,2031388,1163659,3195047,2788.99,518.3,3307.29
2022-06-21 12:00:00+08,20,12,32,2031388,1327356,3358744,2869,561.63,3430.63
2022-06-21 16:00:00+08,20,11,31,2031388,1214840,3246228,2949.04,565.51,3514.55
2022-06-21 20:00:00+08,18,12,30,1860550,1226273,3086823,2916.94,568.64,3485.58
2022-06-22 00:00:00+08,17,12,29,1713529,1149312,2862841,2983.63,518.25,3501.88
2022-06-22 04:00:00+08,16,13,29,1611711,1252980,2864691,2967.5,569.64,3537.14
2022-06-22 08:00:00+08,18,12,30,1838649,1133120,2971769,3006.13,457.53,3463.66
2022-06-22 12:00:00+08,18,13,31,1838649,1234938,3073587,3207.97,507.32,3715.29
2022-06-22 16:00:00+08,18,12,30,1838649,1169370,3008019,3279.99,507.21,3787.2
2022-06-22 20:00:00+08,16,11,27,1641485,1121499,2762984,3152.94,440.42,3593.36
2022-06-23 00:00:00+08,17,11,28,1762419,1065133,2827552,3185.57,342.37,3527.94
2022-06-23 04:00:00+08,16,11,27,1649985,991512,2641497,3253.25,217.94,3471.19
2022-06-23 08:00:00+08,15,13,28,1564153,1244555,2808708,2789,263.74,3052.74
2022-06-23 12:00:00+08,15,13,28,1500967,1214394,2715361,3446.83,249,3695.83
2022-06-23 16:00:00+08,15,11,26,1500967,1076564,2577531,3467.27,237.41,3704.68
2022-06-23 20:00:00+08,14,14,28,1401881,1277655,2679536,3383.55,250.22,3633.77
2022-06-24 00:00:00+08,15,14,29,1510455,1295570,2806025,3422.64,282.58,3705.22
2022-06-24 04:00:00+08,14,14,28,1415254,1260871,2676125,2765.05,310.54,3075.59
2022-06-24 08:00:00+08,15,16,31,1524024,1465093,2989117,3544.87,370.07,3914.94
2022-06-24 12:00:00+08,15,14,29,1524024,1332703,2856727,3560.77,380.67,3941.44
2022-06-24 16:00:00+08,14,14,28,1451720,1332703,2784423,3540.69,436.67,3977.36
2022-06-24 20:00:00+08,13,16,29,1348052,1357583,2705635,2960.02,413.49,3373.51
2022-06-25 00:00:00+08,14,14,28,1497044,1156798,2653842,2886.14,330.86,3217
2022-06-25 04:00:00+08,14,14,28,1497044,1148032,2645076,2938.09,345.31,3283.4
2022-06-25 08:00:00+08,15,13,28,1531239,1210924,2742163,2995.62,357.29,3352.91
2022-06-25 12:00:00+08,15,13,28,1531239,1210924,2742163,3055.62,409.29,3464.91
2022-06-25 16:00:00+08,15,13,28,1498681,1210924,2709605,2874.65,461.29,3335.94
2022-06-25 20:00:00+08,14,11,25,1447906,1037641,2485547,2908.14,371.42,3279.56
2022-06-26 00:00:00+08,15,12,27,1514503,1099666,2614169,3094.18,367.18,3461.36
2022-06-26 04:00:00+08,16,11,27,1547440,1082872,2630312,3155.49,381.48,3536.97
2022-06-26 08:00:00+08,16,11,27,1547440,1082872,2630312,3219.49,425.48,3644.97
2022-06-26 12:00:00+08,16,9,25,1547440,803307,2350747,3248.11,336.56,3584.67
2022-06-26 16:00:00+08,15,8,23,1398448,739907,2138355,3268.24,354.07,3622.31
2022-06-26 20:00:00+08,15,8,23,1398448,680760,2079208,3328.2,302.01,3630.21
2022-06-27 00:00:00+08,16,10,26,1549365,976175,2525540,3407.95,339.41,3747.36
2022-06-27 04:00:00+08,16,9,25,1549365,921030,2470395,3120.66,279.24,3399.9
2022-06-27 08:00:00+08,15,9,24,1428431,921030,2349461,3077.04,315.24,3392.28
2022-06-27 12:00:00+08,15,7,22,1428431,837904,2266335,2823.85,137.41,2961.26
2022-06-27 16:00:00+08,14,7,21,1325570,837904,2163474,2729.78,165.41,2895.19
2022-06-27 20:00:00+08,14,9,23,1325570,957922,2283492,2943.42,195.67,3139.09
2022-06-28 00:00:00+08,15,9,24,1427988,957922,2385910,3000.53,231.67,3232.2
2022-06-28 04:00:00+08,15,9,24,1427988,935128,2363116,3022.88,246.09,3268.97
2022-06-28 08:00:00+08,16,10,26,1573515,965359,2538874,3085.4,282.2,3367.6
2022-06-28 12:00:00+08,16,10,26,1573515,965359,2538874,3149.4,322.2,3471.6
2022-06-28 16:00:00+08,15,9,24,1464745,948202,2412947,3108.7,340.39,3449.09
2022-06-28 20:00:00+08,15,9,24,1464745,1005437,2470182,3275.89,310.47,3586.36
2022-06-29 00:00:00+08,15,11,26,1464745,1207028,2671773,3335.88,349.32,3685.2
2022-06-29 04:00:00+08,14,11,25,1398148,1207028,2605176,3319.49,393.32,3712.81
2022-06-29 08:00:00+08,17,13,30,1651952,1341746,2993698,3459.83,443.86,3903.69
2022-06-29 12:00:00+08,18,13,31,1767945,1346372,3114317,3067.56,371.62,3439.18
2022-06-29 16:00:00+08,18,13,31,1767945,1346372,3114317,3139.56,423.62,3563.18
2022-06-29 20:00:00+08,18,15,33,1767945,1420786,3188731,3211.57,478.65,3690.22
2022-06-30 00:00:00+08,19,15,34,1834954,1367897,3202851,3234.59,465.35,3699.94
2022-06-30 04:00:00+08,17,13,30,1662706,1234805,2897511,3106.95,424.79,3531.74
2022-06-30 08:00:00+08,19,13,32,1894900,1186239,3081139,3209.18,440.83,3650.01
2022-06-30 12:00:00+08,19,14,33,1894900,1342090,3236990,3313.38,494.75,3808.13
2022-06-30 16:00:00+08,17,13,30,1780407,1307776,3088183,3247.23,529.32,3776.55
2022-06-30 20:00:00+08,16,14,30,1746212,1355672,3101884,3250.22,546.57,3796.79
2022-07-01 00:00:00+08,16,12,28,1746212,1088315,2834527,3204.36,417.55,3621.91
2022-07-01 04:00:00+08,17,13,30,1865026,1089294,2954320,3408.48,438.08,3846.56
2022-07-01 08:00:00+08,15,13,28,1603473,1089294,2692767,3112.16,490.08,3602.24
2022-07-01 12:00:00+08,15,11,26,1603473,893752,2497225,3064.98,393.33,3458.31
2022-07-01 16:00:00+08,15,11,26,1603473,1105971,2709444,3360.47,389.16,3749.63
2022-07-01 20:00:00+08,15,12,27,1603473,1222046,2825519,3420.46,371.02,3791.48
2022-07-02 00:00:00+08,15,13,28,1603473,1285446,2888919,3480.46,422.97,3903.43
2022-07-02 04:00:00+08,15,13,28,1603473,1285446,2888919,3540.46,474.97,4015.43
2022-07-02 08:00:00+08,15,11,26,1603473,1171632,2775105,3600.42,413.12,4013.54
2022-07-02 12:00:00+08,16,11,27,1730531,1171632,2902163,3664.27,457.12,4121.39
2022-07-02 16:00:00+08,15,11,26,1628113,1171632,2799745,3615.16,501.12,4116.28
2022-07-02 20:00:00+08,16,10,26,1738885,1076971,2815856,3675.57,452.31,4127.88
2022-07-03 00:00:00+08,16,7,23,1738885,717479,2456364,3711.35,266.68,3978.03
2022-07-03 04:00:00+08,16,7,23,1738885,738495,2477380,3863.83,208.86,4072.69
2022-07-03 08:00:00+08,16,9,25,1776642,915963,2692605,3709.26,242.56,3951.82
2022-07-03 12:00:00+08,17,8,25,1827331,858754,2686085,3858.11,179.89,4038
2022-07-03 16:00:00+08,16,7,23,1749385,713194,2462579,3329.78,160.89,3490.67
2022-07-03 20:00:00+08,16,7,23,1749385,675147,2424532,3618.83,134.7,3753.53
2022-07-04 00:00:00+08,15,7,22,1608029,675147,2283176,3205.61,162.7,3368.31
2022-07-04 04:00:00+08,16,8,24,1665859,816503,2482362,3746.17,192.18,3938.35
2022-07-04 08:00:00+08,18,7,25,1808574,764188,2572762,3816.54,193.82,4010.36
2022-07-04 12:00:00+08,19,7,26,1846691,764188,2610879,3890.28,221.82,4112.1
2022-07-04 16:00:00+08,19,7,26,1846691,764188,2610879,3966.28,249.82,4216.1
2022-07-04 20:00:00+08,19,7,26,1846691,764188,2610879,4042.28,277.82,4320.1
2022-07-05 00:00:00+08,20,7,27,1932206,764188,2696394,4120.88,305.82,4426.7
2022-07-05 04:00:00+08,20,7,27,1932206,764188,2696394,4200.88,333.82,4534.7
2022-07-05 08:00:00+08,19,7,26,1860658,764188,2624846,3952.27,361.82,4314.09
2022-07-05 12:00:00+08,19,7,26,1860658,764188,2624846,4028.27,389.82,4418.09
2022-07-05 16:00:00+08,18,8,26,1775970,849974,2625944,4276.05,419.32,4695.37
2022-07-05 20:00:00+08,19,12,31,1840959,1023639,2864598,4521.3,461.37,4982.67
2022-07-06 00:00:00+08,19,12,31,1828009,1023639,2851648,4509.56,509.37,5018.93
2022-07-06 04:00:00+08,18,11,29,1770179,921221,2691400,4414.09,482.96,4897.05
2022-07-06 08:00:00+08,17,11,28,1719490,970886,2690376,4470.04,514.66,4984.7
2022-07-06 12:00:00+08,17,10,27,1719490,897086,2616576,4538.02,479.55,5017.57
2022-07-06 16:00:00+08,17,9,26,1719490,891528,2611018,4292.3,429.78,4722.08
2022-07-06 20:00:00+08,17,7,24,1719490,721746,2441236,4360.29,310.45,4670.74
2022-07-07 00:00:00+08,18,7,25,1746301,637911,2384212,4460.84,232.17,4693.01
2022-07-07 04:00:00+08,19,11,30,1863364,963710,2827074,4534.67,266.52,4801.19
2022-07-07 08:00:00+08,20,10,30,1904947,896701,2801648,4477.76,270.55,4748.31
2022-07-07 12:00:00+08,19,10,29,1787884,896701,2684585,4547.89,310.55,4858.44
2022-07-07 16:00:00+08,19,9,28,1787884,844385,2632269,4623.84,334.69,4958.53
2022-07-07 20:00:00+08,19,11,30,1787884,987484,2775368,4715.82,374.39,5090.21
2022-07-08 00:00:00+08,20,11,31,1839555,987484,2827039,4792.49,418.39,5210.88
2022-07-08 04:00:00+08,19,9,28,1743627,846904,2590531,3940.12,351.91,4292.03
2022-07-08 08:00:00+08,21,11,32,2021253,1070192,3091445,4750.43,391.15,5141.58
2022-07-08 12:00:00+08,21,10,31,2021253,975563,2996816,4834.44,402.54,5236.98
2022-07-08 16:00:00+08,17,10,27,1781763,975563,2757326,4716.4,442.54,5158.94
2022-07-08 20:00:00+08,18,12,30,1844963,1086627,2931590,4695.22,287.28,4982.5
2022-07-09 00:00:00+08,18,13,31,1844963,1160450,3005413,4767.17,277.91,5045.08
2022-07-09 04:00:00+08,17,13,30,1722002,1160450,2882452,4543.83,329.91,4873.74
2022-07-09 08:00:00+08,18,12,30,1790170,1234944,3025114,4874.95,338.07,5213.02
2022-07-09 12:00:00+08,19,12,31,1936384,1234944,3171328,4948.99,386.07,5335.06
2022-07-09 16:00:00+08,20,11,31,2026674,1117881,3144555,4990.88,388.06,5378.94
2022-07-09 20:00:00+08,21,12,33,2145509,1205212,3350721,5077.76,390.57,5468.33
2022-07-10 00:00:00+08,20,12,32,2107392,1205212,3312604,5028.01,438.57,5466.58
2022-07-10 04:00:00+08,19,11,30,2013847,1140223,3154070,4223.92,453.77,4677.69
2022-07-10 08:00:00+08,19,11,30,2013847,1097913,3111760,5099.07,437.07,5536.14
2022-07-10 12:00:00+08,21,10,31,2160791,985397,3146188,4579.26,427.83,5007.09
2022-07-10 16:00:00+08,19,9,28,1987202,844041,2831243,3916.17,310.35,4226.52
2022-07-10 20:00:00+08,20,10,30,2077645,973485,3051130,4267.43,324.77,4592.2
2022-07-11 00:00:00+08,20,10,30,2077645,973485,3051130,4347.43,364.77,4712.2
2022-07-11 04:00:00+08,20,10,30,2077645,952604,3030249,4288,385.77,4673.77
2022-07-11 08:00:00+08,19,10,29,1955821,939664,2895485,4209.1,366.02,4575.12
2022-07-11 12:00:00+08,19,8,27,1955821,855533,2811354,4195.76,321.42,4517.18
2022-07-11 16:00:00+08,17,6,23,1741992,594943,2336935,4012.65,198.93,4211.58
2022-07-11 20:00:00+08,17,6,23,1741992,570651,2312643,4164.58,156.95,4321.53
2022-07-12 00:00:00+08,16,9,25,1639131,836809,2475940,4440.91,192.22,4633.13
2022-07-12 04:00:00+08,16,10,26,1639131,1002184,2641315,4504.94,231.34,4736.28
2022-07-12 08:00:00+08,16,10,26,1639131,1087809,2726940,4633.92,242.5,4876.42
2022-07-12 12:00:00+08,16,11,27,1639131,1117945,2757076,4697.93,285.81,4983.74
2022-07-12 16:00:00+08,16,11,27,1639131,1117945,2757076,4761.93,329.81,5091.74
2022-07-12 20:00:00+08,16,10,26,1639131,994984,2634115,4527.68,288.7,4816.38
2022-07-13 00:00:00+08,15,10,25,1553325,919462,2472787,3941.32,280.01,4221.33
2022-07-13 04:00:00+08,12,9,21,1202782,851155,2053937,3423.82,274.83,3698.65
2022-07-13 08:00:00+08,12,12,24,1202782,1141290,2344072,4437.99,316.41,4754.4
2022-07-13 12:00:00+08,12,13,25,1202782,1287504,2490286,4581.81,366.65,4948.46
2022-07-13 16:00:00+08,12,11,23,1261153,1126616,2387769,4286.77,340.24,4627.01
2022-07-13 20:00:00+08,12,13,25,1261153,1266708,2527861,4435.09,353.47,4788.56
2022-07-14 00:00:00+08,12,14,26,1261153,1283865,2545018,4483.09,409.42,4892.51
2022-07-14 04:00:00+08,13,13,26,1313299,1003550,2316849,4449.26,357.77,4807.03
2022-07-14 08:00:00+08,12,13,25,1222856,1003550,2226406,4413.37,409.77,4823.14
2022-07-14 12:00:00+08,12,12,24,1222856,937222,2160078,4350.84,393.9,4744.74
2022-07-14 16:00:00+08,12,10,22,1193403,799456,1992859,4054.27,352.39,4406.66
2022-07-14 20:00:00+08,11,11,22,1066043,873404,1939447,3474.37,287.4,3761.77
2022-07-15 00:00:00+08,12,11,23,1099259,958819,2058078,3487.4,237.8,3725.2
2022-07-15 04:00:00+08,13,12,25,1139737,1097430,2237167,3538.31,285.72,3824.03
2022-07-15 08:00:00+08,13,11,24,1139737,1033825,2173562,3116.08,248.79,3364.87
2022-07-15 12:00:00+08,13,11,24,1139737,1033825,2173562,3168.08,292.79,3460.87
2022-07-15 16:00:00+08,13,10,23,1139737,981675,2121412,3220.07,315.55,3535.62
2022-07-15 20:00:00+08,12,14,26,1106682,1344896,2451578,3141.22,363.7,3504.92
2022-07-16 00:00:00+08,12,14,26,1106682,1287508,2394190,3232.93,382.88,3615.81
2022-07-16 04:00:00+08,13,13,26,1262533,1247030,2509563,3281.51,410.42,3691.93
2022-07-16 08:00:00+08,13,12,25,1262533,1207672,2470205,3333.6,437.42,3771.02
2022-07-16 12:00:00+08,13,11,24,1262533,999727,2262260,2950.85,332.71,3283.56
2022-07-16 16:00:00+08,13,11,24,1262533,999727,2262260,3002.85,376.71,3379.56
2022-07-16 20:00:00+08,13,9,22,1262533,884544,2147077,3054.8,328.11,3382.91
2022-07-17 00:00:00+08,14,10,24,1418588,1028886,2447474,3107.22,365.25,3472.47
2022-07-17 04:00:00+08,14,10,24,1445907,1090496,2536403,2957.98,378.93,3336.91
2022-07-17 08:00:00+08,13,10,23,1327072,1004411,2331483,2743.32,345.97,3089.29
2022-07-17 12:00:00+08,13,8,21,1327072,855392,2182464,2504.36,242.87,2747.23
2022-07-17 16:00:00+08,13,8,21,1327072,854868,2181940,2741.9,232.45,2974.35
2022-07-17 20:00:00+08,12,7,19,1171017,749510,1920527,2773.44,213.92,2987.36
2022-07-18 00:00:00+08,13,10,23,1204994,1046706,2251700,2821.8,247.78,3069.58
2022-07-18 04:00:00+08,12,9,21,1171778,1011821,2183599,2821.83,194.25,3016.08
2022-07-18 08:00:00+08,11,7,18,1063204,811093,1874297,2210.46,120.97,2331.43
2022-07-18 12:00:00+08,10,8,18,995036,844309,1839345,2112.77,151.48,2264.25
2022-07-18 16:00:00+08,11,8,19,1118317,844309,1962626,2155.95,183.48,2339.43
2022-07-18 20:00:00+08,11,11,22,1118317,1047862,2166179,3024.34,220.47,3244.81
2022-07-19 00:00:00+08,13,11,24,1235670,1047862,2283532,3074.58,264.47,3339.05
2022-07-19 04:00:00+08,14,11,25,1302610,1047862,2350472,3128.02,308.47,3436.49
2022-07-19 08:00:00+08,15,12,27,1407241,1074887,2482128,2682.13,353.62,3035.75
2022-07-19 12:00:00+08,15,12,27,1407241,1187198,2594439,3168.04,377.79,3545.83
2022-07-19 16:00:00+08,14,13,27,1293133,1272033,2565166,2899.94,426.79,3326.73
2022-07-19 20:00:00+08,15,14,29,1311451,1393644,2705095,3287.88,458.49,3746.37
2022-07-20 00:00:00+08,15,14,29,1311451,1393644,2705095,3347.88,514.49,3862.37
2022-07-20 04:00:00+08,16,14,30,1391559,1393644,2785203,3410.92,570.49,3981.41
2022-07-20 08:00:00+08,16,13,29,1391559,1294601,2686160,3474.97,566.93,4041.9
2022-07-20 12:00:00+08,16,11,27,1391559,1186670,2578229,3538.98,468.08,4007.06
2022-07-20 16:00:00+08,16,10,26,1440873,1118502,2559375,3328.99,466.84,3795.83
2022-07-20 20:00:00+08,15,10,25,1400395,953534,2353929,3275.62,323.56,3599.18
2022-07-21 00:00:00+08,17,11,28,1576913,994012,2570925,3483.97,363.89,3847.86
2022-07-21 04:00:00+08,18,12,30,1715795,1107490,2823285,3555.94,410.8,3966.74
2022-07-21 08:00:00+08,18,12,30,1839499,1091494,2930993,3628.94,419.34,4048.28
2022-07-21 12:00:00+08,17,9,26,1683648,723285,2406933,2139.8,309.18,2448.98
2022-07-21 16:00:00+08,14,9,23,1442621,860849,2303470,2169.6,324.3,2493.9
2022-07-21 20:00:00+08,16,10,26,1590269,710457,2300726,2137.05,144.47,2281.52
2022-07-22 00:00:00+08,16,12,28,1590269,856223,2446492,2223.47,186.13,2409.6
2022-07-22 04:00:00+08,17,12,29,1642370,856223,2498593,2291.18,234.13,2525.31
2022-07-22 08:00:00+08,17,10,27,1642370,698498,2340868,2216.56,205.23,2421.79
2022-07-22 12:00:00+08,18,10,28,1710833,698498,2409331,2286.95,245.23,2532.18
2022-07-22 16:00:00+08,18,9,27,1756356,787303,2543659,2323.56,219.56,2543.12
2022-07-22 20:00:00+08,18,13,31,1714520,1063381,2777901,2220.49,192.18,2412.67
2022-07-23 00:00:00+08,18,12,30,1714520,1045063,2759583,2255.67,203.68,2459.35
2022-07-23 04:00:00+08,19,12,31,1856548,1045063,2901611,2329.27,251.68,2580.95
2022-07-23 08:00:00+08,19,11,30,1856548,1113202,2969750,2546,232.98,2778.98
2022-07-23 12:00:00+08,17,9,26,1642793,948852,2591645,2499.93,194.78,2694.71
2022-07-23 16:00:00+08,17,7,24,1642793,855161,2497954,2549.91,188.54,2738.45
2022-07-23 20:00:00+08,17,9,26,1676533,1167174,2843707,2616.84,221.46,2838.3
2022-07-24 00:00:00+08,19,9,28,1826482,1167174,2993656,2688.12,257.46,2945.58
2022-07-24 04:00:00+08,19,10,29,1826482,1234114,3060596,2881.86,297.17,3179.03
2022-07-24 08:00:00+08,19,11,30,1826482,1381135,3207617,2957.83,337.52,3295.35
2022-07-24 12:00:00+08,18,11,29,1727438,1381135,3108573,2938.01,381.52,3319.53
2022-07-24 16:00:00+08,18,11,29,1727438,1381135,3108573,3010.01,425.52,3435.53
2022-07-24 20:00:00+08,18,9,27,1727438,1108995,2836433,2742.8,306.89,3049.69
2022-07-25 00:00:00+08,19,12,31,1777544,1396947,3174491,2877.84,348.24,3226.08
2022-07-25 04:00:00+08,20,13,33,1845740,1465410,3311150,3012.07,399.99,3412.06
2022-07-25 08:00:00+08,20,13,33,1845740,1465410,3311150,3092.07,451.99,3544.06
2022-07-25 12:00:00+08,20,13,33,1845740,1465410,3311150,3172.07,503.99,3676.06
2022-07-25 16:00:00+08,20,13,33,1845740,1465410,3311150,3252.07,555.99,3808.06
2022-07-25 20:00:00+08,18,13,31,1633823,1261639,2895462,2983.59,418.6,3402.19
2022-07-26 00:00:00+08,17,15,32,1566222,1473556,3039778,3211.17,470.84,3682.01
2022-07-26 04:00:00+08,17,16,33,1566222,1489953,3056175,3279.19,532.63,3811.82
2022-07-26 08:00:00+08,17,17,34,1604593,1645455,3250048,2723.34,597.01,3320.35
2022-07-26 12:00:00+08,17,16,33,1604593,1533021,3137614,2791.33,628.92,3420.25
2022-07-26 16:00:00+08,17,14,31,1604593,1329964,2934557,2737.5,582.8,3320.3
2022-07-26 20:00:00+08,17,15,32,1604593,1447476,3052069,3472.93,573.9,4046.83
2022-07-27 00:00:00+08,19,15,34,1780008,1437535,3217543,3544.22,606.32,4150.54
2022-07-27 04:00:00+08,18,13,31,1686941,1166686,2853627,3508.68,441.58,3950.26
2022-07-27 08:00:00+08,18,12,30,1686941,1121679,2808620,3577.22,397.79,3975.01
2022-07-27 12:00:00+08,18,12,30,1686941,1252031,2938972,3649.21,413.94,4063.15
2022-07-27 16:00:00+08,18,12,30,1639825,1252031,2891856,3704.38,461.94,4166.32
2022-07-27 20:00:00+08,17,11,28,1601943,1110651,2712594,3716.33,391.1,4107.43
2022-07-28 00:00:00+08,17,13,30,1601943,1215542,2817485,3867.6,436.56,4304.16
2022-07-28 04:00:00+08,15,13,28,1454439,1215542,2669981,3594.88,488.56,4083.44
2022-07-28 08:00:00+08,15,10,25,1454439,1040042,2494481,3376.58,414.21,3790.79
2022-07-28 12:00:00+08,15,12,27,1454439,1187546,2641985,3788.9,458.59,4247.49
2022-07-28 16:00:00+08,14,8,22,1386243,775064,2161307,3578.61,241.6,3820.21
2022-07-28 20:00:00+08,14,12,26,1386243,972440,2358683,3721.43,280.13,4001.56
2022-07-29 00:00:00+08,16,12,28,1547066,972440,2519506,3782.94,328.13,4111.07
2022-07-29 04:00:00+08,17,13,30,1577222,979324,2556546,3849.12,379.45,4228.57
2022-07-29 08:00:00+08,15,13,28,1355315,979324,2334639,3784.38,431.45,4215.83
2022-07-29 12:00:00+08,15,12,27,1355315,862473,2217788,3206.04,418.07,3624.11
2022-07-29 16:00:00+08,15,11,26,1377869,776583,2154452,2873.09,436.44,3309.53
2022-07-29 20:00:00+08,16,11,27,1428401,887870,2316271,3050.71,337.97,3388.68
2022-07-30 00:00:00+08,17,12,29,1533759,1001348,2535107,3115.21,385.77,3500.98
2022-07-30 04:00:00+08,16,12,28,1503603,990565,2494168,3157.05,402.92,3559.97
2022-07-30 08:00:00+08,16,11,27,1425114,867088,2292202,3217.81,351.86,3569.67
2022-07-30 12:00:00+08,16,12,28,1459877,997661,2457538,3132.17,397.86,3530.03
2022-07-30 16:00:00+08,16,11,27,1459877,930976,2390853,3127.84,425.34,3553.18
2022-07-30 20:00:00+08,14,11,25,1231238,1052771,2284009,2922.16,371.22,3293.38
2022-07-31 00:00:00+08,16,10,26,1311468,916983,2228451,3119.62,182.94,3302.56
2022-07-31 04:00:00+08,15,12,27,1260936,1162978,2423914,3173.26,229.54,3402.8
2022-07-31 08:00:00+08,16,11,27,1296294,1121133,2417427,3275.12,185.84,3460.96
2022-07-31 12:00:00+08,17,11,28,1397955,1121133,2519088,3342.32,229.84,3572.16
2022-07-31 16:00:00+08,17,11,28,1397955,1121133,2519088,3410.32,273.84,3684.16
2022-07-31 20:00:00+08,17,10,27,1397955,1104532,2502487,3450.35,255.46,3705.81
2022-08-01 00:00:00+08,16,9,25,1334961,991054,2326015,3493.22,243.67,3736.89
2022-08-01 04:00:00+08,16,10,26,1334961,1088915,2423876,3584.42,252.44,3836.86
2022-08-01 08:00:00+08,16,10,26,1334961,1088915,2423876,3648.42,292.44,3940.86
2022-08-01 12:00:00+08,16,9,25,1334961,1025921,2360882,3685.22,322.55,4007.77
2022-08-01 16:00:00+08,15,9,24,1266589,1025921,2292510,3538.37,358.55,3896.92
2022-08-01 20:00:00+08,14,11,25,1236339,1117296,2353635,3520.79,350.18,3870.97
2022-08-02 00:00:00+08,13,11,24,1184255,1020962,2205217,3211.12,349.62,3560.74
2022-08-02 04:00:00+08,14,11,25,1307214,967087,2274301,3290.93,287.88,3578.81
2022-08-02 08:00:00+08,15,12,27,1473205,1019171,2492376,3420.65,333.97,3754.62
2022-08-02 12:00:00+08,16,11,27,1581975,1000853,2582828,3483.82,364.75,3848.57
2022-08-02 16:00:00+08,14,10,24,1450850,1011167,2462017,2922.33,368.81,3291.14
2022-08-02 20:00:00+08,13,11,24,1398062,1121617,2519679,3337.25,393.94,3731.19
2022-08-03 00:00:00+08,13,13,26,1398062,1180763,2578825,3540.93,372.59,3913.52
2022-08-03 04:00:00+08,14,13,27,1525138,1180763,2705901,3594.57,424.59,4019.16
2022-08-03 08:00:00+08,14,13,27,1525138,1214830,2739968,3650.61,417.8,4068.41
2022-08-03 12:00:00+08,15,13,28,1626985,1100000,2726985,3707.56,410.41,4117.97
2022-08-03 16:00:00+08,14,10,24,1591627,887103,2478730,3527.98,268.98,3796.96
2022-08-03 20:00:00+08,15,12,27,1662918,984031,2646949,3567.23,292.75,3859.98
2022-08-04 00:00:00+08,15,13,28,1662918,1048761,2711679,3627.22,344.22,3971.44
2022-08-04 04:00:00+08,14,12,26,1561257,980389,2541646,3381.5,339.91,3721.41
2022-08-04 08:00:00+08,13,12,25,1481149,966027,2447176,3090.47,256.04,3346.51
2022-08-04 12:00:00+08,13,11,24,1481149,820467,2301616,3142.49,257.62,3400.11
2022-08-04 16:00:00+08,15,12,27,1707565,1049343,2756908,3201.21,284.02,3485.23
2022-08-04 20:00:00+08,14,12,26,1584606,1095156,2679762,3487.76,283.79,3771.55
2022-08-05 00:00:00+08,14,12,26,1584606,1126107,2710713,3613.25,269.35,3882.6
2022-08-05 04:00:00+08,14,12,26,1584606,1151696,2736302,3576.81,225.38,3802.19
2022-08-05 08:00:00+08,13,10,23,1418615,957699,2376314,2620.75,199.22,2819.97
2022-08-05 12:00:00+08,13,10,23,1418615,957699,2376314,2672.75,239.22,2911.97
2022-08-05 16:00:00+08,11,9,20,1246644,1029690,2276334,2445.78,223.59,2669.37
2022-08-05 20:00:00+08,12,11,23,1331479,1201661,2533140,2854.78,262.29,3117.07
2022-08-06 00:00:00+08,12,9,21,1331479,984182,2315661,2902.78,182.47,3085.25
2022-08-06 04:00:00+08,12,11,23,1331479,1127056,2458535,2950.77,220.97,3171.74
2022-08-06 08:00:00+08,13,10,23,1433297,1120172,2553469,3000.62,232.7,3233.32
2022-08-06 12:00:00+08,14,10,24,1538459,1120172,2658631,3056.08,272.7,3328.78
2022-08-06 16:00:00+08,15,10,25,1588991,1120172,2709163,3113.74,312.7,3426.44
2022-08-06 20:00:00+08,15,10,25,1600259,1076023,2676282,3148.91,301.11,3450.02
2022-08-07 00:00:00+08,15,10,25,1567972,1097864,2665836,2838.08,321.01,3159.09
2022-08-07 04:00:00+08,16,10,26,1591415,1097864,2689279,2900.1,361.01,3261.11
2022-08-07 08:00:00+08,16,11,27,1591415,1239886,2831301,3371.13,403.49,3774.62
2022-08-07 12:00:00+08,16,11,27,1591415,1239886,2831301,3435.13,447.49,3882.62
2022-08-07 16:00:00+08,16,9,25,1591415,1067915,2659330,3135.69,400.76,3536.45
2022-08-07 20:00:00+08,16,8,24,1591415,943093,2534508,3170.97,351.78,3522.75
2022-08-08 00:00:00+08,16,8,24,1591415,943093,2534508,3234.97,383.78,3618.75
2022-08-08 04:00:00+08,17,8,25,1608572,943093,2551665,3299.44,415.78,3715.22
2022-08-08 08:00:00+08,17,8,25,1608572,943093,2551665,3367.44,447.78,3815.22
2022-08-08 12:00:00+08,18,7,25,1688680,902993,2591673,3438.91,462.13,3901.04
2022-08-08 16:00:00+08,18,6,24,1688680,756406,2445086,3510.98,391,3901.98
2022-08-08 20:00:00+08,16,5,21,1511072,633447,2144519,3322.18,322.22,3644.4
2022-08-09 00:00:00+08,15,6,21,1431607,683979,2115586,2892.32,342.77,3235.09
2022-08-09 04:00:00+08,16,7,23,1517498,811055,2328553,3099.98,368.58,3468.56
2022-08-09 08:00:00+08,16,9,25,1517498,917388,2434886,3720.35,401.49,4121.84
2022-08-09 12:00:00+08,17,9,26,1583428,917388,2500816,3787.17,437.49,4224.66
2022-08-09 16:00:00+08,17,9,26,1583428,917388,2500816,3855.17,473.49,4328.66
2022-08-09 20:00:00+08,15,10,25,1458167,770661,2228828,3692.17,300.62,3992.79
2022-08-10 00:00:00+08,15,11,26,1458167,800034,2258201,3821,251.73,4072.73
2022-08-10 04:00:00+08,14,13,27,1441010,1028928,2469938,3976.84,302.89,4279.73
2022-08-10 08:00:00+08,13,12,25,1339163,877195,2216358,3512.58,254.85,3767.43
2022-08-10 12:00:00+08,14,11,25,1389860,721963,2111823,3565.29,197.51,3762.8
2022-08-10 16:00:00+08,13,9,22,1323930,583813,1907743,3533.31,177.45,3710.76
2022-08-10 20:00:00+08,12,10,22,1224864,731130,1955994,2687.15,167.91,2855.06
2022-08-11 00:00:00+08,12,10,22,1224864,742001,1966865,2666.36,185.68,2852.04
2022-08-11 04:00:00+08,14,10,24,1419123,827264,2246387,3270.88,196.44,3467.32
2022-08-11 08:00:00+08,15,11,26,1530737,908820,2439557,3328.59,239.8,3568.39
2022-08-11 12:00:00+08,15,11,26,1530737,971106,2501843,3336.78,257.18,3593.96
2022-08-11 16:00:00+08,14,9,23,1444846,758220,2203066,3189.22,195.89,3385.11
2022-08-11 20:00:00+08,15,10,25,1547707,809552,2357259,3314.15,198.08,3512.23
2022-08-12 00:00:00+08,15,12,27,1547707,887692,2435399,3374.14,242.18,3616.32
2022-08-12 04:00:00+08,14,13,27,1409330,1034484,2443814,3126.58,291.4,3417.98
2022-08-12 08:00:00+08,15,12,27,1539903,932637,2472540,3008.89,306.09,3314.98
2022-08-12 12:00:00+08,15,14,29,1539903,1217710,2757613,3381.41,358.44,3739.85
2022-08-12 16:00:00+08,14,12,26,1420399,1136399,2556798,3245.84,371.53,3617.37
2022-08-12 20:00:00+08,14,11,25,1420399,1006001,2426400,3380.1,279.02,3659.12
2022-08-13 00:00:00+08,15,14,29,1561372,1344600,2905972,3437.87,329.54,3767.41
2022-08-13 04:00:00+08,15,13,28,1561372,1278670,2840042,3464.89,327.71,3792.6
2022-08-13 08:00:00+08,15,13,28,1561372,1251720,2813092,2970.28,296.83,3267.11
2022-08-13 12:00:00+08,14,12,26,1481264,1180464,2661728,2906.79,309.08,3215.87
2022-08-13 16:00:00+08,14,11,25,1481264,1150229,2631493,2962.79,335.95,3298.74
2022-08-13 20:00:00+08,14,11,25,1481264,1111806,2593070,2928.72,290.68,3219.4
2022-08-14 00:00:00+08,14,12,26,1481264,1200577,2681841,3119.19,253.85,3373.04
2022-08-14 04:00:00+08,15,12,27,1598436,1200577,2799013,3178.67,301.85,3480.52
2022-08-14 08:00:00+08,15,12,27,1598436,1200577,2799013,3238.67,349.85,3588.52
2022-08-14 12:00:00+08,15,11,26,1598436,1053881,2652317,3298.63,348.46,3647.09
2022-08-14 16:00:00+08,16,11,27,1725796,1053881,2779677,3359.72,392.46,3752.18
2022-08-14 20:00:00+08,16,10,26,1725796,1017196,2742992,3224.97,362.19,3587.16
2022-08-15 00:00:00+08,16,10,26,1725796,960667,2686463,3288.92,295.47,3584.39
2022-08-15 04:00:00+08,15,8,23,1584823,872043,2456866,3299.19,259.35,3558.54
2022-08-15 08:00:00+08,15,7,22,1584823,733666,2318489,3046.43,220.38,3266.81
2022-08-15 12:00:00+08,14,9,23,1473209,1031715,2504924,3066.03,248.9,3314.93
2022-08-15 16:00:00+08,14,9,23,1473209,1031715,2504924,3122.03,284.9,3406.93
2022-08-15 20:00:00+08,15,10,25,1524988,1139007,2663995,3290.52,207.1,3497.62
2022-08-16 00:00:00+08,16,12,28,1635091,1350080,2985171,3352.41,290.96,3643.37
2022-08-16 04:00:00+08,16,11,27,1635091,1246412,2881503,3416.44,283.28,3699.72
2022-08-16 08:00:00+08,16,12,28,1635091,1341012,2976103,3480.51,329.71,3810.22
2022-08-16 12:00:00+08,16,12,28,1635091,1341012,2976103,3544.51,377.71,3922.22
2022-08-16 16:00:00+08,16,12,28,1672828,1341012,3013840,3269.08,425.71,3694.79
2022-08-16 20:00:00+08,16,14,30,1672828,1484077,3156905,3678.33,477.2,4155.53
2022-08-17 00:00:00+08,16,13,29,1672828,1403969,3076797,3607.81,460.22,4068.03
2022-08-17 04:00:00+08,15,13,28,1622131,1348145,2970276,3511.15,456.98,3968.13
2022-08-17 08:00:00+08,14,13,27,1480103,1277304,2757407,2965.4,438.16,3403.56
2022-08-17 12:00:00+08,14,11,25,1480103,1077138,2557241,3187.06,324.14,3511.2
2022-08-17 16:00:00+08,11,9,20,1180579,888768,2069347,3246.01,260.12,3506.13
2022-08-17 20:00:00+08,11,14,25,1180579,1339004,2519583,3563.76,302.19,3865.95
2022-08-18 00:00:00+08,11,14,25,1180579,1339004,2519583,3607.76,358.19,3965.95
2022-08-18 04:00:00+08,13,14,27,1240872,1339004,2579876,3653.99,414.19,4068.18
2022-08-18 08:00:00+08,12,12,24,1130769,1160704,2291473,3538.74,349.1,3887.84
2022-08-18 12:00:00+08,13,12,25,1239769,1193615,2433384,3587.95,370.69,3958.64
2022-08-18 16:00:00+08,12,10,22,1158192,1057061,2215253,2973.15,375.92,3349.07
2022-08-18 20:00:00+08,12,11,23,1158192,1132543,2290735,3452.85,360.53,3813.38
2022-08-19 00:00:00+08,14,11,25,1385562,1132543,2518105,3502.55,404.53,3907.08
2022-08-19 04:00:00+08,14,11,25,1385562,1132543,2518105,3558.55,448.53,4007.08
2022-08-19 08:00:00+08,15,12,27,1527582,1139427,2667009,3617.87,493.47,4111.34
2022-08-19 12:00:00+08,15,12,27,1567576,1139427,2707003,3319.92,541.47,3861.39
2022-08-19 16:00:00+08,15,10,25,1567576,978890,2546466,3379.88,461.59,3841.47
2022-08-19 20:00:00+08,16,12,28,1600513,1046266,2646779,3381.19,401.44,3782.63
2022-08-20 00:00:00+08,16,12,28,1600513,1101507,2702020,3814.87,420.85,4235.72
2022-08-20 04:00:00+08,17,12,29,1740659,1101507,2842166,3882.65,468.85,4351.5
2022-08-20 08:00:00+08,17,12,29,1702502,1176217,2878719,3860.78,495.4,4356.18
2022-08-20 12:00:00+08,16,10,26,1592767,1031640,2624407,2983.33,484.93,3468.26
2022-08-20 16:00:00+08,16,7,23,1592767,649511,2242278,2914.14,310.33,3224.47
2022-08-20 20:00:00+08,14,8,22,1412924,809505,2222429,2672.41,130.53,2802.94
2022-08-21 00:00:00+08,14,8,22,1412924,774827,2187751,2758,99.76,2857.76
2022-08-21 04:00:00+08,14,9,23,1412924,921733,2334657,2851.3,135.62,2986.92
2022-08-21 08:00:00+08,14,8,22,1412924,870864,2283788,2907.3,134.53,3041.83
2022-08-21 12:00:00+08,13,8,21,1285564,870864,2156428,2798.26,166.53,2964.79
2022-08-21 16:00:00+08,12,8,20,1251291,852698,2103989,2565.07,125.74,2690.81
2022-08-21 20:00:00+08,10,10,20,1056471,927162,1983633,2520.14,141.74,2661.88
2022-08-22 00:00:00+08,10,12,22,1056471,1121982,2178453,2716.26,183.23,2899.49
2022-08-22 04:00:00+08,10,12,22,1056471,1121982,2178453,2756.26,231.23,2987.49
2022-08-22 08:00:00+08,11,10,21,1167786,1004082,2171868,2465.14,230.8,2695.94
2022-08-22 12:00:00+08,11,10,21,1167786,1004082,2171868,2509.14,270.8,2779.94
2022-08-22 16:00:00+08,10,8,18,1059436,757809,1817245,2495.41,216.88,2712.29
2022-08-22 20:00:00+08,11,9,20,1186512,837591,2024103,2342.6,197.03,2539.63
2022-08-23 00:00:00+08,11,10,21,1186512,928225,2114737,2386.64,233.13,2619.77
2022-08-23 04:00:00+08,11,9,20,1186512,828872,2015384,2393.35,189.93,2583.28
2022-08-23 08:00:00+08,12,9,21,1254638,822475,2077113,2369.27,193.18,2562.45
2022-08-23 12:00:00+08,14,9,23,1387836,859158,2246994,2337.05,196.26,2533.31
2022-08-23 16:00:00+08,11,8,19,1149476,828927,1978403,1684.66,211.04,1895.7
2022-08-23 20:00:00+08,11,13,24,1149476,1046316,2195792,2386.45,227.28,2613.73
2022-08-24 00:00:00+08,11,13,24,1149476,1046316,2195792,2430.45,279.28,2709.73
2022-08-24 04:00:00+08,10,12,22,1053373,1006958,2060331,2057.82,321.56,2379.38
2022-08-24 08:00:00+08,9,12,21,913227,956554,1869781,2313.69,282.93,2596.62
2022-08-24 12:00:00+08,9,13,22,913227,1110074,2023301,2349.68,334.6,2684.28
2022-08-24 16:00:00+08,9,12,21,966045,1007240,1973285,2351.08,341.84,2692.92
2022-08-24 20:00:00+08,11,13,24,1062684,1074221,2136905,2429.49,244.82,2674.31
2022-08-25 00:00:00+08,12,15,27,1178384,1228170,2406554,2591.5,300.85,2892.35
2022-08-25 04:00:00+08,12,15,27,1178384,1228170,2406554,2639.5,360.85,3000.35
2022-08-25 08:00:00+08,12,15,27,1178384,1309400,2487784,2687.46,382.67,3070.13
2022-08-25 12:00:00+08,12,13,25,1178384,1176202,2354586,2435.79,361.52,2797.31
2022-08-25 16:00:00+08,11,11,22,1161148,1051406,2212554,2462.35,328.38,2790.73
2022-08-25 20:00:00+08,11,11,22,1161148,982386,2143534,2530.01,326.78,2856.79
2022-08-26 00:00:00+08,10,12,22,1052721,1075952,2128673,1798.29,298.68,2096.97
2022-08-26 04:00:00+08,11,11,22,1198248,996529,2194777,1841.13,278.67,2119.8
2022-08-26 08:00:00+08,12,10,22,1297766,900426,2198192,1465.3,274.66,1739.96
2022-08-26 12:00:00+08,11,10,21,1182066,991617,2173683,1816.96,300.05,2117.01
2022-08-26 16:00:00+08,10,9,19,1061122,987041,2048163,1814.84,272.9,2087.74
2022-08-26 20:00:00+08,10,10,20,1061122,1042083,2103205,1906.11,254.22,2160.33
2022-08-27 00:00:00+08,10,10,20,1061122,1105386,2166508,1946.17,269.88,2216.05
2022-08-27 04:00:00+08,11,11,22,1100540,1217557,2318097,1989.78,313.14,2302.92
2022-08-27 08:00:00+08,12,9,21,1150628,1099639,2250267,2036.12,275.35,2311.47
2022-08-27 12:00:00+08,12,9,21,1150628,1099639,2250267,2084.12,311.35,2395.47
2022-08-27 16:00:00+08,10,8,18,876881,959493,1836374,1759.7,279.76,2039.46
2022-08-27 20:00:00+08,10,10,20,876881,1165056,2041937,2064.69,181.89,2246.58
2022-08-28 00:00:00+08,10,10,20,876881,1165056,2041937,2104.69,221.89,2326.58
2022-08-28 04:00:00+08,9,9,18,791049,1056629,1847678,1370.03,218.73,1588.76
2022-08-28 08:00:00+08,9,10,19,791049,1142461,1933510,1817.96,256.36,2074.32
2022-08-28 12:00:00+08,9,10,19,791049,1142461,1933510,1853.96,296.36,2150.32
2022-08-28 16:00:00+08,9,10,19,793105,1142461,1935566,1865.57,336.36,2201.93
2022-08-28 20:00:00+08,9,10,19,793105,1097358,1890463,1826.93,256.76,2083.69
2022-08-29 00:00:00+08,9,9,18,817393,986550,1803943,1720.16,193.22,1913.38
2022-08-29 04:00:00+08,11,8,19,1073395,855977,1929372,1763.72,177.06,1940.78
2022-08-29 08:00:00+08,13,9,22,1285139,935380,2220519,1917.53,213.03,2130.56
2022-08-29 12:00:00+08,13,8,21,1285139,789853,2074992,1928.26,207.41,2135.67
2022-08-29 16:00:00+08,13,8,21,1285139,789853,2074992,1980.26,239.41,2219.67
2022-08-29 20:00:00+08,12,7,19,1181448,643711,1825159,1548.05,139.76,1687.81
2022-08-30 00:00:00+08,14,8,22,1357817,747402,2105219,1626.41,168.62,1795.03
2022-08-30 04:00:00+08,15,9,24,1496236,892790,2389026,1395.37,203.7,1599.07
2022-08-30 08:00:00+08,15,12,27,1496236,1140346,2636582,1748.66,245.07,1993.73
2022-08-30 12:00:00+08,16,11,27,1606236,1013270,2619506,1690,228.27,1918.27
2022-08-30 16:00:00+08,16,10,26,1563553,986459,2550012,1740.99,249.12,1990.11
2022-08-30 20:00:00+08,15,12,27,1524135,1185086,2709221,1729.55,292.1,2021.65
2022-08-31 00:00:00+08,15,13,28,1524135,1262406,2786541,1883.1,323.92,2207.02
2022-08-31 04:00:00+08,15,13,28,1524135,1262406,2786541,1943.1,375.92,2319.02
2022-08-31 08:00:00+08,16,13,29,1595530,1262406,2857936,2006.9,427.92,2434.82
2022-08-31 12:00:00+08,16,13,29,1525805,1270700,2796505,1555.55,453.34,2008.89
2022-08-31 16:00:00+08,16,12,28,1525805,1153637,2679442,1619.48,441,2060.48
2022-08-31 20:00:00+08,17,12,29,1629473,1016007,2645480,1685.04,375.51,2060.55
2022-09-01 00:00:00+08,18,13,31,1764066,1127322,2891388,1954.54,425.78,2380.32
2022-09-01 04:00:00+08,18,14,32,1764066,1198578,2962644,2061.99,478.54,2540.53
2022-09-01 08:00:00+08,18,13,31,1764066,1101598,2865664,2134.05,473.43,2607.48
2022-09-01 12:00:00+08,18,11,29,1764066,977492,2741558,2112.46,445.6,2558.06
2022-09-01 16:00:00+08,16,9,25,1650821,802807,2453628,1957.63,356.32,2313.95
2022-09-01 20:00:00+08,16,10,26,1650821,888021,2538842,1914.99,308.17,2223.16
2022-09-02 00:00:00+08,16,12,28,1597351,964482,2561833,1999.92,242.31,2242.23
2022-09-02 04:00:00+08,15,13,28,1555761,1103389,2659150,2121.62,291.65,2413.27
2022-09-02 08:00:00+08,15,13,28,1555761,1110788,2666549,2225.7,306.87,2532.57
2022-09-02 12:00:00+08,14,13,27,1474590,1110788,2585378,2184.86,358.87,2543.73
2022-09-02 16:00:00+08,12,11,23,1258580,981205,2239785,2099.94,280.4,2380.34
2022-09-02 20:00:00+08,13,10,23,1309355,872390,2181745,1967.97,142.52,2110.49
2022-09-03 00:00:00+08,13,12,25,1309355,991360,2300715,2019.94,185.66,2205.6
2022-09-03 04:00:00+08,13,13,26,1309355,1072531,2381886,2185.14,237.32,2422.46
2022-09-03 08:00:00+08,13,9,22,1299811,850942,2150753,1995.09,149.13,2144.22
2022-09-03 12:00:00+08,12,10,22,1196038,964154,2160192,2016.48,185.44,2201.92
2022-09-03 16:00:00+08,12,11,23,1196038,1076038,2272076,2064.52,225.77,2290.29
2022-09-03 20:00:00+08,12,10,22,1196038,1009230,2205268,2261.45,222.91,2484.36
2022-09-04 00:00:00+08,12,10,22,1196038,987193,2183231,2288.02,233.85,2521.87
2022-09-04 04:00:00+08,12,10,22,1196038,1021722,2217760,2222.87,248.5,2471.37
2022-09-04 08:00:00+08,12,11,23,1196038,1042829,2238867,2270.88,232.76,2503.64
2022-09-04 12:00:00+08,12,12,24,1196038,1163763,2359801,2318.89,279.21,2598.1
2022-09-04 16:00:00+08,13,12,25,1262859,1163763,2426622,2369.35,327.21,2696.56
2022-09-04 20:00:00+08,14,11,25,1304442,1100363,2404805,2422.19,355.2,2777.39
2022-09-05 00:00:00+08,15,11,26,1320839,1100363,2421202,2481.94,399.2,2881.14
2022-09-05 04:00:00+08,14,9,23,1221321,952633,2173954,2196.22,364.27,2560.49
2022-09-05 08:00:00+08,16,8,24,1398696,855414,2254110,2292.16,297.39,2589.55
2022-09-05 12:00:00+08,16,7,23,1448542,821219,2269761,2246.67,268.58,2515.25
2022-09-05 16:00:00+08,15,7,22,1432145,821219,2253364,2290.9,296.58,2587.48
2022-09-05 20:00:00+08,15,7,22,1432145,707080,2139225,2351.11,170.4,2521.51
2022-09-06 00:00:00+08,14,6,20,1322145,591380,1913525,2253.88,152.08,2405.96
2022-09-06 04:00:00+08,15,6,21,1349016,591380,1940396,2311.01,176.08,2487.09
2022-09-06 08:00:00+08,15,6,21,1349016,591380,1940396,2371.01,200.08,2571.09
2022-09-06 12:00:00+08,15,6,21,1349016,591380,1940396,2431.01,224.08,2655.09
2022-09-06 16:00:00+08,14,6,20,1321802,591380,1913182,2429.88,248.08,2677.96
2022-09-06 20:00:00+08,14,13,27,1321802,1225139,2546941,2728.66,285.77,3014.43
2022-09-07 00:00:00+08,15,13,28,1420888,1225139,2646027,2828.26,337.77,3166.03
2022-09-07 04:00:00+08,15,14,29,1420888,1277454,2698342,2888.24,393.21,3281.45
2022-09-07 08:00:00+08,17,14,31,1645431,1277454,2922885,2951.74,449.21,3400.95
2022-09-07 12:00:00+08,16,15,31,1594931,1312158,2907089,2817.87,506.19,3324.06
2022-09-07 16:00:00+08,16,13,29,1594931,1210783,2805714,2828.02,523.87,3351.89
2022-09-07 20:00:00+08,16,13,29,1594931,1268800,2863731,3084.87,527.04,3611.91
2022-09-08 00:00:00+08,16,13,29,1509783,1268800,2778583,2982.39,579.04,3561.43
2022-09-08 04:00:00+08,16,13,29,1509783,1363587,2873370,3192.51,577.18,3769.69
2022-09-08 08:00:00+08,16,11,27,1509783,1172685,2682468,3256.5,469.73,3726.23
2022-09-08 12:00:00+08,17,10,27,1625780,1122185,2747965,3115.48,495.85,3611.33
2022-09-08 16:00:00+08,16,9,25,1559302,1012185,2571487,2959.41,488.3,3447.71
2022-09-08 20:00:00+08,16,10,26,1584010,1071055,2655065,2511.93,370.26,2882.19
2022-09-09 00:00:00+08,17,10,27,1685857,996890,2682747,2788.94,357.64,3146.58
2022-09-09 04:00:00+08,17,9,26,1685857,944575,2630432,2856.89,346.21,3203.1
2022-09-09 08:00:00+08,17,11,28,1685857,1082032,2767889,2924.83,386.21,3311.04
2022-09-09 12:00:00+08,18,12,30,1780564,1221367,3001931,2996.83,432.43,3429.26
2022-09-09 16:00:00+08,17,11,28,1675206,1126702,2801908,2847.76,387.22,3234.98
2022-09-09 20:00:00+08,16,12,28,1573359,1116899,2690258,3001.95,334.32,3336.27
2022-09-10 00:00:00+08,15,10,25,1522584,876806,2399390,2892.08,195.36,3087.44
2022-09-10 04:00:00+08,15,13,28,1522584,1037593,2560177,3155.76,239.12,3394.88
2022-09-10 08:00:00+08,17,14,31,1735080,1051396,2786476,3219.57,294.48,3514.05
2022-09-10 12:00:00+08,18,11,29,1802681,967128,2769809,3024.48,227.8,3252.28
2022-09-10 16:00:00+08,17,10,27,1761098,958963,2720061,2955.65,259.75,3215.4
2022-09-10 20:00:00+08,17,12,29,1761098,1125415,2886513,2854.13,241.03,3095.16
2022-09-11 00:00:00+08,17,11,28,1761098,897090,2658188,3068.05,211,3279.05
2022-09-11 04:00:00+08,19,11,30,1894951,897090,2792041,3143.11,255,3398.11
2022-09-11 08:00:00+08,20,12,32,1967255,1027663,2994918,3221.1,300.17,3521.27
2022-09-11 12:00:00+08,21,10,31,2080327,963085,3043412,3128.42,283.15,3411.57
2022-09-11 16:00:00+08,21,8,29,2080327,873074,2953401,3212.4,278.58,3490.98
2022-09-11 20:00:00+08,21,10,31,2080327,998257,3078584,3296.4,314.97,3611.37
2022-09-12 00:00:00+08,21,10,31,2080327,998257,3078584,3380.4,354.97,3735.37
2022-09-12 04:00:00+08,20,8,28,1985620,762326,2747946,3288.74,256.02,3544.76
2022-09-12 08:00:00+08,20,6,26,1985620,650248,2635868,3264.01,141.11,3405.12
2022-09-12 12:00:00+08,20,6,26,1985620,650248,2635868,3344.01,165.11,3509.12
2022-09-12 16:00:00+08,18,7,25,1761077,794308,2555385,3164.45,189.39,3353.84
2022-09-12 20:00:00+08,18,8,26,1762534,911943,2674477,3320.58,169.19,3489.77
2022-09-13 00:00:00+08,18,7,25,1822013,724318,2546331,3274.11,145.97,3420.08
2022-09-13 04:00:00+08,18,9,27,1822013,826094,2648107,3531.85,178.59,3710.44
2022-09-13 08:00:00+08,19,9,28,1944974,826094,2771068,3606.99,214.59,3821.58
2022-09-13 12:00:00+08,19,8,27,1944974,703282,2648256,3815.06,181.88,3996.94
2022-09-13 16:00:00+08,16,8,24,1689076,703282,2392358,3553.91,213.88,3767.79
2022-09-13 20:00:00+08,16,9,25,1689076,802131,2491207,3617.88,246.15,3864.03
2022-09-14 00:00:00+08,15,10,25,1636930,878268,2515198,3926.97,199.62,4126.59
2022-09-14 04:00:00+08,15,10,25,1636930,973953,2610883,3986.96,217.03,4203.99
2022-09-14 08:00:00+08,15,11,26,1636930,1026099,2663029,4079.19,260.92,4340.11
2022-09-14 12:00:00+08,15,11,26,1636930,1009572,2646502,3953.46,271.49,4224.95
2022-09-14 16:00:00+08,13,9,22,1525263,875072,2400335,3555.6,240.48,3796.08
2022-09-14 20:00:00+08,13,10,23,1525263,838456,2363719,3610.18,207.98,3818.16
2022-09-15 00:00:00+08,13,10,23,1505148,853911,2359059,3328.21,231.5,3559.71
2022-09-15 04:00:00+08,13,10,23,1505148,853911,2359059,3380.21,271.5,3651.71
2022-09-15 08:00:00+08,12,11,23,1363598,971006,2334604,3189.33,313,3502.33
2022-09-15 12:00:00+08,13,10,23,1479591,1038294,2517885,3896.08,318.44,4214.52
2022-09-15 16:00:00+08,12,10,22,1348557,1038294,2386851,3819.89,358.44,4178.33
2022-09-15 20:00:00+08,12,13,25,1348557,1239827,2588384,3999.09,404.12,4403.21
2022-09-16 00:00:00+08,11,13,24,1225596,1152004,2377600,3911.05,365.48,4276.53
2022-09-16 04:00:00+08,12,13,25,1267179,1176116,2443295,4025.26,363.88,4389.14
2022-09-16 08:00:00+08,12,13,25,1267179,1176116,2443295,4073.26,415.88,4489.14
2022-09-16 12:00:00+08,13,12,25,1375949,1108515,2484464,4017.68,428.47,4446.15
2022-09-16 16:00:00+08,11,11,22,1186766,1078310,2265076,3565.56,430.87,3996.43
2022-09-16 20:00:00+08,11,12,23,1186766,1082492,2269258,3703.53,351.56,4055.09
2022-09-17 00:00:00+08,13,13,26,1400527,1186160,2586687,4082.83,401.13,4483.96
2022-09-17 04:00:00+08,15,13,28,1694015,1235338,2929353,3928.67,376.61,4305.28
2022-09-17 08:00:00+08,15,11,26,1694015,1146992,2841007,3878.42,334.79,4213.21
2022-09-17 12:00:00+08,14,10,24,1547424,1000220,2547644,3923.13,295.46,4218.59
2022-09-17 16:00:00+08,13,10,23,1438654,1015777,2454431,3834.92,292.54,4127.46
2022-09-17 20:00:00+08,12,10,22,1371484,1046087,2417571,3482.94,248.79,3731.73
2022-09-18 00:00:00+08,12,12,24,1371484,1167159,2538643,3530.97,262.37,3793.34
2022-09-18 04:00:00+08,13,12,25,1525295,1186143,2711438,3609.69,308.85,3918.54
2022-09-18 08:00:00+08,14,12,26,1587329,1186143,2773472,3635,356.85,3991.85
2022-09-18 12:00:00+08,14,10,24,1626157,975769,2601926,2799.74,311.32,3111.06
2022-09-18 16:00:00+08,14,10,24,1626157,1105287,2731444,2856.26,318.2,3174.46
2022-09-18 20:00:00+08,14,14,28,1626157,1382360,3008517,3155.56,364.1,3519.66
2022-09-19 00:00:00+08,13,14,27,1529177,1382360,2911537,3115.23,420.1,3535.33
2022-09-19 04:00:00+08,13,13,26,1529177,1315190,2844367,3139.85,449.02,3588.87
2022-09-19 08:00:00+08,13,14,27,1529177,1412170,2941347,3294.27,502.93,3797.2
2022-09-19 12:00:00+08,11,14,25,1266388,1412170,2678558,3020.88,558.93,3579.81
2022-09-19 16:00:00+08,10,13,23,1162740,1308502,2471242,2527.69,549.42,3077.11
2022-09-19 20:00:00+08,11,13,24,1309646,1283159,2592805,2840.49,450.86,3291.35
2022-09-20 00:00:00+08,11,13,24,1277569,1301292,2578861,2646.83,429.64,3076.47
2022-09-20 04:00:00+08,12,13,25,1385919,1301261,2687180,2690.97,379.4,3070.37
2022-09-20 08:00:00+08,12,14,26,1385919,1400347,2786266,3100.96,433.05,3534.01
2022-09-20 12:00:00+08,12,12,24,1385919,1355379,2741298,3148.96,434.83,3583.79
2022-09-20 16:00:00+08,12,11,23,1385919,1302591,2688510,3196.96,437.13,3634.09
2022-09-20 20:00:00+08,13,13,26,1516492,1463914,2980406,3247.33,485.8,3733.13
2022-09-21 00:00:00+08,13,13,26,1460209,1463914,2924123,3237.22,537.8,3775.02
2022-09-21 04:00:00+08,13,11,24,1460209,1215686,2675895,3255.89,469.22,3725.11
2022-09-21 08:00:00+08,14,11,25,1500687,1245626,2746313,3035.37,476.98,3512.35
2022-09-21 12:00:00+08,13,9,22,1387615,934671,2322286,2604.47,304.45,2908.92
2022-09-21 16:00:00+08,12,11,23,1347137,1154655,2501792,2970.72,343.77,3314.49
2022-09-21 20:00:00+08,13,14,27,1446104,1293435,2739539,3034.83,391.13,3425.96
2022-09-22 00:00:00+08,12,14,26,1330111,1293435,2623546,2930.17,447.13,3377.3
2022-09-22 04:00:00+08,11,14,25,1188091,1293435,2481526,2162.83,503.13,2665.96
2022-09-22 08:00:00+08,13,13,26,1308874,1168208,2477082,2353.93,408.99,2762.92
2022-09-22 12:00:00+08,13,11,24,1308874,1024977,2333851,2043.9,390.66,2434.56
2022-09-22 16:00:00+08,12,9,21,1229471,811491,2040962,1981.83,316.42,2298.25
2022-09-22 20:00:00+08,11,10,21,1178842,900712,2079554,1941.83,210.07,2151.9
2022-09-23 00:00:00+08,11,11,22,1178842,921573,2100415,2529.06,112.42,2641.48
2022-09-23 04:00:00+08,12,12,24,1320864,972202,2293066,2625.51,160.39,2785.9
2022-09-23 08:00:00+08,12,12,24,1320864,972202,2293066,2673.51,208.39,2881.9
2022-09-23 12:00:00+08,12,12,24,1320864,972202,2293066,2721.51,256.39,2977.9
2022-09-23 16:00:00+08,11,11,22,1279281,931724,2211005,2575.11,259.22,2834.33
2022-09-23 20:00:00+08,11,12,23,1188167,889633,2077800,2273.51,207.85,2481.36
2022-09-24 00:00:00+08,12,14,26,1337159,1115316,2452475,2409.72,258.29,2668.01
2022-09-24 04:00:00+08,13,13,26,1375276,1064216,2439492,2461.39,281.6,2742.99
2022-09-24 08:00:00+08,12,12,24,1308267,1057332,2365599,2409.11,301.12,2710.23
2022-09-24 12:00:00+08,11,13,24,1154456,1127751,2282207,2452.89,316.29,2769.18
2022-09-24 16:00:00+08,9,9,18,1001911,796787,1798698,2297.71,192.85,2490.56
2022-09-24 20:00:00+08,9,12,21,1001911,977621,1979532,2463.36,146.6,2609.96
2022-09-25 00:00:00+08,10,13,23,1148424,1114771,2263195,2558.67,168.7,2727.37
2022-09-25 04:00:00+08,10,14,24,1148424,1233585,2382009,2598.66,224.2,2822.86
2022-09-25 08:00:00+08,10,12,22,1148424,1188483,2336907,2638.63,228.38,2867.01
2022-09-25 12:00:00+08,10,12,22,1148424,1188483,2336907,2678.63,276.38,2955.01
2022-09-25 16:00:00+08,7,10,17,750708,1029227,1779935,1498.15,236.98,1735.13
2022-09-25 20:00:00+08,8,9,17,841096,978052,1819148,1520.96,233.02,1753.98
2022-09-26 00:00:00+08,7,11,18,742129,1261831,2003960,1678.61,238.44,1917.05
2022-09-26 04:00:00+08,7,11,18,742129,1347608,2089737,1505.69,245.54,1751.23
2022-09-26 08:00:00+08,8,11,19,849059,1329242,2178301,1643.35,235.72,1879.07
2022-09-26 12:00:00+08,9,11,20,952727,1329242,2281969,1678.81,279.72,1958.53
2022-09-26 16:00:00+08,9,11,20,1033445,1329242,2362687,1653.11,323.72,1976.83
2022-09-26 20:00:00+08,9,11,20,1033445,1258359,2291804,1696.87,323.96,2020.83
2022-09-27 00:00:00+08,9,12,21,1033445,1375606,2409051,1732.88,370.55,2103.43
2022-09-27 04:00:00+08,9,12,21,1033445,1376614,2410059,1654.16,363.63,2017.79
2022-09-27 08:00:00+08,9,12,21,1033445,1376614,2410059,1690.16,411.63,2101.79
2022-09-27 12:00:00+08,9,12,21,1033445,1376614,2410059,1726.16,459.63,2185.79
2022-09-27 16:00:00+08,8,11,19,970492,1222803,2193295,1474.64,434.97,1909.61
2022-09-27 20:00:00+08,8,12,20,970492,1265380,2235872,1637.69,438.49,2076.18
2022-09-28 00:00:00+08,9,13,22,1080460,1443540,2524000,1604.95,460.8,2065.75
2022-09-28 04:00:00+08,9,12,21,968983,1341722,2310705,1383.73,457.15,1840.88
2022-09-28 08:00:00+08,9,12,21,968983,1341594,2310577,1274.1,443.23,1717.33
2022-09-28 12:00:00+08,11,12,23,1112634,1261385,2374019,1349.72,371.5,1721.22
2022-09-28 16:00:00+08,12,12,24,1200240,1261385,2461625,1395.15,419.5,1814.65
2022-09-28 20:00:00+08,11,10,21,1165204,998440,2163644,1425.21,279.73,1704.94
2022-09-29 00:00:00+08,11,11,22,1165204,1193171,2358375,1488.62,264.23,1752.85
2022-09-29 04:00:00+08,11,12,23,1165204,1210368,2375572,1532.62,310.95,1843.57
2022-09-29 08:00:00+08,11,12,23,1165204,1129404,2294608,1576.62,324.6,1901.22
2022-09-29 12:00:00+08,12,10,22,1322280,1049254,2371534,1492.28,320.06,1812.34
2022-09-29 16:00:00+08,10,7,17,1113057,788672,1901729,1351.07,234.67,1585.74
2022-09-29 20:00:00+08,9,11,20,959543,1063852,2023395,879.73,266.49,1146.22
2022-09-30 00:00:00+08,9,13,22,959543,1161124,2120667,1016.31,314.21,1330.52
2022-09-30 04:00:00+08,10,15,25,1100152,1236360,2336512,1649.71,329.67,1979.38
2022-09-30 08:00:00+08,10,13,23,1100152,1111373,2211525,1580.89,263.97,1844.86
2022-09-30 12:00:00+08,10,13,23,1100152,1111373,2211525,1620.89,315.97,1936.86
2022-09-30 16:00:00+08,9,11,20,1012546,969100,1981646,1611.41,279.7,1891.11
2022-09-30 20:00:00+08,9,10,19,1012546,952395,1964941,1699.35,280.47,1979.82
2022-10-01 00:00:00+08,8,11,19,904648,989588,1894236,1468.08,262.31,1730.39
2022-10-01 04:00:00+08,8,12,20,904648,1096518,2001166,1616.27,307.02,1923.29
2022-10-01 08:00:00+08,9,13,22,962478,1291000,2253478,1728.65,291.09,2019.74
2022-10-01 12:00:00+08,9,14,23,962478,1359047,2321525,1764.67,346.46,2111.13
2022-10-01 16:00:00+08,10,13,23,1000360,1323602,2323962,1801,364.33,2165.33
2022-10-01 20:00:00+08,10,11,21,1000360,1134374,2134734,1740.4,276.15,2016.55
2022-10-02 00:00:00+08,9,11,20,906815,1088679,1995494,1642.16,279.64,1921.8
2022-10-02 04:00:00+08,9,12,21,906815,1182224,2089039,1766.22,325.89,2092.11
2022-10-02 08:00:00+08,9,10,19,906815,1031914,1938729,1802.22,330.5,2132.72
2022-10-02 12:00:00+08,8,9,17,768175,968920,1737095,1576.01,354.59,1930.6
2022-10-02 16:00:00+08,7,12,19,710345,1390469,2100814,1846.5,394.6,2241.1
2022-10-02 20:00:00+08,7,13,20,710345,1448299,2158644,1909.74,444.51,2354.25
2022-10-03 00:00:00+08,7,13,20,710345,1448299,2158644,1937.74,496.51,2434.25
2022-10-03 04:00:00+08,7,11,18,710345,1269507,1979852,1886.55,469.7,2356.25
2022-10-03 08:00:00+08,7,9,16,710345,1082625,1792970,1837.93,380.96,2218.89
2022-10-03 12:00:00+08,6,9,15,672463,1043236,1715699,1227.91,336.08,1563.99
2022-10-03 16:00:00+08,5,8,13,568795,985406,1554201,1041.17,350.16,1391.33
2022-10-03 20:00:00+08,5,10,15,568795,1126956,1695751,1291.14,384.01,1675.15
2022-10-04 00:00:00+08,5,10,15,568795,1126956,1695751,1311.14,424.01,1735.15
2022-10-04 04:00:00+08,5,10,15,568795,1126956,1695751,1331.14,464.01,1795.15
2022-10-04 08:00:00+08,5,10,15,568795,1126956,1695751,1351.14,504.01,1855.15
2022-10-04 12:00:00+08,5,10,15,568795,1126956,1695751,1371.14,544.01,1915.15
2022-10-04 16:00:00+08,4,9,13,518689,1024122,1542811,1241.72,503.73,1745.45
2022-10-04 20:00:00+08,4,10,14,518689,1066581,1585270,1358.43,516.57,1875
2022-10-05 00:00:00+08,6,10,16,757262,1067636,1824898,1291.61,487,1778.61
2022-10-05 04:00:00+08,6,10,16,757262,1067636,1824898,1315.61,527,1842.61
2022-10-05 08:00:00+08,6,10,16,757262,1067636,1824898,1339.61,567,1906.61
2022-10-05 12:00:00+08,6,11,17,757262,1101798,1859060,1363.61,609.41,1973.02
2022-10-05 16:00:00+08,5,9,14,630204,891200,1521404,1012.69,499.97,1512.66
2022-10-05 20:00:00+08,4,11,15,545369,1119987,1665356,898.48,460.41,1358.89
2022-10-06 00:00:00+08,4,9,13,545369,923458,1468827,762.55,305.24,1067.79
2022-10-06 04:00:00+08,4,7,11,545369,779098,1324467,778.57,243.49,1022.06
2022-10-06 08:00:00+08,4,10,14,545369,961260,1506629,825.89,276.71,1102.6
2022-10-06 12:00:00+08,4,10,14,545369,983987,1529356,841.89,293.04,1134.93
2022-10-06 16:00:00+08,5,10,15,578585,983987,1562572,861.39,333.04,1194.43
2022-10-06 20:00:00+08,5,9,14,579332,687457,1266789,643.53,170.71,814.24
2022-10-07 00:00:00+08,4,11,15,470332,910284,1380616,486.52,167.8,654.32
2022-10-07 04:00:00+08,5,13,18,492310,1159893,1652203,821.28,216.96,1038.24
2022-10-07 08:00:00+08,6,13,19,533900,1147396,1681296,843.99,244.64,1088.63
2022-10-07 12:00:00+08,6,11,17,533900,995907,1529807,867.98,209.22,1077.2
2022-10-07 16:00:00+08,7,9,16,584432,790903,1375335,810.16,198.93,1009.09
2022-10-07 20:00:00+08,7,13,20,584432,1210891,1795323,838.13,239.22,1077.35
2022-10-08 00:00:00+08,7,13,20,584432,1257488,1841920,866.11,266.5,1132.61
2022-10-08 04:00:00+08,6,11,17,533900,1059950,1593850,881.38,233.5,1114.88
2022-10-08 08:00:00+08,6,10,16,533900,906000,1439900,921.1,210.74,1131.84
2022-10-08 12:00:00+08,6,11,17,650804,1053021,1703825,912.6,253.12,1165.72
2022-10-08 16:00:00+08,6,10,16,650804,990027,1640831,936.6,277.4,1214
2022-10-08 20:00:00+08,6,10,16,650804,890626,1541430,852.95,231.47,1084.42
2022-10-09 00:00:00+08,6,10,16,563031,855300,1418331,781.63,247.39,1029.02
2022-10-09 04:00:00+08,7,10,17,703272,990720,1693992,909.71,281.41,1191.12
2022-10-09 08:00:00+08,8,11,19,849859,1086823,1936682,938.61,324.15,1262.76
2022-10-09 12:00:00+08,8,11,19,849859,1086823,1936682,970.61,368.15,1338.76
2022-10-09 16:00:00+08,6,10,16,669387,1036291,1705678,898.11,379.16,1277.27
2022-10-09 20:00:00+08,6,11,17,669387,1157970,1827357,975.71,371.98,1347.69
2022-10-10 00:00:00+08,6,11,17,669387,1157970,1827357,999.71,415.98,1415.69
2022-10-10 04:00:00+08,6,12,18,669387,1252599,1921986,1023.71,463.98,1487.69
2022-10-10 08:00:00+08,7,11,18,808722,1211009,2019731,988.12,498.82,1486.94
2022-10-10 12:00:00+08,6,11,17,775506,1280978,2056484,920.64,479.33,1399.97
2022-10-10 16:00:00+08,7,10,17,881051,1168231,2049282,777.56,417.63,1195.19
2022-10-10 20:00:00+08,6,13,19,740810,1410877,2151687,864.05,463.55,1327.6
2022-10-11 00:00:00+08,6,12,18,740810,1217119,1957929,888,355.21,1243.21
2022-10-11 04:00:00+08,6,13,19,740810,1356454,2097264,912,406.92,1318.92
2022-10-11 08:00:00+08,6,11,17,740810,1106613,1847423,835.36,354.23,1189.59
2022-10-11 12:00:00+08,7,13,20,863769,1375012,2238781,863.27,402.61,1265.88
2022-10-11 16:00:00+08,8,12,20,914301,1219033,2133334,892.11,361.97,1254.08
2022-10-11 20:00:00+08,8,15,23,914301,1532086,2446387,987.88,415.86,1403.74
2022-10-12 00:00:00+08,8,14,22,914301,1498870,2413171,918,446.25,1364.25
2022-10-12 04:00:00+08,8,14,22,914301,1498870,2413171,950,502.25,1452.25
2022-10-12 08:00:00+08,8,13,21,914301,1412980,2327281,982,525.55,1507.55
2022-10-12 12:00:00+08,10,13,23,1066099,1348251,2414350,1020.81,536.98,1557.79
2022-10-12 16:00:00+08,10,12,22,1066099,1322230,2388329,1060.78,568,1628.78
2022-10-12 20:00:00+08,10,12,22,1067714,1304057,2371771,1006.17,580.74,1586.91
2022-10-13 00:00:00+08,10,12,22,1067714,1304057,2371771,1046.17,628.74,1674.91
2022-10-13 04:00:00+08,10,13,23,1067714,1370022,2437736,1187.14,679.07,1866.21
2022-10-13 08:00:00+08,10,12,22,1067714,1335708,2403422,1227.15,708.89,1936.04
2022-10-13 12:00:00+08,10,11,21,1067714,1268699,2336413,1267.13,693.97,1961.1
2022-10-13 16:00:00+08,9,9,18,962169,1045129,2007298,1201.66,624.33,1825.99
2022-10-13 20:00:00+08,8,10,18,845729,1018619,1864348,1277.8,499.54,1777.34
2022-10-14 00:00:00+08,9,11,20,921456,899695,1821151,1203.86,411.81,1615.67
2022-10-14 04:00:00+08,11,13,24,1082216,1073965,2156181,1284.57,462.2,1746.77
2022-10-14 08:00:00+08,11,12,23,1082216,934630,2016846,1328.55,434.47,1763.02
2022-10-14 12:00:00+08,12,12,24,1076783,934630,2011413,1277.25,482.47,1759.72
2022-10-14 16:00:00+08,11,8,19,1026251,687311,1713562,1252.35,401.31,1653.66
2022-10-14 20:00:00+08,11,12,23,1026251,1060568,2086819,1372.91,438.7,1811.61
2022-10-15 00:00:00+08,12,13,25,1153327,1208859,2362186,1527.89,470.3,1998.19
2022-10-15 04:00:00+08,13,13,26,1254007,1223164,2477171,1478.69,475.33,1954.02
2022-10-15 08:00:00+08,13,12,25,1254007,1082923,2336930,1466.82,439.79,1906.61
2022-10-15 12:00:00+08,13,11,24,1254007,997091,2251098,1518.82,447.68,1966.5
2022-10-15 16:00:00+08,12,12,24,1223773,1201916,2425689,1612.63,477.73,2090.36
2022-10-15 20:00:00+08,12,10,22,1223773,1094810,2318583,1694.54,202.97,1897.51
2022-10-16 00:00:00+08,12,9,21,1223773,986040,2209813,1742.52,231.57,1974.09
2022-10-16 04:00:00+08,12,10,22,1223773,1134622,2358395,1790.48,269.38,2059.86
2022-10-16 08:00:00+08,11,10,21,1110295,1120029,2230324,1738.02,256.88,1994.9
2022-10-16 12:00:00+08,11,10,21,1110295,1153237,2263532,1843.39,263.77,2107.16
2022-10-16 16:00:00+08,10,10,20,1080108,1153237,2233345,1823.54,303.77,2127.31
2022-10-16 20:00:00+08,10,10,20,1080108,1061634,2141742,1895.58,247.76,2143.34
2022-10-17 00:00:00+08,10,10,20,1080108,1061634,2141742,1935.58,287.76,2223.34
2022-10-17 04:00:00+08,10,10,20,1080108,1007736,2087844,1865.16,273.32,2138.48
2022-10-17 08:00:00+08,11,10,21,1120586,1007736,2128322,1907.82,313.32,2221.14
2022-10-17 12:00:00+08,12,10,22,1227498,1007736,2235234,1951.99,353.32,2305.31
2022-10-17 16:00:00+08,12,9,21,1169359,905889,2075248,1911.87,358.89,2270.76
2022-10-17 20:00:00+08,12,10,22,1169359,968202,2137561,1898.4,365.79,2264.19
2022-10-18 00:00:00+08,14,10,24,1310750,971493,2282243,1971.61,308.83,2280.44
2022-10-18 04:00:00+08,14,10,24,1310750,975501,2286251,1961.7,314.94,2276.64
2022-10-18 08:00:00+08,14,11,25,1310750,1002526,2313276,2017.73,356.82,2374.55
2022-10-18 12:00:00+08,14,10,24,1310750,897491,2208241,2073.69,359.33,2433.02
2022-10-18 16:00:00+08,11,7,18,1009799,696222,1706021,1933.94,239.06,2173
2022-10-18 20:00:00+08,11,10,21,1009799,1006216,2016015,2181.12,230.69,2411.81
2022-10-19 00:00:00+08,11,10,21,1009799,1073856,2083655,2225.1,253.16,2478.26
2022-10-19 04:00:00+08,11,11,22,1009799,1091053,2100852,2269.11,295.93,2565.04
2022-10-19 08:00:00+08,12,11,23,1105902,1091053,2196955,2316.3,339.93,2656.23
2022-10-19 12:00:00+08,12,9,21,1105902,813391,1919293,2214.32,197.73,2412.05
2022-10-19 16:00:00+08,10,8,18,879226,718911,1598137,2119.16,213.58,2332.74
2022-10-19 20:00:00+08,10,11,21,879226,992260,1871486,2307.59,202.09,2509.68
2022-10-20 00:00:00+08,8,11,19,633536,962045,1595581,1544.95,216.74,1761.69
2022-10-20 04:00:00+08,9,10,19,748879,834969,1583848,1489.47,227.52,1716.99
2022-10-20 08:00:00+08,10,12,22,852570,1144998,1997568,2320.88,252.77,2573.65
2022-10-20 12:00:00+08,11,11,22,963885,1036162,2000047,2266.44,236.81,2503.25
2022-10-20 16:00:00+08,10,7,17,888555,778373,1666928,1933.02,131.74,2064.76
2022-10-20 20:00:00+08,10,10,20,888555,936658,1825213,2174.25,164.25,2338.5
2022-10-21 00:00:00+08,11,11,22,1007914,1043570,2051484,2299.57,206.23,2505.8
2022-10-21 04:00:00+08,10,10,20,940974,1000590,1941564,2329.63,221.53,2551.16
2022-10-21 08:00:00+08,10,12,22,940974,1074414,2015388,2385.91,266.21,2652.12
2022-10-21 12:00:00+08,10,12,22,940974,1074414,2015388,2425.91,314.21,2740.12
2022-10-21 16:00:00+08,8,12,20,750435,1074414,1824849,2005.36,362.21,2367.57
2022-10-21 20:00:00+08,7,10,17,709957,973879,1683836,1941.78,266.48,2208.26
2022-10-22 00:00:00+08,7,11,18,709957,1096838,1806795,2222.73,309.42,2532.15
2022-10-22 04:00:00+08,7,12,19,712120,1137316,1849436,2326.05,357.17,2683.22
2022-10-22 08:00:00+08,7,8,15,712120,630741,1342861,1997.2,196.19,2193.39
2022-10-22 12:00:00+08,7,7,14,712120,636129,1348249,2072.56,143.51,2216.07
2022-10-22 16:00:00+08,7,7,14,702981,724351,1427332,1733.6,154.23,1887.83
2022-10-22 20:00:00+08,6,10,16,652284,1008886,1661170,1796.43,187.23,1983.66
2022-10-23 00:00:00+08,5,9,14,510928,968065,1478993,1297.89,163.85,1461.74
2022-10-23 04:00:00+08,5,11,16,510928,1110369,1621297,1191.48,102.47,1293.95
2022-10-23 08:00:00+08,5,11,16,510928,1110369,1621297,1211.48,146.47,1357.95
2022-10-23 12:00:00+08,5,11,16,510928,1110369,1621297,1231.48,190.47,1421.95
2022-10-23 16:00:00+08,6,11,17,578645,1110369,1689014,1251.73,234.47,1486.2
2022-10-23 20:00:00+08,6,12,18,578645,1173709,1752354,1275.72,263.49,1539.21
2022-10-24 00:00:00+08,8,12,20,723787,1173709,1897496,1302.09,311.49,1613.58
2022-10-24 04:00:00+08,8,11,19,723787,1123012,1846799,1201.49,332.87,1534.36
2022-10-24 08:00:00+08,7,12,19,610309,1157405,1767714,1180.22,314.99,1495.21
2022-10-24 12:00:00+08,7,11,18,610309,1094134,1704443,1208.24,346.36,1554.6
2022-10-24 16:00:00+08,6,7,13,499625,626393,1126018,676.78,188.38,865.16
2022-10-24 20:00:00+08,6,10,16,499625,907984,1407609,763.15,169.18,932.33
2022-10-25 00:00:00+08,7,11,18,643775,1011675,1655450,901.88,211.32,1113.2
2022-10-25 04:00:00+08,6,11,17,535425,1011675,1547100,913.96,255.32,1169.28
2022-10-25 08:00:00+08,6,10,16,535425,1026706,1562131,955.56,236.82,1192.38
2022-10-25 12:00:00+08,7,11,18,572995,1044981,1617976,980.33,279.39,1259.72
2022-10-25 16:00:00+08,7,11,18,572995,1044981,1617976,1008.33,323.39,1331.72
2022-10-25 20:00:00+08,9,10,19,742849,1026706,1769555,1041.88,356.82,1398.7
2022-10-26 00:00:00+08,9,10,19,742849,1026706,1769555,1077.88,396.82,1474.7
2022-10-26 04:00:00+08,7,7,14,572995,790397,1363392,977.7,339.09,1316.79
2022-10-26 08:00:00+08,8,10,18,625783,948096,1573879,638.52,297.17,935.69
2022-10-26 12:00:00+08,8,10,18,625783,948096,1573879,670.52,337.17,1007.69
2022-10-26 16:00:00+08,9,10,19,652594,948096,1600690,705.5,377.17,1082.67
2022-10-26 20:00:00+08,9,11,20,652594,982258,1634852,741.48,418.48,1159.96
2022-10-27 00:00:00+08,8,9,17,615024,760430,1375454,658.81,367.12,1025.93
2022-10-27 04:00:00+08,6,6,12,553940,580360,1134300,564.57,289.09,853.66
2022-10-27 08:00:00+08,5,14,19,486223,1218707,1704930,672.26,332.77,1005.03
2022-10-27 12:00:00+08,6,12,18,607370,1036851,1644221,682.06,278.59,960.65
2022-10-27 16:00:00+08,5,9,14,463227,742038,1205265,566.88,149.83,716.71
2022-10-27 20:00:00+08,5,13,18,463227,1134316,1597543,810.95,191.08,1002.03
2022-10-28 00:00:00+08,5,12,17,463227,1108296,1571523,830.98,223.78,1054.76
2022-10-28 04:00:00+08,5,13,18,463227,1115180,1578407,850.95,275.6,1126.55
2022-10-28 08:00:00+08,4,13,17,412792,1045466,1458258,655.11,248.48,903.59
2022-10-28 12:00:00+08,4,15,19,412792,1204542,1617334,776.12,305.28,1081.4
2022-10-28 16:00:00+08,2,11,13,173935,1025801,1199736,414.84,227.9,642.74
2022-10-28 20:00:00+08,1,12,13,121147,1049302,1170449,479.47,233.31,712.78
2022-10-29 00:00:00+08,2,13,15,232181,1178523,1410704,550.21,253.17,803.38
2022-10-29 04:00:00+08,2,12,14,232181,1066007,1298188,558.22,272.18,830.4
2022-10-29 08:00:00+08,3,11,14,376523,878114,1254637,568.53,251.09,819.62
2022-10-29 12:00:00+08,4,10,14,428256,947377,1375633,582.98,169.67,752.65
2022-10-29 16:00:00+08,4,9,13,428256,888010,1316266,598.97,188.46,787.43
2022-10-29 20:00:00+08,4,13,17,428256,1289729,1717985,615,230.77,845.77
2022-10-30 00:00:00+08,5,13,18,540772,1303876,1844648,461.13,223.95,685.08
2022-10-30 04:00:00+08,7,14,21,811798,1322167,2133965,483.82,279.44,763.26
2022-10-30 08:00:00+08,7,14,21,811798,1334005,2145803,511.82,328.39,840.21
2022-10-30 12:00:00+08,8,14,22,896486,1334005,2230491,543.26,384.39,927.65
2022-10-30 16:00:00+08,8,12,20,935079,1203920,2138999,571.59,384.55,956.14
2022-10-30 20:00:00+08,7,12,19,822563,1179878,2002441,593.53,408.67,1002.2
2022-10-31 00:00:00+08,7,13,20,822563,1292394,2114957,645.04,457.31,1102.35
2022-10-31 04:00:00+08,7,9,16,822563,1110918,1933481,673.05,356.91,1029.96
2022-10-31 08:00:00+08,7,9,16,822563,1110918,1933481,701.05,392.91,1093.96
2022-10-31 12:00:00+08,6,5,11,699282,642106,1341388,451.97,206.13,658.1
2022-10-31 16:00:00+08,5,6,11,558829,765387,1324216,463.39,229.66,693.05
2022-10-31 20:00:00+08,5,7,12,558829,828200,1387029,523.74,205.07,728.81
2022-11-01 00:00:00+08,4,7,11,428256,828200,1256456,497.72,233.07,730.79
2022-11-01 04:00:00+08,4,7,11,428256,815297,1243553,415.46,185.95,601.41
2022-11-01 08:00:00+08,4,9,13,428256,935111,1363367,484.02,92.19,576.21
2022-11-01 12:00:00+08,4,9,13,428256,935111,1363367,500.02,128.19,628.21
2022-11-01 16:00:00+08,4,10,14,428256,1073488,1501744,516.11,165.42,681.53
2022-11-01 20:00:00+08,4,11,15,428256,1158263,1586519,532.11,208.81,740.92
2022-11-02 00:00:00+08,5,11,16,523916,1098575,1622491,526.14,205.26,731.4
2022-11-02 04:00:00+08,6,12,18,618290,1202223,1820513,547.69,252.6,800.29
2022-11-02 08:00:00+08,6,14,20,618290,1282451,1900741,571.69,305.43,877.12
2022-11-02 12:00:00+08,5,13,18,473948,1251758,1725706,493.39,293.18,786.57
2022-11-02 16:00:00+08,4,11,15,352801,1043702,1396503,340.74,270.25,610.99
2022-11-02 20:00:00+08,5,11,16,473745,1029838,1503583,412.2,238.82,651.02
2022-11-03 00:00:00+08,4,10,14,362711,852171,1214882,269.55,187.15,456.7
2022-11-03 04:00:00+08,5,13,18,403189,1069058,1472247,445.72,237.12,682.84
2022-11-03 08:00:00+08,5,14,19,403189,1180092,1583281,592.09,293.01,885.1
2022-11-03 12:00:00+08,5,12,17,403189,1059321,1462510,612.1,302.92,915.02
2022-11-03 16:00:00+08,6,9,15,419586,930596,1350182,634.47,265.52,899.99
2022-11-03 20:00:00+08,6,10,16,419586,1077374,1496960,658.48,302.14,960.62
2022-11-04 00:00:00+08,6,9,15,419586,905278,1324864,682.56,221.12,903.68
2022-11-04 04:00:00+08,6,9,15,419586,849091,1268677,706.55,213.39,919.94
2022-11-04 08:00:00+08,7,10,17,573294,946071,1519365,733.81,251.65,985.46
2022-11-04 12:00:00+08,6,9,15,477634,891914,1369548,700.25,256.09,956.34
2022-11-04 16:00:00+08,6,7,13,477634,736165,1213799,724.19,210.09,934.28
2022-11-04 20:00:00+08,6,11,17,477634,1064431,1542065,817.3,200.01,1017.31
2022-11-05 00:00:00+08,6,10,16,356863,943284,1300147,667.95,196.04,863.99
2022-11-05 04:00:00+08,5,11,16,323926,1096992,1420918,706.97,237.85,944.82
2022-11-05 08:00:00+08,5,13,18,323926,1196615,1520541,735.47,286.39,1021.86
2022-11-05 12:00:00+08,5,12,17,323926,1189731,1513657,755.47,302.81,1058.28
2022-11-05 16:00:00+08,5,10,15,323926,1031851,1355777,775.45,308.08,1083.53
2022-11-05 20:00:00+08,5,8,13,323926,908221,1232147,795.45,282.73,1078.18
2022-11-06 00:00:00+08,5,7,12,337734,814397,1152131,751.64,244.99,996.63
2022-11-06 04:00:00+08,5,7,12,337734,770964,1108698,645.25,204.08,849.33
2022-11-06 08:00:00+08,5,7,12,337734,720675,1058409,727.92,209.21,937.13
2022-11-06 12:00:00+08,5,5,10,337734,419257,756991,640.93,105.88,746.81
2022-11-06 16:00:00+08,5,5,10,337734,419257,756991,660.93,125.88,786.81
2022-11-06 20:00:00+08,4,8,12,243360,772893,1016253,567.43,129.79,697.22
2022-11-07 00:00:00+08,4,8,12,243360,780967,1024327,520.73,145.49,666.22
2022-11-07 04:00:00+08,3,8,11,191627,721633,913260,423.43,130.58,554.01
2022-11-07 08:00:00+08,3,9,12,191627,773366,964993,648.35,164.1,812.45
2022-11-07 12:00:00+08,3,9,12,191627,894422,1086049,660.35,186.71,847.06
2022-11-07 16:00:00+08,2,8,10,70683,808531,879214,555.34,181.82,737.16
2022-11-07 20:00:00+08,3,7,10,121458,629737,751195,497.69,117.09,614.78
2022-11-08 00:00:00+08,3,8,11,121458,744649,866107,631.05,119.45,750.5
2022-11-08 04:00:00+08,3,8,11,121458,744649,866107,643.05,151.45,794.5
2022-11-08 08:00:00+08,3,8,11,121458,744649,866107,655.05,183.45,838.5
2022-11-08 12:00:00+08,3,9,12,227571,910640,1138211,539.06,218.35,757.41
2022-11-08 16:00:00+08,3,8,11,227571,842623,1070194,551.04,209.7,760.74
2022-11-08 20:00:00+08,4,9,13,293271,940325,1233596,351.1,206.3,557.4
2022-11-09 00:00:00+08,4,10,14,293271,1059614,1352885,367.07,217.89,584.96
2022-11-09 04:00:00+08,4,10,14,293271,1059614,1352885,383.07,257.89,640.96
2022-11-09 08:00:00+08,4,9,13,293271,914087,1207358,399.07,251.93,651
2022-11-09 12:00:00+08,5,8,13,327975,815035,1143010,418.32,251.79,670.11
2022-11-09 16:00:00+08,5,8,13,327975,815035,1143010,438.32,283.79,722.11
2022-11-09 20:00:00+08,5,6,11,327975,665600,993575,458.33,265.66,723.99
2022-11-10 00:00:00+08,5,6,11,327975,623541,951516,359.69,222.3,581.99
2022-11-10 04:00:00+08,5,7,12,327975,664019,991994,547.84,249.83,797.67
2022-11-10 08:00:00+08,4,10,14,343671,802503,1146174,566.68,281.22,847.9
2022-11-10 12:00:00+08,4,10,14,343671,802503,1146174,582.68,321.22,903.9
2022-11-10 16:00:00+08,4,9,13,343671,750188,1093859,598.7,341.69,940.39
2022-11-10 20:00:00+08,4,9,13,223948,662470,886418,558.82,331.49,890.31
2022-11-11 00:00:00+08,6,10,16,430727,686822,1117549,642.04,268.57,910.61
2022-11-11 04:00:00+08,3,9,12,257554,648742,906296,505.96,287.61,793.57
2022-11-11 08:00:00+08,2,11,13,102554,654244,756798,533.5,231.12,764.62
2022-11-11 12:00:00+08,3,12,15,223488,890640,1114128,564.29,246.55,810.84
2022-11-11 16:00:00+08,2,11,13,171709,863829,1035538,557.35,277.3,834.65
2022-11-11 20:00:00+08,1,13,14,120934,996214,1117148,283.75,245.24,528.99
2022-11-12 00:00:00+08,1,14,15,120934,1120801,1241735,373.93,285.32,659.25
2022-11-12 04:00:00+08,1,14,15,120934,1109344,1230278,377.96,324.01,701.97
2022-11-12 08:00:00+08,1,14,15,120934,1109344,1230278,381.96,380.01,761.97
2022-11-12 12:00:00+08,1,14,15,120934,1109344,1230278,385.96,436.01,821.97
2022-11-12 16:00:00+08,1,13,14,120934,1102460,1223394,390,458.12,848.12
2022-11-12 20:00:00+08,0,9,9,0,836707,836707,336.39,415.04,751.43
2022-11-13 00:00:00+08,0,7,7,0,687698,687698,205.84,274.5,480.34
2022-11-13 04:00:00+08,0,9,9,0,825829,825829,246.87,304.68,551.55
2022-11-13 08:00:00+08,0,9,9,0,825829,825829,246.87,340.68,587.55
2022-11-13 12:00:00+08,0,8,8,0,808632,808632,246.87,368.56,615.43
2022-11-13 16:00:00+08,1,6,7,102834,591852,694686,219.24,305.9,525.14
2022-11-13 20:00:00+08,2,5,7,207434,445261,652695,160.97,261.5,422.47
2022-11-14 00:00:00+08,2,6,8,207434,567085,774519,168.94,281.9,450.84
2022-11-14 04:00:00+08,1,7,8,104600,772280,876880,61.69,256.77,318.46
2022-11-14 08:00:00+08,1,6,7,104600,718734,823334,69.58,53.71,123.29
2022-11-14 12:00:00+08,1,6,7,104600,718734,823334,73.58,77.71,151.29
2022-11-14 16:00:00+08,1,6,7,104600,718734,823334,77.58,101.71,179.29
2022-11-14 20:00:00+08,1,8,9,104600,1040853,1145453,81.58,128.54,210.12
2022-11-15 00:00:00+08,2,8,10,155289,1040853,1196142,86.14,160.54,246.68
2022-11-15 04:00:00+08,2,8,10,155289,1040853,1196142,94.14,192.54,286.68
2022-11-15 08:00:00+08,2,9,11,155289,1059144,1214433,102.14,228.28,330.42
2022-11-15 12:00:00+08,2,8,10,155289,942081,1097370,110.12,228.82,338.94
2022-11-15 16:00:00+08,1,7,8,50689,820257,870946,73.17,220.42,293.59
2022-11-15 20:00:00+08,0,7,7,0,807685,807685,105.03,212.39,317.42
2022-11-16 00:00:00+08,1,7,8,130573,771439,902012,66.29,174.28,240.57
2022-11-16 04:00:00+08,1,9,10,130573,962765,1093338,95.74,206.51,302.25
2022-11-16 08:00:00+08,1,10,11,130573,1042188,1172761,99.74,246.33,346.07
2022-11-16 12:00:00+08,1,11,12,130573,1164988,1295561,88.16,235.96,324.12
2022-11-16 16:00:00+08,2,9,11,171051,1017137,1188188,96.01,179.79,275.8
2022-11-16 20:00:00+08,2,9,11,121649,870820,992469,83.18,102.28,185.46
2022-11-17 00:00:00+08,2,10,12,121649,1017569,1139218,91.18,139.47,230.65
2022-11-17 04:00:00+08,2,11,13,121649,1148142,1269791,125.77,183.14,308.91
2022-11-17 08:00:00+08,2,10,12,121649,1097453,1219102,108.32,196.03,304.35
2022-11-17 12:00:00+08,3,12,15,244610,1271518,1516128,120.29,238.63,358.92
2022-11-17 16:00:00+08,3,10,13,244610,1087495,1332105,83.83,206.34,290.17
2022-11-17 20:00:00+08,3,10,13,244610,1078736,1323346,95.82,223.58,319.4
2022-11-18 00:00:00+08,2,9,11,121649,1039572,1161221,91.87,227.17,319.04
2022-11-18 04:00:00+08,1,8,9,40478,699865,740343,66.43,155.75,222.18
2022-11-18 08:00:00+08,1,10,11,40478,903997,944475,129.45,190.12,319.57
2022-11-18 12:00:00+08,1,10,11,40478,903997,944475,133.45,230.12,363.57
2022-11-18 16:00:00+08,1,7,8,40478,662403,702881,137.45,172.65,310.1
2022-11-18 20:00:00+08,1,10,11,40478,964898,1005376,141.47,203.84,345.31
2022-11-19 00:00:00+08,1,12,13,40478,1222660,1263138,145.47,247.88,393.35
2022-11-19 04:00:00+08,1,12,13,40478,1175651,1216129,113.05,276.98,390.03
2022-11-19 08:00:00+08,2,13,15,79896,1261166,1341062,120.12,327.52,447.64
2022-11-19 12:00:00+08,2,11,13,79896,1171320,1251216,101.54,235.98,337.52
2022-11-19 16:00:00+08,2,10,12,79896,1108120,1188016,109.54,259.55,369.09
2022-11-19 20:00:00+08,2,8,10,79896,913386,993282,117.54,181.97,299.51
2022-11-20 00:00:00+08,2,6,8,58796,733271,792067,109.78,134.06,243.84
2022-11-20 04:00:00+08,1,10,11,40478,915945,956423,137.01,142.58,279.59
2022-11-20 08:00:00+08,2,10,12,150446,915945,1066391,144.89,182.58,327.47
2022-11-20 12:00:00+08,2,9,11,150446,897627,1048073,146.52,213.64,360.16
2022-11-20 16:00:00+08,2,7,9,150446,636195,786641,154.53,188.99,343.52
2022-11-20 20:00:00+08,2,6,8,150446,576345,726791,142.35,156.4,298.75
2022-11-21 00:00:00+08,3,9,12,269950,950246,1220196,151.71,190.98,342.69
2022-11-21 04:00:00+08,3,8,11,269950,827285,1097235,141.1,157.64,298.74
2022-11-21 08:00:00+08,2,9,11,150446,1013191,1163637,151.99,162.78,314.77
2022-11-21 12:00:00+08,3,10,13,201240,1043426,1244666,163.84,201.32,365.16
2022-11-21 16:00:00+08,3,7,10,201240,753633,954873,175.84,107.33,283.17
2022-11-21 20:00:00+08,3,11,14,201240,1157172,1358412,187.92,138,325.92
2022-11-22 00:00:00+08,3,11,14,201240,1157172,1358412,199.92,182,381.92
2022-11-22 04:00:00+08,3,11,14,201240,1157172,1358412,211.92,226,437.92
2022-11-22 08:00:00+08,3,11,14,201240,1157172,1358412,223.92,270,493.92
2022-11-22 12:00:00+08,3,11,14,201240,1157172,1358412,235.92,314,549.92
2022-11-22 16:00:00+08,3,8,11,201240,886763,1088003,247.87,237.17,485.04
2022-11-22 20:00:00+08,2,11,13,150446,1023486,1173932,224.01,223.99,448
2022-11-23 00:00:00+08,2,11,13,150446,1114879,1265325,232.03,241.63,473.66
2022-11-23 04:00:00+08,1,11,12,109968,1018793,1128761,112.05,212.09,324.14
2022-11-23 08:00:00+08,1,11,12,109968,1018793,1128761,116.05,256.09,372.14
2022-11-23 12:00:00+08,1,11,12,109968,945818,1055786,286.65,210.47,497.12
2022-11-23 16:00:00+08,1,11,12,109968,945818,1055786,290.65,254.47,545.12
2022-11-23 20:00:00+08,1,9,10,109968,772214,882182,294.61,248.61,543.22
2022-11-24 00:00:00+08,1,12,13,109968,987846,1097814,298.6,294.06,592.66
2022-11-24 04:00:00+08,1,12,13,109968,987846,1097814,302.6,342.06,644.66
2022-11-24 08:00:00+08,1,12,13,109968,987846,1097814,306.6,390.06,696.66
2022-11-24 12:00:00+08,1,9,10,109968,800677,910645,310.62,341.41,652.03
2022-11-24 16:00:00+08,1,4,5,109968,312318,422286,107.89,115.95,223.84
2022-11-24 20:00:00+08,1,4,5,109968,343965,453933,111.9,94.38,206.28
2022-11-25 00:00:00+08,3,3,6,211136,270997,482133,116.35,84.02,200.37
2022-11-25 04:00:00+08,3,2,5,211136,236683,447819,128.35,64.86,193.21
2022-11-25 08:00:00+08,3,2,5,211136,236683,447819,140.35,72.86,213.21
2022-11-25 12:00:00+08,3,2,5,211136,236683,447819,152.35,80.86,233.21
2022-11-25 16:00:00+08,2,2,4,126365,236683,363048,147.96,88.86,236.82
2022-11-25 20:00:00+08,2,9,11,126365,762263,888628,174.63,106.03,280.66
2022-11-26 00:00:00+08,2,11,13,126365,1033501,1159866,182.62,147.84,330.46
2022-11-26 04:00:00+08,1,11,12,109968,1033501,1143469,162.56,191.84,354.4
2022-11-26 08:00:00+08,1,12,13,109968,1049898,1159866,198.6,235.86,434.46
2022-11-26 12:00:00+08,1,10,11,109968,958243,1068211,183.94,249.56,433.5
2022-11-26 16:00:00+08,1,11,12,109968,1090278,1200246,187.91,289.71,477.62
2022-11-26 20:00:00+08,2,9,11,223180,896155,1119335,195.27,214.16,409.43
2022-11-27 00:00:00+08,2,9,11,223180,846204,1069384,203.25,225.26,428.51
2022-11-27 04:00:00+08,3,11,14,261062,989895,1250957,214.4,264.43,478.83
2022-11-27 08:00:00+08,3,11,14,261062,1029508,1290570,226.35,298.84,525.19
2022-11-27 12:00:00+08,3,8,11,261062,813394,1074456,206.32,230.34,436.66
2022-11-27 16:00:00+08,2,9,11,151094,983009,1134103,38.4,253.71,292.11
2022-11-27 20:00:00+08,2,9,11,151094,962404,1113498,230.1,242.37,472.47
2022-11-28 00:00:00+08,2,10,12,151094,923190,1074284,238.12,250.69,488.81
2022-11-28 04:00:00+08,2,9,11,151094,828715,979809,246.11,155.05,401.16
2022-11-28 08:00:00+08,3,8,11,202765,802093,1004858,256.85,147.56,404.41
2022-11-28 12:00:00+08,3,8,11,202765,802093,1004858,268.85,179.56,448.41
2022-11-28 16:00:00+08,2,6,8,89553,610408,699961,233.57,125.37,358.94
2022-11-28 20:00:00+08,2,7,9,89553,655203,744756,292.77,109.12,401.89
2022-11-29 00:00:00+08,2,8,10,89553,739908,829461,300.77,137.28,438.05
2022-11-29 04:00:00+08,2,9,11,89553,850011,939564,308.76,171.84,480.6
2022-11-29 08:00:00+08,2,8,10,89553,897200,986753,316.76,163.84,480.6
2022-11-29 12:00:00+08,2,8,10,89553,897200,986753,324.76,195.84,520.6
2022-11-29 16:00:00+08,2,9,11,89553,1035316,1124869,332.76,192.71,525.47
2022-11-29 20:00:00+08,2,7,9,89553,809513,899066,340.81,155.33,496.14
2022-11-30 00:00:00+08,3,9,12,170724,988100,1158824,351.79,167.1,518.89
2022-11-30 04:00:00+08,3,9,12,170724,988100,1158824,363.79,203.1,566.89
2022-11-30 08:00:00+08,2,9,11,119053,988100,1107153,325,239.1,564.1
2022-11-30 12:00:00+08,2,6,8,119053,680137,799190,98.17,155.11,253.28
2022-11-30 16:00:00+08,2,7,9,119053,826644,945697,106.17,179.11,285.28
2022-11-30 20:00:00+08,2,11,13,119053,1131511,1250564,114.17,212.46,326.63
2022-12-01 00:00:00+08,2,10,12,119053,1000938,1119991,122.17,215.94,338.11
2022-12-01 04:00:00+08,1,12,13,81171,1118553,1199724,98.51,232.81,331.32
2022-12-01 08:00:00+08,1,11,12,81171,975634,1056805,205.37,194.56,399.93
2022-12-01 12:00:00+08,2,11,13,143158,975634,1118792,210.01,238.56,448.57
2022-12-01 16:00:00+08,2,10,12,143158,924534,1067692,218.02,261.69,479.71
2022-12-01 20:00:00+08,2,8,10,143158,854572,997730,158.55,264.55,423.1
2022-12-02 00:00:00+08,1,7,8,61987,755486,817473,115.51,247.86,363.37
2022-12-02 04:00:00+08,1,9,10,61987,843541,905528,174.15,278.02,452.17
2022-12-02 08:00:00+08,1,10,11,61987,843252,905239,178.12,252.22,430.34
2022-12-02 12:00:00+08,1,9,10,61987,686176,748163,182.12,248.51,430.63
2022-12-02 16:00:00+08,2,8,10,180822,651472,832294,187.67,240.37,428.04
2022-12-02 20:00:00+08,2,9,11,180822,767172,947994,195.68,273.99,469.67
2022-12-03 00:00:00+08,1,6,7,61987,542574,604561,36.65,165.76,202.41
2022-12-03 04:00:00+08,1,7,8,61987,628998,690985,52.69,143.96,196.65
2022-12-03 08:00:00+08,2,9,11,171722,870991,1042713,59.47,175.68,235.15
2022-12-03 12:00:00+08,2,9,11,171722,927101,1098823,67.48,179.49,246.97
2022-12-03 16:00:00+08,2,10,12,171722,995464,1167186,75.48,217.07,292.55
2022-12-03 20:00:00+08,2,14,16,171722,1296546,1468268,83.48,263,346.48
2022-12-04 00:00:00+08,2,14,16,171722,1314692,1486414,91.47,206.52,297.99
2022-12-04 04:00:00+08,2,15,17,171722,1418360,1590082,99.52,263.25,362.77
2022-12-04 08:00:00+08,2,16,18,171722,1435557,1607279,107.52,325.6,433.12
2022-12-04 12:00:00+08,2,12,14,171722,1113431,1285153,115.56,260.32,375.88
2022-12-04 16:00:00+08,1,8,9,61987,846705,908692,88.7,212.57,301.27
2022-12-04 20:00:00+08,1,11,12,61987,1064612,1126599,129.76,248.28,378.04
2022-12-05 00:00:00+08,2,12,14,202440,1131398,1333838,133.95,292.58,426.53
2022-12-05 04:00:00+08,2,12,14,202440,1171657,1374097,141.99,305.81,447.8
2022-12-05 08:00:00+08,4,11,15,411375,1076992,1488367,153.83,297.89,451.72
2022-12-05 12:00:00+08,5,9,14,449257,913614,1362871,171.35,283.41,454.76
2022-12-05 16:00:00+08,6,8,14,484241,846828,1331069,185.61,303.12,488.73
2022-12-05 20:00:00+08,6,8,14,484241,861274,1345515,211.62,245.46,457.08
2022-12-06 00:00:00+08,6,6,12,484241,625683,1109924,235.6,172.64,408.24
2022-12-06 04:00:00+08,7,6,13,514578,664940,1179518,223,163.39,386.39
2022-12-06 08:00:00+08,6,7,13,447414,690960,1138374,231.97,189.32,421.29
2022-12-06 12:00:00+08,5,7,12,306961,732975,1039936,219.76,162.9,382.66
2022-12-06 16:00:00+08,4,8,12,341603,873428,1215031,237.83,192.53,430.36
2022-12-06 20:00:00+08,4,12,16,341603,1076669,1418272,302.25,142.11,444.36
2022-12-07 00:00:00+08,3,11,14,268621,1013283,1281904,284.53,127.82,412.35
2022-12-07 04:00:00+08,3,10,13,268621,908121,1176742,282.54,139.21,421.75
2022-12-07 08:00:00+08,3,10,13,268621,922753,1191374,332.7,146.21,478.91
2022-12-07 12:00:00+08,3,10,13,268621,943285,1211906,328.74,173.59,502.33
2022-12-07 16:00:00+08,3,9,12,268621,848656,1117277,340.74,192.31,533.05
2022-12-07 20:00:00+08,2,9,11,165760,844936,1010696,290.71,203.75,494.46
2022-12-08 00:00:00+08,4,7,11,339681,624688,964369,303.5,168.69,472.19
2022-12-08 04:00:00+08,4,8,12,339681,727549,1067230,353.98,199.66,553.64
2022-12-08 08:00:00+08,3,8,11,272672,635437,908109,394.37,157.46,551.83
2022-12-08 12:00:00+08,2,8,10,165760,635437,801197,390.62,189.46,580.08
2022-12-08 16:00:00+08,2,7,9,165760,540730,706490,398.63,177.32,575.95
2022-12-08 20:00:00+08,2,7,9,165760,675950,841710,391.91,86.52,478.43
2022-12-09 00:00:00+08,2,7,9,165760,675950,841710,399.91,114.52,514.43
2022-12-09 04:00:00+08,2,7,9,165760,631965,797725,407.89,101.38,509.27
2022-12-09 08:00:00+08,2,7,9,165760,631965,797725,415.89,129.38,545.27
2022-12-09 12:00:00+08,1,7,8,61987,579636,641623,288.1,124.02,412.12
2022-12-09 16:00:00+08,0,6,6,0,512472,512472,31.54,116.88,148.42
2022-12-09 20:00:00+08,0,7,7,0,627182,627182,132.12,105.17,237.29
2022-12-10 00:00:00+08,2,8,10,130164,668765,798929,137.53,136.98,274.51
2022-12-10 04:00:00+08,2,8,10,130164,668765,798929,145.53,168.98,314.51
2022-12-10 08:00:00+08,3,7,10,174217,573677,747894,131.32,129.96,261.28
2022-12-10 12:00:00+08,3,8,11,174217,800227,974444,143.32,125.88,269.2
2022-12-10 16:00:00+08,0,8,8,0,800227,800227,108.68,157.88,266.56
2022-12-10 20:00:00+08,0,11,11,0,1048940,1048940,164.17,170.33,334.5
2022-12-11 00:00:00+08,0,10,10,0,998408,998408,164.15,176.71,340.86
2022-12-11 04:00:00+08,0,10,10,0,938780,938780,164.15,186,350.15
2022-12-11 08:00:00+08,0,9,9,0,875786,875786,141.67,212.5,354.17
2022-12-11 12:00:00+08,0,6,6,0,599618,599618,33.02,130.96,163.98
2022-12-11 16:00:00+08,0,4,4,0,452704,452704,20.4,105.99,126.39
2022-12-11 20:00:00+08,0,8,8,0,732501,732501,20.4,125.38,145.78
2022-12-12 00:00:00+08,0,7,7,0,665331,665331,0,128.35,128.35
2022-12-12 04:00:00+08,0,7,7,0,665331,665331,0,156.35,156.35
2022-12-12 08:00:00+08,0,8,8,0,682488,682488,0,185.21,185.21
2022-12-12 12:00:00+08,0,7,7,0,551915,551915,0,166.89,166.89
2022-12-12 16:00:00+08,1,5,6,40478,409025,449503,2.71,128.23,130.94
2022-12-12 20:00:00+08,1,3,4,40478,267640,308118,6.7,39.04,45.74
2022-12-13 00:00:00+08,1,3,4,40478,267640,308118,10.7,51.04,61.74
2022-12-13 04:00:00+08,1,5,6,40478,473913,514391,14.7,69.09,83.79
2022-12-13 08:00:00+08,1,8,9,40478,677011,717489,18.7,91.58,110.28
2022-12-13 12:00:00+08,1,7,8,40478,659854,700332,22.7,94.71,117.41
2022-12-13 16:00:00+08,0,7,7,0,755989,755989,0,109.7,109.7
2022-12-13 20:00:00+08,1,11,12,59367,1039255,1098622,31.8,128.26,160.06
2022-12-14 00:00:00+08,2,10,12,124372,1009451,1133823,38.8,155.29,194.09
2022-12-14 04:00:00+08,2,11,13,124372,1072806,1197178,46.82,198.46,245.28
2022-12-14 08:00:00+08,2,11,13,124372,1072806,1197178,54.82,242.46,297.28
2022-12-14 12:00:00+08,2,11,13,124372,1072806,1197178,62.82,286.46,349.28
2022-12-14 16:00:00+08,1,8,9,59367,853715,913082,51.83,267.85,319.68
2022-12-14 20:00:00+08,1,7,8,59367,699335,758702,55.83,177.7,233.53
2022-12-15 00:00:00+08,1,8,9,59367,706350,765717,83.83,116.59,200.42
2022-12-15 04:00:00+08,1,8,9,59367,706350,765717,87.83,148.59,236.42
2022-12-15 08:00:00+08,1,7,8,59367,665872,725239,61.31,144.42,205.73
2022-12-15 12:00:00+08,1,7,8,59367,665872,725239,65.31,172.42,237.73
2022-12-15 16:00:00+08,1,5,6,59367,445626,504993,69.31,73.7,143.01
2022-12-15 20:00:00+08,1,4,5,59367,380621,439988,49.29,70.75,120.04
2022-12-16 00:00:00+08,1,4,5,59367,380621,439988,53.29,86.75,140.04
2022-12-16 04:00:00+08,1,6,7,59367,450968,510335,57.29,107.57,164.86
2022-12-16 08:00:00+08,2,6,8,203498,450968,654466,62.04,131.57,193.61
2022-12-16 12:00:00+08,2,7,9,203498,457852,661350,70.04,156.4,226.44
2022-12-16 16:00:00+08,2,7,9,203498,457852,661350,78.04,184.4,262.44
2022-12-16 20:00:00+08,2,7,9,203498,457852,661350,86.04,212.4,298.44
2022-12-17 00:00:00+08,2,7,9,203498,457852,661350,94.04,240.4,334.44
2022-12-17 04:00:00+08,2,5,7,203498,374704,578202,102.04,137.89,239.93
2022-12-17 08:00:00+08,2,2,4,82661,122877,205538,85.95,61.13,147.08
2022-12-17 12:00:00+08,2,3,5,82661,173574,256235,93.96,72.19,166.15
2022-12-17 16:00:00+08,2,6,8,82661,591936,674597,133.53,64.01,197.54
2022-12-17 20:00:00+08,2,10,12,82661,974052,1056713,141.53,92.48,234.01
2022-12-18 00:00:00+08,3,10,13,167444,974052,1141496,151.43,132.48,283.91
2022-12-18 04:00:00+08,3,10,13,167444,900165,1067609,163.44,113.96,277.4
2022-12-18 08:00:00+08,3,12,15,167444,1148193,1315637,175.44,158.45,333.89
2022-12-18 12:00:00+08,4,9,13,200499,934256,1134755,187.54,143.31,330.85
2022-12-18 16:00:00+08,3,10,13,115716,1079644,1195360,185.64,182.32,367.96
2022-12-18 20:00:00+08,3,10,13,115716,1048430,1164146,217.89,198.85,416.74
2022-12-19 00:00:00+08,5,9,14,352325,941529,1293854,235.32,175.15,410.47
2022-12-19 04:00:00+08,5,11,16,352325,1111078,1463403,255.34,217.45,472.79
2022-12-19 08:00:00+08,5,12,17,337355,1216436,1553791,274.01,263.61,537.62
2022-12-19 12:00:00+08,5,12,17,337355,1216436,1553791,294.01,311.61,605.62
2022-12-19 16:00:00+08,5,11,16,337355,1131653,1469008,293.76,337.96,631.72
2022-12-19 20:00:00+08,6,9,15,364166,944159,1308325,317.36,309.17,626.53
2022-12-20 00:00:00+08,6,6,12,364166,629405,993571,341.42,218.19,559.61
2022-12-20 04:00:00+08,6,9,15,364166,831975,1196141,365.34,248.94,614.28
2022-12-20 08:00:00+08,6,9,15,364166,856591,1220757,389.43,235.53,624.96
2022-12-20 12:00:00+08,6,9,15,364166,856591,1220757,413.43,271.53,684.96
2022-12-20 16:00:00+08,2,6,8,221639,695305,916944,115.79,149.7,265.49
2022-12-20 20:00:00+08,1,8,9,90388,661670,752058,210.99,81.21,292.2
2022-12-21 00:00:00+08,1,9,10,90388,691859,782247,214.98,117.06,332.04
2022-12-21 04:00:00+08,1,9,10,90388,723592,813980,270.72,128.02,398.74
2022-12-21 08:00:00+08,1,11,12,90388,938856,1029244,274.7,156.3,431
2022-12-21 12:00:00+08,1,12,13,90388,973560,1063948,278.74,201,479.74
2022-12-21 16:00:00+08,0,10,10,0,923455,923455,116.46,206.12,322.58
2022-12-21 20:00:00+08,0,11,11,0,954185,954185,176.04,223.56,399.6
2022-12-22 00:00:00+08,0,11,11,0,1060037,1060037,120.42,242.1,362.52
2022-12-22 04:00:00+08,0,13,13,0,1161879,1161879,120.42,287.36,407.78
2022-12-22 08:00:00+08,0,13,13,0,1235816,1235816,120.4,322.5,442.9
2022-12-22 12:00:00+08,0,11,11,0,1073372,1073372,120.42,298.89,419.31
2022-12-22 16:00:00+08,0,9,9,0,877970,877970,60.84,287.83,348.67
2022-12-22 20:00:00+08,0,7,7,0,515007,515007,51.72,145.31,197.03
2022-12-23 00:00:00+08,0,8,8,0,678742,678742,51.72,137.76,189.48
2022-12-23 04:00:00+08,0,9,9,0,782390,782390,51.75,171.3,223.05
2022-12-23 08:00:00+08,0,10,10,0,831390,831390,51.75,174.75,226.5
2022-12-23 12:00:00+08,0,10,10,0,846004,846004,51.75,200.55,252.3
2022-12-23 16:00:00+08,0,10,10,0,846004,846004,51.75,240.55,292.3
2022-12-23 20:00:00+08,0,10,10,0,846004,846004,51.75,280.55,332.3
2022-12-24 00:00:00+08,0,10,10,0,846004,846004,51.75,320.55,372.3
2022-12-24 04:00:00+08,0,10,10,0,846004,846004,51.75,360.55,412.3
2022-12-24 08:00:00+08,0,10,10,0,846004,846004,51.75,400.55,452.3
2022-12-24 12:00:00+08,0,10,10,0,846004,846004,51.75,440.55,492.3
2022-12-24 16:00:00+08,0,10,10,0,846004,846004,51.75,480.55,532.3
2022-12-24 20:00:00+08,0,10,10,0,846004,846004,51.75,520.55,572.3
2022-12-25 00:00:00+08,0,7,7,0,737903,737903,51.75,400.28,452.03
2022-12-25 04:00:00+08,0,7,7,0,737903,737903,51.75,428.28,480.03
2022-12-25 08:00:00+08,0,7,7,0,737903,737903,51.75,456.28,508.03
2022-12-25 12:00:00+08,0,7,7,0,737903,737903,51.75,484.28,536.03
2022-12-25 16:00:00+08,0,7,7,0,737903,737903,51.75,512.28,564.03
2022-12-25 20:00:00+08,0,7,7,0,737903,737903,51.75,540.28,592.03
2022-12-26 00:00:00+08,0,5,5,0,599768,599768,0,383.65,383.65
2022-12-26 04:00:00+08,0,5,5,0,599768,599768,0,403.65,403.65
2022-12-26 08:00:00+08,0,5,5,0,599768,599768,0,423.65,423.65
2022-12-26 12:00:00+08,0,5,5,0,599768,599768,0,443.65,443.65
2022-12-26 16:00:00+08,0,3,3,0,389146,389146,0,290.61,290.61
2022-12-26 20:00:00+08,0,6,6,0,627351,627351,0,304.36,304.36
2022-12-27 00:00:00+08,0,9,9,0,748249,748249,0,337.06,337.06
2022-12-27 04:00:00+08,0,9,9,0,748249,748249,0,373.06,373.06
2022-12-27 08:00:00+08,1,9,10,130573,748249,878822,3.15,409.06,412.21
2022-12-27 12:00:00+08,1,8,9,130573,706147,836720,7.15,431.29,438.44
2022-12-27 16:00:00+08,1,8,9,130573,662973,793546,11.15,309.62,320.77
2022-12-27 20:00:00+08,1,8,9,130573,627529,758102,15.15,203.54,218.69
2022-12-28 00:00:00+08,1,9,10,130573,731197,861770,19.14,237.89,257.03
2022-12-28 04:00:00+08,1,11,12,130573,928981,1059554,23.14,245.9,269.04
2022-12-28 08:00:00+08,2,11,13,180933,938439,1119372,30.2,277.34,307.54
2022-12-28 12:00:00+08,2,10,12,180933,870206,1051139,38.19,147.69,185.88
2022-12-28 16:00:00+08,1,10,11,130573,861388,991961,35.16,165.69,200.85
2022-12-28 20:00:00+08,1,11,12,130573,951071,1081644,53.47,169.77,223.24
2022-12-29 00:00:00+08,1,8,9,130573,647697,778270,57.5,103.65,161.15
2022-12-29 04:00:00+08,3,13,16,385323,1162769,1548092,66.27,148.92,215.19
2022-12-29 08:00:00+08,1,12,13,130573,1059101,1189674,65.49,166.57,232.06
2022-12-29 12:00:00+08,1,11,12,130573,959697,1090270,78.24,155.22,233.46
2022-12-29 16:00:00+08,1,11,12,130573,1134381,1264954,83.58,155.56,239.14
2022-12-29 20:00:00+08,1,12,13,130573,1197042,1327615,87.54,175.57,263.11
2022-12-30 00:00:00+08,1,11,12,130573,1061530,1192103,91.51,158.99,250.5
2022-12-30 04:00:00+08,2,11,13,182306,1061530,1243836,95.81,202.99,298.8
2022-12-30 08:00:00+08,1,10,11,51733,1012510,1064243,28.68,184.87,213.55
2022-12-30 12:00:00+08,1,9,10,51733,910057,961790,32.69,208.74,241.43
2022-12-30 16:00:00+08,1,8,9,41829,848070,889899,28.08,224.53,252.61
2022-12-30 20:00:00+08,1,11,12,41829,992782,1034611,48.09,229.74,277.83
2022-12-31 00:00:00+08,1,9,10,41829,682123,723952,52.07,160.19,212.26
2022-12-31 04:00:00+08,1,9,10,41829,682123,723952,56.07,196.19,252.26
2022-12-31 08:00:00+08,0,10,10,0,724980,724980,139.5,176.75,316.25
2022-12-31 12:00:00+08,0,11,11,0,829985,829985,162.27,205.88,368.15
2022-12-31 16:00:00+08,0,10,10,0,766585,766585,162.28,228.35,390.63
2022-12-31 20:00:00+08,0,7,7,0,580854,580854,137.56,163.52,301.08
2023-01-01 00:00:00+08,1,7,8,77941,580854,658795,138.23,191.52,329.75
2023-01-01 04:00:00+08,2,7,9,171486,580854,752340,142.82,219.52,362.34
2023-01-01 08:00:00+08,2,7,9,171486,580854,752340,150.82,247.52,398.34
2023-01-01 12:00:00+08,2,7,9,171486,580854,752340,158.82,275.52,434.34
2023-01-01 16:00:00+08,2,7,9,171486,580854,752340,166.82,303.52,470.34
2023-01-01 20:00:00+08,2,7,9,171486,580854,752340,174.82,331.52,506.34
2023-01-02 00:00:00+08,2,6,8,171486,559384,730870,182.82,292.12,474.94
2023-01-02 04:00:00+08,2,7,9,171486,595350,766836,190.82,319.18,510
2023-01-02 08:00:00+08,3,8,11,222018,669334,891352,201.9,350.63,552.53
2023-01-02 12:00:00+08,3,9,12,222018,778104,1000122,213.9,384.1,598
2023-01-02 16:00:00+08,3,9,12,222018,778104,1000122,225.9,420.1,646
2023-01-02 20:00:00+08,3,13,16,222018,1050672,1272690,237.92,459.12,697.04
2023-01-03 00:00:00+08,4,15,19,344977,1177963,1522940,252.8,517.1,769.9
2023-01-03 04:00:00+08,5,15,20,498715,1177963,1676678,268.86,577.1,845.96
2023-01-03 08:00:00+08,5,14,19,498715,1141997,1640712,288.86,606.02,894.88
2023-01-03 12:00:00+08,4,14,18,420774,1141997,1562771,248.21,662.02,910.23
2023-01-03 16:00:00+08,4,13,17,420774,1159818,1580592,303.43,624.88,928.31
2023-01-03 20:00:00+08,4,7,11,420774,588737,1009511,303.76,234.03,537.79
2023-01-04 00:00:00+08,3,7,10,297815,529420,827235,193.75,176.58,370.33
2023-01-04 04:00:00+08,2,10,12,204270,887214,1091484,161.01,213.36,374.37
2023-01-04 08:00:00+08,2,10,12,204270,756107,960377,169.04,177.77,346.81
2023-01-04 12:00:00+08,2,11,13,204270,849652,1053922,254.86,220.54,475.4
2023-01-04 16:00:00+08,1,11,12,50532,849652,900184,226.8,264.54,491.34
2023-01-04 20:00:00+08,1,9,10,50532,716787,767319,230.79,261.49,492.28
2023-01-05 00:00:00+08,2,10,12,177608,981262,1158870,214.93,252.94,467.87
2023-01-05 04:00:00+08,2,9,11,177608,913618,1091226,222.93,269.65,492.58
2023-01-05 08:00:00+08,2,10,12,177608,999298,1176906,230.92,307.36,538.28
2023-01-05 12:00:00+08,2,10,12,177608,999298,1176906,238.92,347.36,586.28
2023-01-05 16:00:00+08,2,10,12,177608,999298,1176906,246.92,387.36,634.28
2023-01-05 20:00:00+08,2,9,11,177608,852612,1030220,254.94,361.74,616.68
2023-01-06 00:00:00+08,2,9,11,177608,824925,1002533,185.06,336.66,521.72
2023-01-06 04:00:00+08,2,9,11,177608,757762,935370,193.07,322.6,515.67
2023-01-06 08:00:00+08,1,8,9,127076,708668,835744,101.99,276.04,378.03
2023-01-06 12:00:00+08,1,9,10,127076,807824,934900,207.32,296.39,503.71
2023-01-06 16:00:00+08,1,9,10,127076,815093,942169,211.32,317.59,528.91
2023-01-06 20:00:00+08,1,12,13,127076,1088772,1215848,215.29,355.34,570.63
2023-01-07 00:00:00+08,1,11,12,127076,875475,1002551,150.57,281.28,431.85
2023-01-07 04:00:00+08,2,12,14,234060,898769,1132829,155.7,328.34,484.04
2023-01-07 08:00:00+08,2,12,14,234060,934326,1168386,163.7,349.08,512.78
2023-01-07 12:00:00+08,2,10,12,234060,942574,1176634,171.7,186.37,358.07
2023-01-07 16:00:00+08,2,8,10,234060,818600,1052660,179.7,179.4,359.1
2023-01-07 20:00:00+08,1,8,9,127076,858323,985399,69.26,161.59,230.85
2023-01-08 00:00:00+08,0,10,10,0,905603,905603,0,170.53,170.53
2023-01-08 04:00:00+08,0,10,10,0,904013,904013,21.88,181.61,203.49
2023-01-08 08:00:00+08,0,11,11,0,1013815,1013815,21.85,224.87,246.72
2023-01-08 12:00:00+08,0,10,10,0,882568,882568,21.84,213.49,235.33
2023-01-08 16:00:00+08,0,10,10,0,851674,851674,107.4,171.46,278.86
2023-01-08 20:00:00+08,0,9,9,0,860627,860627,107.4,152.23,259.63
2023-01-09 00:00:00+08,0,10,10,0,959798,959798,107.41,164.3,271.71
2023-01-09 04:00:00+08,0,10,10,0,954661,954661,85.53,180.86,266.39
2023-01-09 08:00:00+08,1,9,10,50775,912667,963442,86.73,187.67,274.4
2023-01-09 12:00:00+08,1,9,10,50775,912667,963442,90.73,223.67,314.4
2023-01-09 16:00:00+08,1,10,11,50775,1021308,1072083,94.73,261.13,355.86
2023-01-09 20:00:00+08,1,7,8,50775,625063,675838,13.21,132.97,146.18
2023-01-10 00:00:00+08,1,7,8,50775,625063,675838,17.21,160.97,178.18
2023-01-10 04:00:00+08,1,11,12,50775,1041142,1091917,27.54,171.32,198.86
2023-01-10 08:00:00+08,1,10,11,50775,1006520,1057295,31.55,179.55,211.1
2023-01-10 12:00:00+08,1,7,8,50775,731740,782515,35.55,124.66,160.21
2023-01-10 16:00:00+08,1,6,7,50775,710478,761253,33.21,139.61,172.82
2023-01-10 20:00:00+08,1,9,10,50775,1019114,1069889,37.2,169.28,206.48
2023-01-11 00:00:00+08,1,9,10,50775,1062977,1113752,41.21,147.53,188.74
2023-01-11 04:00:00+08,1,10,11,50775,1130694,1181469,45.19,186.8,231.99
2023-01-11 08:00:00+08,1,9,10,50775,898809,949584,49.19,134.97,184.16
2023-01-11 12:00:00+08,1,9,10,50775,898809,949584,53.19,170.97,224.16
2023-01-11 16:00:00+08,1,8,9,50775,833846,884621,57.2,185.62,242.82
2023-01-11 20:00:00+08,1,7,8,50775,727569,778344,61.2,152.84,214.04
2023-01-12 00:00:00+08,1,9,10,50775,881689,932464,65.22,137.7,202.92
2023-01-12 04:00:00+08,1,9,10,50775,856200,906975,69.22,124.78,194
2023-01-12 08:00:00+08,2,11,13,90877,1045476,1136353,73.66,163.28,236.94
2023-01-12 12:00:00+08,2,9,11,90877,828782,919659,81.67,134.58,216.25
2023-01-12 16:00:00+08,2,9,11,90877,828782,919659,89.67,170.58,260.25
2023-01-12 20:00:00+08,2,10,12,90877,879164,970041,97.7,208,305.7
2023-01-13 00:00:00+08,2,9,11,90877,816320,907197,105.67,203.43,309.1
2023-01-13 04:00:00+08,2,8,10,90877,749635,840512,113.7,211.34,325.04
2023-01-13 08:00:00+08,1,9,10,40102,756519,796621,24.47,244.28,268.75
2023-01-13 12:00:00+08,1,8,9,40102,607545,647647,128.43,182.75,311.18
2023-01-13 16:00:00+08,0,6,6,0,432176,432176,99.96,129.93,229.89
2023-01-13 20:00:00+08,0,9,9,0,690768,690768,135.75,136.2,271.95
2023-01-14 00:00:00+08,0,11,11,0,878292,878292,135.72,176.59,312.31
2023-01-14 04:00:00+08,0,10,10,0,732904,732904,135.72,163.82,299.54
2023-01-14 08:00:00+08,0,10,10,0,791868,791868,99.96,192.81,292.77
2023-01-14 12:00:00+08,1,8,9,57830,787381,845211,107.26,151.24,258.5
2023-01-14 16:00:00+08,1,7,8,57830,693983,751813,111.26,161.94,273.2
2023-01-14 20:00:00+08,1,7,8,57830,737547,795377,15.29,73.84,89.13
2023-01-15 00:00:00+08,1,10,11,57830,964508,1022338,19.32,107.86,127.18
2023-01-15 04:00:00+08,1,10,11,57830,964508,1022338,23.32,147.86,171.18
2023-01-15 08:00:00+08,1,10,11,57830,964508,1022338,27.32,187.86,215.18
2023-01-15 12:00:00+08,1,10,11,57830,964508,1022338,31.32,227.86,259.18
2023-01-15 16:00:00+08,0,7,7,0,716351,716351,7.2,196.95,204.15
2023-01-15 20:00:00+08,0,6,6,0,655552,655552,38,178.45,216.45
2023-01-16 00:00:00+08,0,6,6,0,689901,689901,37.97,156.12,194.09
2023-01-16 04:00:00+08,0,6,6,0,689901,689901,37.97,180.12,218.09
2023-01-16 08:00:00+08,1,5,6,30234,568957,599191,32.45,156.44,188.89
2023-01-16 12:00:00+08,1,3,4,30234,320538,350772,36.45,73.58,110.03
2023-01-16 16:00:00+08,1,4,5,30234,354229,384463,40.46,87.42,127.88
2023-01-16 20:00:00+08,0,4,4,0,354229,354229,30.8,103.42,134.22
2023-01-17 00:00:00+08,0,2,2,0,187399,187399,0,36.99,36.99
2023-01-17 04:00:00+08,0,3,3,0,217633,217633,18.04,48.61,66.65
2023-01-17 08:00:00+08,0,3,3,0,217633,217633,18.04,60.61,78.65
2023-01-17 12:00:00+08,1,2,3,50689,63925,114614,19.11,33.46,52.57
2023-01-17 16:00:00+08,1,1,2,50689,30234,80923,23.11,15.61,38.72
2023-01-17 20:00:00+08,1,5,6,50689,405194,455883,27.11,24.58,51.69
2023-01-18 00:00:00+08,0,4,4,0,374960,374960,0,20.96,20.96
2023-01-18 04:00:00+08,0,6,6,0,586742,586742,0,43.42,43.42
2023-01-18 08:00:00+08,0,10,10,0,947647,947647,0,75.8,75.8
2023-01-18 12:00:00+08,0,9,9,0,874105,874105,24.39,88.61,113
2023-01-18 16:00:00+08,0,8,8,0,765105,765105,24.39,104.07,128.46
2023-01-18 20:00:00+08,0,9,9,0,873455,873455,24.39,136.91,161.3
2023-01-19 00:00:00+08,0,8,8,0,855164,855164,24.39,153.16,177.55
2023-01-19 04:00:00+08,0,8,8,0,675067,675067,24.39,122.69,147.08
2023-01-19 08:00:00+08,0,10,10,0,843965,843965,24.39,145.55,169.94
2023-01-19 12:00:00+08,0,10,10,0,843965,843965,24.39,185.55,209.94
2023-01-19 16:00:00+08,0,6,6,0,483661,483661,0,89.85,89.85
2023-01-19 20:00:00+08,0,7,7,0,649713,649713,0,97.8,97.8
2023-01-20 00:00:00+08,1,8,9,139335,711700,851035,1.87,129.56,131.43
2023-01-20 04:00:00+08,1,9,10,139335,792871,932206,5.87,164.54,170.41
2023-01-20 08:00:00+08,0,9,9,0,792871,792871,0,200.54,200.54
2023-01-20 12:00:00+08,0,5,5,0,392809,392809,0,96.25,96.25
2023-01-20 16:00:00+08,0,4,4,0,342502,342502,17.04,49.42,66.46
2023-01-20 20:00:00+08,0,6,6,0,520660,520660,17.04,47.45,64.49
2023-01-21 00:00:00+08,0,8,8,0,738785,738785,17.04,75.34,92.38
2023-01-21 04:00:00+08,0,8,8,0,738785,738785,17.04,107.34,124.38
2023-01-21 08:00:00+08,0,9,9,0,801799,801799,17.04,140.7,157.74
2023-01-21 12:00:00+08,0,10,10,0,886580,886580,17.04,165.3,182.34
2023-01-21 16:00:00+08,0,10,10,0,886580,886580,17.04,205.3,222.34
2023-01-21 20:00:00+08,1,7,8,44053,723155,767208,20.39,158.21,178.6
2023-01-22 00:00:00+08,1,8,9,44053,872147,916200,24.39,189.69,214.08
2023-01-22 04:00:00+08,1,8,9,44053,903613,947666,28.39,204.27,232.66
2023-01-22 08:00:00+08,0,7,7,0,767853,767853,15.08,172.82,187.9
2023-01-22 12:00:00+08,0,6,6,0,631763,631763,15.08,99.07,114.15
2023-01-22 16:00:00+08,0,6,6,0,631763,631763,15.08,123.07,138.15
2023-01-22 20:00:00+08,1,7,8,120934,743022,863956,15.77,131.31,147.08
2023-01-23 00:00:00+08,1,6,7,50629,648315,698944,15.91,108.44,124.35
2023-01-23 04:00:00+08,1,8,9,50629,882727,933356,26.45,138.49,164.94
2023-01-23 08:00:00+08,1,8,9,50629,850586,901215,30.47,135.62,166.09
2023-01-23 12:00:00+08,1,7,8,50629,806533,857162,19.38,139.36,158.74
2023-01-23 16:00:00+08,1,7,8,50629,725841,776470,23.36,111.95,135.31
2023-01-23 20:00:00+08,1,9,10,50629,806505,857134,27.37,143.3,170.67
2023-01-24 00:00:00+08,2,8,10,101225,754359,855584,33.09,150.07,183.16
2023-01-24 04:00:00+08,2,9,11,101225,789425,890650,41.09,185.18,226.27
2023-01-24 08:00:00+08,2,7,9,101225,533919,635144,49.11,144.41,193.52
2023-01-24 12:00:00+08,2,5,7,101225,484794,586019,57.11,134.64,191.75
2023-01-24 16:00:00+08,1,4,5,50629,449728,500357,47.39,139.54,186.93
2023-01-24 20:00:00+08,1,8,9,50629,774992,825621,72.71,108,180.71
2023-01-25 00:00:00+08,2,8,10,121885,743973,865858,78.04,100.92,178.96
2023-01-25 04:00:00+08,2,8,10,121885,743973,865858,86.04,132.92,218.96
2023-01-25 08:00:00+08,2,8,10,121885,770328,892213,94.03,128.88,222.91
2023-01-25 12:00:00+08,2,8,10,121885,683708,805593,95.47,106.06,201.53
2023-01-25 16:00:00+08,1,8,9,71256,683708,754964,38.64,138.06,176.7
2023-01-25 20:00:00+08,1,9,10,71256,802019,873275,110.51,149.78,260.29
2023-01-26 00:00:00+08,1,10,11,71256,867984,939240,114.48,187.22,301.7
2023-01-26 04:00:00+08,0,8,8,0,721285,721285,67.84,162.66,230.5
2023-01-26 08:00:00+08,1,9,10,52156,854628,906784,102.66,171.76,274.42
2023-01-26 12:00:00+08,1,9,10,52156,854628,906784,106.66,207.76,314.42
2023-01-26 16:00:00+08,1,8,9,52156,752781,804937,110.66,199.3,309.96
2023-01-26 20:00:00+08,1,12,13,52156,1050032,1102188,120.16,188.53,308.69
2023-01-27 00:00:00+08,1,11,12,52156,999403,1051559,56.37,207.52,263.89
2023-01-27 04:00:00+08,1,12,13,52156,1025267,1077423,60.37,252.08,312.45
2023-01-27 08:00:00+08,1,11,12,52156,927404,979560,32.35,242.61,274.96
2023-01-27 12:00:00+08,2,11,13,87601,899974,987575,38.75,236.24,274.99
2023-01-27 16:00:00+08,1,9,10,52156,717897,770053,34.81,169.22,204.03
2023-01-27 20:00:00+08,1,10,11,52156,829684,881840,48.83,193,241.83
2023-01-28 00:00:00+08,1,12,13,52156,943703,995859,52.83,235.34,288.17
2023-01-28 04:00:00+08,1,10,11,52156,856202,908358,46.82,241.15,287.97
2023-01-28 08:00:00+08,1,11,12,52156,1067508,1119664,50.82,256.58,307.4
2023-01-28 12:00:00+08,1,9,10,52156,993454,1045610,54.8,234.93,289.73
2023-01-28 16:00:00+08,0,6,6,0,643059,643059,0,150.38,150.38
2023-01-28 20:00:00+08,0,11,11,0,1024208,1024208,0,177.03,177.03
2023-01-29 00:00:00+08,0,10,10,0,871981,871981,63.04,124.15,187.19
2023-01-29 04:00:00+08,0,11,11,0,1065115,1065115,63.04,132.32,195.36
2023-01-29 08:00:00+08,1,12,13,27025,1211052,1238077,63.7,180.21,243.91
2023-01-29 12:00:00+08,1,10,11,27025,1061063,1088088,67.7,171.44,239.14
2023-01-29 16:00:00+08,1,7,8,27025,825261,852286,71.69,136.67,208.36
2023-01-29 20:00:00+08,1,7,8,27025,825261,852286,75.69,164.67,240.36
2023-01-30 00:00:00+08,1,6,7,27025,701980,729005,79.69,149.96,229.65
2023-01-30 04:00:00+08,0,5,5,0,571407,571407,63.04,141.43,204.47
2023-01-30 08:00:00+08,0,6,6,0,658635,658635,23.96,129.4,153.36
2023-01-30 12:00:00+08,0,6,6,0,658635,658635,23.96,153.4,177.36
2023-01-30 16:00:00+08,0,6,6,0,605851,605851,23.96,133.76,157.72
2023-01-30 20:00:00+08,0,6,6,0,605851,605851,23.96,157.76,181.72
2023-01-31 00:00:00+08,0,5,5,0,578826,578826,0,165.07,165.07
2023-01-31 04:00:00+08,0,5,5,0,579338,579338,0,176.03,176.03
2023-01-31 08:00:00+08,0,5,5,0,600186,600186,0,139,139
2023-01-31 12:00:00+08,0,3,3,0,364866,364866,0,68.14,68.14
2023-01-31 16:00:00+08,0,3,3,0,364866,364866,0,80.14,80.14
2023-01-31 20:00:00+08,0,7,7,0,626607,626607,0,96.95,96.95
2023-02-01 00:00:00+08,0,8,8,0,730298,730298,0,128.43,128.43
2023-02-01 04:00:00+08,0,7,7,0,709036,709036,0,140.34,140.34
2023-02-01 08:00:00+08,0,8,8,0,788439,788439,0,170.36,170.36
2023-02-01 12:00:00+08,0,8,8,0,792987,792987,0,186.88,186.88
2023-02-01 16:00:00+08,0,6,6,0,552233,552233,0,111.99,111.99
2023-02-01 20:00:00+08,0,11,11,0,929133,929133,0,140.36,140.36
2023-02-02 00:00:00+08,0,10,10,0,891053,891053,0,155.11,155.11
2023-02-02 04:00:00+08,0,10,10,0,891053,891053,0,195.11,195.11
2023-02-02 08:00:00+08,1,7,8,118814,490967,609781,0.78,135.77,136.55
2023-02-02 12:00:00+08,1,5,6,118814,314696,433510,4.79,78.19,82.98
2023-02-02 16:00:00+08,1,5,6,118814,314696,433510,8.79,98.19,106.98
2023-02-02 20:00:00+08,1,6,7,118814,362971,481785,12.79,95.46,108.25
2023-02-03 00:00:00+08,0,4,4,0,265270,265270,0,53.41,53.41
2023-02-03 04:00:00+08,0,6,6,0,327685,327685,17.83,47.01,64.84
2023-02-03 08:00:00+08,0,7,7,0,334569,334569,17.83,72.9,90.73
2023-02-03 12:00:00+08,0,5,5,0,245016,245016,17.83,57.83,75.66
2023-02-03 16:00:00+08,0,5,5,0,245016,245016,17.83,77.83,95.66
2023-02-03 20:00:00+08,0,6,6,0,401632,401632,17.82,58.69,76.51
2023-02-04 00:00:00+08,0,7,7,0,552199,552199,17.82,63.53,81.35
2023-02-04 04:00:00+08,1,7,8,144143,552199,696342,20.8,91.53,112.33
2023-02-04 08:00:00+08,1,7,8,144143,552199,696342,24.8,119.53,144.33
2023-02-04 12:00:00+08,1,7,8,144143,552199,696342,28.8,147.53,176.33
2023-02-04 16:00:00+08,0,7,7,0,552199,552199,17.82,175.53,193.35
2023-02-04 20:00:00+08,0,7,7,0,643622,643622,17.84,140.89,158.73
2023-02-05 00:00:00+08,0,8,8,0,822652,822652,36.91,140.81,177.72
2023-02-05 04:00:00+08,0,10,10,0,986641,986641,36.92,175.24,212.16
2023-02-05 08:00:00+08,0,9,9,0,902933,902933,19.12,128.25,147.37
2023-02-05 12:00:00+08,0,7,7,0,785056,785056,19.12,116.53,135.65
2023-02-05 16:00:00+08,0,6,6,0,671578,671578,19.12,100.18,119.3
2023-02-05 20:00:00+08,0,8,8,0,694975,694975,19.12,102.81,121.93
2023-02-06 00:00:00+08,0,10,10,0,945625,945625,19.11,139.24,158.35
2023-02-06 04:00:00+08,0,10,10,0,945625,945625,19.11,179.24,198.35
2023-02-06 08:00:00+08,1,8,9,155802,855378,1011180,19.35,139.5,158.85
2023-02-06 12:00:00+08,1,9,10,155802,940066,1095868,23.35,174.07,197.42
2023-02-06 16:00:00+08,1,10,11,155802,1007863,1163665,27.35,212.85,240.2
2023-02-06 20:00:00+08,1,10,11,155802,967258,1123060,31.35,230.55,261.9
2023-02-07 00:00:00+08,1,7,8,155802,774822,930624,35.35,197.84,233.19
2023-02-07 04:00:00+08,1,5,6,155802,525269,681071,39.34,155.34,194.68
2023-02-07 08:00:00+08,1,4,5,155802,341113,496915,24.24,65.47,89.71
2023-02-07 12:00:00+08,1,4,5,155802,341113,496915,28.24,81.47,109.71
2023-02-07 16:00:00+08,0,4,4,0,300127,300127,0,70.89,70.89
2023-02-07 20:00:00+08,0,9,9,0,803874,803874,32.58,82.45,115.03
2023-02-08 00:00:00+08,0,11,11,0,848508,848508,32.58,77.63,110.21
2023-02-08 04:00:00+08,0,12,12,0,957149,957149,32.58,123.29,155.87
2023-02-08 08:00:00+08,0,11,11,0,920159,920159,32.58,158.35,190.93
2023-02-08 12:00:00+08,0,10,10,0,835388,835388,32.58,185.21,217.79
2023-02-08 16:00:00+08,0,7,7,0,685309,685309,32.58,143.4,175.98
2023-02-08 20:00:00+08,0,7,7,0,601121,601121,32.58,124.14,156.72
2023-02-09 00:00:00+08,0,8,8,0,757361,757361,32.58,125.57,158.15
2023-02-09 04:00:00+08,0,8,8,0,757361,757361,32.58,157.57,190.15
2023-02-09 08:00:00+08,0,6,6,0,518147,518147,32.58,123.39,155.97
2023-02-09 12:00:00+08,0,5,5,0,438744,438744,32.58,132.53,165.11
2023-02-09 16:00:00+08,0,5,5,0,438744,438744,32.58,152.53,185.11
2023-02-09 20:00:00+08,0,9,9,0,653303,653303,32.58,175.52,208.1
2023-02-10 00:00:00+08,0,10,10,0,769003,769003,32.58,211.54,244.12
2023-02-10 04:00:00+08,0,10,10,0,769003,769003,32.58,251.54,284.12
2023-02-10 08:00:00+08,0,9,9,0,775752,775752,32.58,267.53,300.11
2023-02-10 12:00:00+08,0,9,9,0,833078,833078,32.58,248.28,280.86
2023-02-10 16:00:00+08,0,9,9,0,833078,833078,32.58,284.28,316.86
2023-02-10 20:00:00+08,0,9,9,0,768894,768894,32.58,250.15,282.73
2023-02-11 00:00:00+08,0,9,9,0,691038,691038,0,207.6,207.6
2023-02-11 04:00:00+08,2,8,10,203540,596438,799978,3.19,187.55,190.74
2023-02-11 08:00:00+08,1,9,10,84705,694254,778959,11.17,208.32,219.49
2023-02-11 12:00:00+08,1,6,7,84705,537370,622075,15.19,166.07,181.26
2023-02-11 16:00:00+08,0,5,5,0,435879,435879,4.39,156.53,160.92
2023-02-11 20:00:00+08,0,5,5,0,516763,516763,21.2,145.39,166.59
2023-02-12 00:00:00+08,0,5,5,0,516763,516763,21.2,165.39,186.59
2023-02-12 04:00:00+08,0,7,7,0,759628,759628,21.2,192.81,214.01
2023-02-12 08:00:00+08,0,6,6,0,709096,709096,21.2,111.23,132.43
2023-02-12 12:00:00+08,0,6,6,0,709096,709096,21.2,135.23,156.43
2023-02-12 16:00:00+08,0,8,8,0,792523,792523,21.2,166.44,187.64
2023-02-12 20:00:00+08,0,7,7,0,740768,740768,4.41,147.27,151.68
2023-02-13 00:00:00+08,0,9,9,0,959774,959774,4.4,175.85,180.25
2023-02-13 04:00:00+08,1,9,10,24757,1073478,1098235,4.65,197.63,202.28
2023-02-13 08:00:00+08,1,8,9,24757,927789,952546,8.65,135.46,144.11
2023-02-13 12:00:00+08,1,7,8,24757,808954,833711,8.25,115.46,123.71
2023-02-13 16:00:00+08,0,5,5,0,646085,646085,0,105.66,105.66
2023-02-13 20:00:00+08,0,7,7,0,780945,780945,15.12,127.33,142.45
2023-02-14 00:00:00+08,0,8,8,0,708099,708099,15.12,132.55,147.67
2023-02-14 04:00:00+08,0,7,7,0,576848,576848,15.12,112.93,128.05
2023-02-14 08:00:00+08,0,6,6,0,495103,495103,15.1,101.44,116.54
2023-02-14 12:00:00+08,0,6,6,0,495103,495103,15.1,125.44,140.54
2023-02-14 16:00:00+08,0,4,4,0,360243,360243,0,107.75,107.75
2023-02-14 20:00:00+08,1,9,10,50525,800776,851301,2.53,132.28,134.81
2023-02-15 00:00:00+08,1,10,11,50525,868941,919466,6.55,169.17,175.72
2023-02-15 04:00:00+08,1,9,10,50697,846627,897324,0.39,181.16,181.55
2023-02-15 08:00:00+08,1,9,10,50697,674292,724989,18.02,105.19,123.21
2023-02-15 12:00:00+08,1,10,11,50697,784508,835205,22.02,126.82,148.84
2023-02-15 16:00:00+08,0,6,6,0,562809,562809,13.66,72.58,86.24
2023-02-15 20:00:00+08,0,9,9,0,795667,795667,29.2,100.03,129.23
2023-02-16 00:00:00+08,0,8,8,0,730937,730937,29.22,106.35,135.57
2023-02-16 04:00:00+08,0,9,9,0,761131,761131,29.22,142.04,171.26
2023-02-16 08:00:00+08,0,9,9,0,749222,749222,15.54,154.46,170
2023-02-16 12:00:00+08,0,8,8,0,562752,562752,15.54,147.08,162.62
2023-02-16 16:00:00+08,0,6,6,0,536131,536131,0,99.84,99.84
2023-02-16 20:00:00+08,0,9,9,0,849632,849632,0,127.36,127.36
2023-02-17 00:00:00+08,1,9,10,53462,785243,838705,3.28,134.1,137.38
2023-02-17 04:00:00+08,0,9,9,0,863819,863819,0,146.24,146.24
2023-02-17 08:00:00+08,0,9,9,0,878665,878665,9.56,158.63,168.19
2023-02-17 12:00:00+08,0,11,11,0,938062,938062,9.55,200.67,210.22
2023-02-17 16:00:00+08,0,9,9,0,754648,754648,9.56,195.48,205.04
2023-02-17 20:00:00+08,0,9,9,0,669582,669582,0,149.21,149.21
2023-02-18 00:00:00+08,0,12,12,0,817570,817570,0,193.84,193.84
2023-02-18 04:00:00+08,0,14,14,0,1062960,1062960,0,245,245
2023-02-18 08:00:00+08,0,13,13,0,954190,954190,0,269.18,269.18
2023-02-18 12:00:00+08,0,9,9,0,734990,734990,0,215.29,215.29
2023-02-18 16:00:00+08,0,7,7,0,681663,681663,0,213.85,213.85
2023-02-18 20:00:00+08,1,7,8,55301,728135,783436,1.4,216.29,217.69
2023-02-19 00:00:00+08,0,9,9,0,789676,789676,3.3,212.9,216.2
2023-02-19 04:00:00+08,0,9,9,0,789676,789676,3.3,248.9,252.2
2023-02-19 08:00:00+08,0,8,8,0,771401,771401,3.3,274.45,277.75
2023-02-19 12:00:00+08,1,8,9,50435,771401,821836,5.26,306.45,311.71
2023-02-19 16:00:00+08,1,7,8,50435,716100,766535,5.95,320.35,326.3
2023-02-19 20:00:00+08,1,9,10,50435,870895,921330,9.95,349.98,359.93
2023-02-20 00:00:00+08,1,7,8,50435,641170,691605,13.95,264.45,278.4
2023-02-20 04:00:00+08,0,5,5,0,415262,415262,0,204.48,204.48
2023-02-20 08:00:00+08,0,5,5,0,425219,425219,19.68,191.78,211.46
2023-02-20 12:00:00+08,0,5,5,0,425219,425219,19.68,211.78,231.46
2023-02-20 16:00:00+08,0,4,4,0,404433,404433,19.67,94.45,114.12
2023-02-20 20:00:00+08,1,8,9,138882,678335,817217,21.08,113.73,134.81
2023-02-21 00:00:00+08,0,8,8,0,712144,712144,19.66,117.86,137.52
2023-02-21 04:00:00+08,0,8,8,0,800591,800591,7.44,129.56,137
2023-02-21 08:00:00+08,0,9,9,0,821853,821853,7.44,163.78,171.22
2023-02-21 12:00:00+08,0,7,7,0,585682,585682,7.44,100.04,107.48
2023-02-21 16:00:00+08,0,6,6,0,537012,537012,7.44,83.08,90.52
2023-02-21 20:00:00+08,0,8,8,0,787586,787586,7.44,84.3,91.74
2023-02-22 00:00:00+08,0,7,7,0,736792,736792,7.44,87.51,94.95
2023-02-22 04:00:00+08,0,6,6,0,665536,665536,7.44,106.92,114.36
2023-02-22 08:00:00+08,1,5,6,49963,644274,694237,8.57,104.7,113.27
2023-02-22 12:00:00+08,1,6,7,49963,698791,748754,12.57,111.9,124.47
2023-02-22 16:00:00+08,0,6,6,0,687356,687356,0,101.04,101.04
2023-02-22 20:00:00+08,0,9,9,0,814296,814296,12.22,84.09,96.31
2023-02-23 00:00:00+08,0,8,8,0,787428,787428,12.22,106.49,118.71
2023-02-23 04:00:00+08,0,9,9,0,889207,889207,12.22,141.42,153.64
2023-02-23 08:00:00+08,1,7,8,40102,653119,693221,13.13,121.66,134.79
2023-02-23 12:00:00+08,1,7,8,40102,644170,684272,17.13,135.91,153.04
2023-02-23 16:00:00+08,1,6,7,40102,512907,553009,21.13,133.74,154.87
2023-02-23 20:00:00+08,1,7,8,40102,534162,574264,25.11,105.57,130.68
2023-02-24 00:00:00+08,1,10,11,40102,892883,932985,16.89,112.8,129.69
2023-02-24 04:00:00+08,1,10,11,40102,892883,932985,20.89,152.8,173.69
2023-02-24 08:00:00+08,1,11,12,40102,944616,984718,24.92,193.06,217.98
2023-02-24 12:00:00+08,1,12,13,40102,951500,991602,28.92,239.02,267.94
2023-02-24 16:00:00+08,0,11,11,0,916796,916796,0,242.47,242.47
2023-02-24 20:00:00+08,0,13,13,0,1015185,1015185,36.9,173.27,210.17
2023-02-25 00:00:00+08,1,10,11,112516,747317,859833,38.55,141.09,179.64
2023-02-25 04:00:00+08,1,10,11,112516,781263,893779,42.54,126.98,169.52
2023-02-25 08:00:00+08,1,10,11,112516,770965,883481,9.67,156.7,166.37
2023-02-25 12:00:00+08,1,5,6,112516,447524,560040,13.69,80.02,93.71
2023-02-25 16:00:00+08,1,6,7,112516,589546,702062,17.69,101.18,118.87
2023-02-25 20:00:00+08,1,7,8,112516,730484,843000,21.67,112.31,133.98
2023-02-26 00:00:00+08,1,8,9,112516,662524,775040,25.67,93.56,119.23
2023-02-26 04:00:00+08,1,11,12,112516,974786,1087302,29.66,131.56,161.22
2023-02-26 08:00:00+08,1,9,10,112516,852044,964560,33.69,130.2,163.89
2023-02-26 12:00:00+08,1,8,9,112516,799181,911697,37.69,148.94,186.63
2023-02-26 16:00:00+08,1,5,6,112516,568223,680739,41.68,91.14,132.82
2023-02-26 20:00:00+08,1,4,5,112516,499969,612485,45.68,91.18,136.86
2023-02-27 00:00:00+08,1,5,6,112516,615966,728482,49.7,107.24,156.94
2023-02-27 04:00:00+08,1,6,7,112516,683763,796279,53.7,129.25,182.95
2023-02-27 08:00:00+08,0,7,7,0,789121,789121,0,153.35,153.35
2023-02-27 12:00:00+08,0,6,6,0,672189,672189,0,148.42,148.42
2023-02-27 16:00:00+08,0,7,7,0,784705,784705,61.88,176.23,238.11
2023-02-27 20:00:00+08,0,7,7,0,784705,784705,61.88,204.23,266.11
2023-02-28 00:00:00+08,0,4,4,0,427693,427693,61.88,107.04,168.92
2023-02-28 04:00:00+08,0,5,5,0,568358,568358,61.88,123.33,185.21
2023-02-28 08:00:00+08,1,7,8,146778,822311,969089,62.3,120.2,182.5
2023-02-28 12:00:00+08,1,6,7,146778,680289,827067,66.27,79.05,145.32
2023-02-28 16:00:00+08,1,7,8,146778,758230,905008,70.27,104.79,175.06
2023-02-28 20:00:00+08,1,9,10,146778,968467,1115245,74.3,136.57,210.87
2023-03-01 00:00:00+08,1,9,10,146778,1004943,1151721,16.4,137.1,153.5
2023-03-01 04:00:00+08,1,9,10,146778,1004943,1151721,20.4,173.1,193.5
2023-03-01 08:00:00+08,1,9,10,146778,1004943,1151721,24.4,209.1,233.5
2023-03-01 12:00:00+08,1,7,8,146778,849622,996400,28.4,163.9,192.3
2023-03-01 16:00:00+08,2,7,9,182223,806129,988352,34.55,174.16,208.71
2023-03-01 20:00:00+08,1,8,9,146778,818876,965654,36.4,165.41,201.81
2023-03-02 00:00:00+08,1,11,12,146778,1043443,1190221,40.4,200.4,240.8
2023-03-02 04:00:00+08,1,12,13,146778,1078888,1225666,54.66,248.3,302.96
2023-03-02 08:00:00+08,1,12,13,146778,1078888,1225666,58.66,296.3,354.96
2023-03-02 12:00:00+08,1,10,11,146778,1021973,1168751,52.4,309.24,361.64
2023-03-02 16:00:00+08,2,8,10,188774,914456,1103230,58.7,310.68,369.38
2023-03-02 20:00:00+08,2,7,9,188774,769182,957956,66.69,291.81,358.5
2023-03-03 00:00:00+08,1,5,6,41996,487880,529876,10.3,183.61,193.91
2023-03-03 04:00:00+08,2,6,8,145769,628218,773987,82.48,124.67,207.15
2023-03-03 08:00:00+08,2,5,7,145769,533503,679272,90.46,79.87,170.33
2023-03-03 12:00:00+08,2,5,7,145769,462446,608215,98.46,30.93,129.39
2023-03-03 16:00:00+08,1,5,6,103773,462446,566219,80.17,50.93,131.1
2023-03-03 20:00:00+08,1,8,9,103773,714507,818280,113.72,57.14,170.86
2023-03-04 00:00:00+08,1,7,8,103773,583410,687183,117.74,68.7,186.44
2023-03-04 04:00:00+08,2,7,9,189583,583410,772993,122.34,96.7,219.04
2023-03-04 08:00:00+08,1,8,9,103773,713114,816887,99.68,115.11,214.79
2023-03-04 12:00:00+08,1,7,8,103773,706230,810003,103.68,122.31,225.99
2023-03-04 16:00:00+08,1,6,7,103773,621447,725220,107.72,130.09,237.81
2023-03-04 20:00:00+08,1,8,9,103773,734445,838218,111.71,155.85,267.56
2023-03-05 00:00:00+08,0,7,7,0,648635,648635,67.7,170.77,238.47
2023-03-05 04:00:00+08,0,5,5,0,363997,363997,0,73.74,73.74
2023-03-05 08:00:00+08,0,6,6,0,595806,595806,49.41,84.15,133.56
2023-03-05 12:00:00+08,0,5,5,0,509916,509916,49.41,78.09,127.5
2023-03-05 16:00:00+08,0,5,5,0,509916,509916,49.41,98.09,147.5
2023-03-05 20:00:00+08,0,4,4,0,363125,363125,49.41,69.27,118.68
2023-03-06 00:00:00+08,1,3,4,105035,259352,364387,0.75,66.19,66.94
2023-03-06 04:00:00+08,0,3,3,0,304904,304904,3.54,57.45,60.99
2023-03-06 08:00:00+08,0,3,3,0,304904,304904,3.54,69.45,72.99
2023-03-06 12:00:00+08,0,2,2,0,199742,199742,3.52,49.6,53.12
2023-03-06 16:00:00+08,0,2,2,0,199742,199742,3.52,57.6,61.12
2023-03-06 20:00:00+08,0,5,5,0,373316,373316,3.51,68.35,71.86
2023-03-07 00:00:00+08,0,7,7,0,527582,527582,3.52,96.12,99.64
2023-03-07 04:00:00+08,0,7,7,0,563448,563448,3.52,68.08,71.6
2023-03-07 08:00:00+08,0,8,8,0,588686,588686,3.52,97.29,100.81
2023-03-07 12:00:00+08,0,6,6,0,476511,476511,0,51.56,51.56
2023-03-07 16:00:00+08,0,5,5,0,438629,438629,0,55.67,55.67
2023-03-07 20:00:00+08,1,5,6,44053,402938,446991,0.96,51.36,52.32
2023-03-08 00:00:00+08,1,4,5,44053,377700,421753,4.96,54.16,59.12
2023-03-08 04:00:00+08,1,4,5,44053,417807,461860,8.96,53.65,62.61
2023-03-08 08:00:00+08,1,4,5,44053,417807,461860,12.96,69.65,82.61
2023-03-08 12:00:00+08,1,4,5,44053,417807,461860,16.96,85.65,102.61
2023-03-08 16:00:00+08,0,3,3,0,350637,350637,0,80.99,80.99
2023-03-08 20:00:00+08,0,7,7,0,567640,567640,23.85,98.26,122.11
2023-03-09 00:00:00+08,0,9,9,0,749681,749681,23.86,129.19,153.05
2023-03-09 04:00:00+08,0,10,10,0,835238,835238,23.86,118.7,142.56
2023-03-09 08:00:00+08,0,9,9,0,804901,804901,23.86,145.75,169.61
2023-03-09 12:00:00+08,1,5,6,34289,432485,466774,1.49,61.31,62.8
2023-03-09 16:00:00+08,1,5,6,34289,432485,466774,5.49,81.31,86.8
2023-03-09 20:00:00+08,1,6,7,34289,484541,518830,9.49,101.36,110.85
2023-03-10 00:00:00+08,1,8,9,34289,698502,732791,13.49,125.69,139.18
2023-03-10 04:00:00+08,1,8,9,34289,690707,724996,17.49,129.49,146.98
2023-03-10 08:00:00+08,1,10,11,34289,856929,891218,21.49,164.44,185.93
2023-03-10 12:00:00+08,1,7,8,34289,587735,622024,25.48,92.41,117.89
2023-03-10 16:00:00+08,0,5,5,0,423163,423163,0,63.55,63.55
2023-03-10 20:00:00+08,0,9,9,0,661223,661223,32.98,87.13,120.11
2023-03-11 00:00:00+08,0,10,10,0,668107,668107,32.97,123.33,156.3
2023-03-11 04:00:00+08,0,10,10,0,664567,664567,32.97,135.41,168.38
2023-03-11 08:00:00+08,0,9,9,0,597397,597397,32.97,150.26,183.23
2023-03-11 12:00:00+08,0,9,9,0,615352,615352,32.98,171.05,204.03
2023-03-11 16:00:00+08,0,7,7,0,543949,543949,32.98,169.95,202.93
2023-03-11 20:00:00+08,0,7,7,0,522414,522414,0,159.35,159.35
2023-03-12 00:00:00+08,1,6,7,35031,423362,458393,1.31,145.54,146.85
2023-03-12 04:00:00+08,2,7,9,120744,482130,602874,5.72,172.97,178.69
2023-03-12 08:00:00+08,1,6,7,35031,343339,378370,13.18,126.56,139.74
2023-03-12 12:00:00+08,1,4,5,35031,241597,276628,17.16,69.86,87.02
2023-03-12 16:00:00+08,0,2,2,0,180342,180342,3.84,15.84,19.68
2023-03-12 20:00:00+08,0,3,3,0,215373,215373,23.97,25.03,49
2023-03-13 00:00:00+08,0,4,4,0,316905,316905,23.97,38.09,62.06
2023-03-13 04:00:00+08,0,4,4,0,289993,289993,23.99,35.65,59.64
2023-03-13 08:00:00+08,0,4,4,0,289993,289993,23.99,51.65,75.64
2023-03-13 12:00:00+08,0,4,4,0,289993,289993,23.99,67.65,91.64
2023-03-13 16:00:00+08,0,5,5,0,436500,436500,23.99,87.29,111.28
2023-03-13 20:00:00+08,0,5,5,0,436500,436500,23.99,107.29,131.28
2023-03-14 00:00:00+08,0,3,3,0,267251,267251,23.99,81.38,105.37
2023-03-14 04:00:00+08,0,4,4,0,308841,308841,23.98,96.47,120.45
2023-03-14 08:00:00+08,0,5,5,0,390470,390470,20.12,68.88,89
2023-03-14 12:00:00+08,0,4,4,0,355439,355439,0,47.68,47.68
2023-03-14 16:00:00+08,0,5,5,0,418866,418866,0,67.03,67.03
2023-03-14 20:00:00+08,1,7,8,93398,630684,724082,0.86,90.07,90.93
2023-03-15 00:00:00+08,1,7,8,93398,630684,724082,4.86,118.07,122.93
2023-03-15 04:00:00+08,0,7,7,0,630684,630684,0,146.07,146.07
2023-03-15 08:00:00+08,0,7,7,0,630684,630684,0,174.07,174.07
2023-03-15 12:00:00+08,0,7,7,0,592420,592420,0,174.25,174.25
2023-03-15 16:00:00+08,1,7,8,90388,592420,682808,1.12,202.25,203.37
2023-03-15 20:00:00+08,1,7,8,90388,592420,682808,5.12,230.25,235.37
2023-03-16 00:00:00+08,1,8,9,90388,660585,750973,9.12,259.42,268.54
2023-03-16 04:00:00+08,1,9,10,90388,809808,900196,13.12,241.4,254.52
2023-03-16 08:00:00+08,1,7,8,90388,597990,688378,17.1,202.36,219.46
2023-03-16 12:00:00+08,1,6,7,90388,559796,650184,61.35,170.45,231.8
2023-03-16 16:00:00+08,1,4,5,90388,318915,409303,65.35,60.33,125.68
2023-03-16 20:00:00+08,1,9,10,90388,789482,879870,69.36,88.31,157.67
2023-03-17 00:00:00+08,1,10,11,90388,912441,1002829,73.36,125.65,199.01
2023-03-17 04:00:00+08,1,11,12,90388,1028520,1118908,77.37,167.57,244.94
2023-03-17 08:00:00+08,1,11,12,90388,1028520,1118908,81.37,211.57,292.94
2023-03-17 12:00:00+08,1,8,9,90388,917436,1007824,85.37,154.92,240.29
2023-03-17 16:00:00+08,1,7,8,50813,829830,880643,43.96,164.48,208.44
2023-03-17 20:00:00+08,1,7,8,50813,762412,813225,60.71,145.31,206.02
2023-03-18 00:00:00+08,1,7,8,50813,754186,804999,64.71,144.39,209.1
2023-03-18 04:00:00+08,1,7,8,50813,620617,671430,68.71,126.87,195.58
2023-03-18 08:00:00+08,1,9,10,50813,768098,818911,72.69,157.49,230.18
2023-03-18 12:00:00+08,1,7,8,50813,698014,748827,76.69,169.27,245.96
2023-03-18 16:00:00+08,1,4,5,50813,410681,461494,27.71,107.08,134.79
2023-03-18 20:00:00+08,1,4,5,50813,356272,407085,31.71,73.57,105.28
2023-03-19 00:00:00+08,1,5,6,50813,484832,535645,35.71,91.01,126.72
2023-03-19 04:00:00+08,1,7,8,50813,759756,810569,39.71,115.15,154.86
2023-03-19 08:00:00+08,3,5,8,276769,657016,933785,48.46,103.52,151.98
2023-03-19 12:00:00+08,3,5,8,276769,657016,933785,60.46,123.52,183.98
2023-03-19 16:00:00+08,4,5,9,304973,585077,890050,23.97,79.22,103.19
2023-03-19 20:00:00+08,4,6,10,304973,585587,890560,94.13,65.99,160.12
2023-03-20 00:00:00+08,4,5,9,304973,457027,762000,110.13,64.55,174.68
2023-03-20 04:00:00+08,4,6,10,304973,551627,856600,126.13,85.63,211.76
2023-03-20 08:00:00+08,4,6,10,304973,551627,856600,142.13,109.63,251.76
2023-03-20 12:00:00+08,3,5,8,219163,525974,745137,127.83,80.69,208.52
2023-03-20 16:00:00+08,1,5,6,140146,472515,612661,88.61,79.68,168.29
2023-03-20 20:00:00+08,1,11,12,140146,874934,1015080,129.24,87.33,216.57
2023-03-21 00:00:00+08,1,12,13,140146,971914,1112060,133.24,134.59,267.83
2023-03-21 04:00:00+08,1,12,13,140146,971914,1112060,137.24,182.59,319.83
2023-03-21 08:00:00+08,1,12,13,140146,971914,1112060,141.24,230.59,371.83
2023-03-21 12:00:00+08,1,11,12,140146,945043,1085189,116.89,261.21,378.1
2023-03-21 16:00:00+08,0,7,7,0,626199,626199,0,173.3,173.3
2023-03-21 20:00:00+08,0,9,9,0,928424,928424,0,183.15,183.15
2023-03-22 00:00:00+08,0,11,11,0,1112537,1112537,63.21,153.32,216.53
2023-03-22 04:00:00+08,0,9,9,0,893292,893292,63.21,128.86,192.07
2023-03-22 08:00:00+08,0,9,9,0,912249,912249,63.21,121.66,184.87
2023-03-22 12:00:00+08,0,8,8,0,831240,831240,63.2,108.76,171.96
2023-03-22 16:00:00+08,0,8,8,0,831240,831240,63.2,140.76,203.96
2023-03-22 20:00:00+08,0,11,11,0,1017704,1017704,63.2,179.39,242.59
2023-03-23 00:00:00+08,0,9,9,0,899311,899311,63.2,146.49,209.69
2023-03-23 04:00:00+08,0,7,7,0,667299,667299,63.21,119.86,183.07
2023-03-23 08:00:00+08,0,7,7,0,729856,729856,63.2,136.94,200.14
2023-03-23 12:00:00+08,0,7,7,0,729856,729856,63.2,164.94,228.14
2023-03-23 16:00:00+08,0,7,7,0,729856,729856,63.2,192.94,256.14
2023-03-23 20:00:00+08,0,6,6,0,555416,555416,63.21,156.53,219.74
2023-03-24 00:00:00+08,0,6,6,0,422154,422154,0,129.52,129.52
2023-03-24 04:00:00+08,0,7,7,0,525845,525845,0,155.97,155.97
2023-03-24 08:00:00+08,0,7,7,0,525845,525845,0,183.97,183.97
2023-03-24 12:00:00+08,0,5,5,0,429696,429696,0,144.36,144.36
2023-03-24 16:00:00+08,0,5,5,0,429696,429696,0,164.36,164.36
2023-03-24 20:00:00+08,0,10,10,0,778218,778218,0,192.17,192.17
2023-03-25 00:00:00+08,0,10,10,0,778218,778218,0,232.17,232.17
2023-03-25 04:00:00+08,0,8,8,0,509786,509786,0,160.33,160.33
2023-03-25 08:00:00+08,0,7,7,0,520585,520585,0,166.22,166.22
2023-03-25 12:00:00+08,0,6,6,0,513701,513701,0,158,158
2023-03-25 16:00:00+08,0,2,2,0,171296,171296,0,30.39,30.39
2023-03-25 20:00:00+08,0,5,5,0,476195,476195,0,20.42,20.42
2023-03-26 00:00:00+08,0,6,6,0,526824,526824,0,41.46,41.46
2023-03-26 04:00:00+08,0,5,5,0,418525,418525,0,44.29,44.29
2023-03-26 08:00:00+08,0,5,5,0,418525,418525,0,64.29,64.29
2023-03-26 12:00:00+08,0,4,4,0,356916,356916,0,65.48,65.48
2023-03-26 16:00:00+08,0,4,4,0,356916,356916,0,81.48,81.48
2023-03-26 20:00:00+08,0,6,6,0,482811,482811,0,99.33,99.33
2023-03-27 00:00:00+08,0,7,7,0,595883,595883,0,127.28,127.28
2023-03-27 04:00:00+08,0,7,7,0,606037,606037,0,126.2,126.2
2023-03-27 08:00:00+08,0,7,7,0,665789,665789,0,121.8,121.8
2023-03-27 12:00:00+08,0,5,5,0,552268,552268,0,90,90
2023-03-27 16:00:00+08,0,5,5,0,552268,552268,0,110,110
2023-03-27 20:00:00+08,0,8,8,0,569651,569651,0,115.84,115.84
2023-03-28 00:00:00+08,0,9,9,0,604421,604421,0,95.77,95.77
2023-03-28 04:00:00+08,0,10,10,0,751213,751213,0,132.84,132.84
2023-03-28 08:00:00+08,0,11,11,0,804665,804665,0,176.18,176.18
2023-03-28 12:00:00+08,0,9,9,0,747826,747826,0,182.24,182.24
2023-03-28 16:00:00+08,0,7,7,0,746087,746087,0,130.79,130.79
2023-03-28 20:00:00+08,0,7,7,0,785228,785228,0,141.54,141.54
2023-03-29 00:00:00+08,0,9,9,0,1009212,1009212,0,173.48,173.48
2023-03-29 04:00:00+08,0,9,9,0,1009212,1009212,0,209.48,209.48
2023-03-29 08:00:00+08,0,9,9,0,943527,943527,0,216.23,216.23
2023-03-29 12:00:00+08,0,8,8,0,815748,815748,0,208.47,208.47
2023-03-29 16:00:00+08,0,6,6,0,564758,564758,0,120.3,120.3
2023-03-29 20:00:00+08,0,6,6,0,643884,643884,0,119.9,119.9
2023-03-30 00:00:00+08,0,8,8,0,863677,863677,0,145.36,145.36
2023-03-30 04:00:00+08,0,9,9,0,853782,853782,0,148.21,148.21
2023-03-30 08:00:00+08,0,8,8,0,815900,815900,0,156.88,156.88
2023-03-30 12:00:00+08,0,7,7,0,676540,676540,0,123.61,123.61
2023-03-30 16:00:00+08,0,6,6,0,561197,561197,0,110.57,110.57
2023-03-30 20:00:00+08,0,9,9,0,849865,849865,0,139.84,139.84
2023-03-31 00:00:00+08,0,9,9,0,867607,867607,0,140.64,140.64
2023-03-31 04:00:00+08,0,9,9,0,762057,762057,0,152.23,152.23
2023-03-31 08:00:00+08,0,8,8,0,719955,719955,0,174.43,174.43
2023-03-31 12:00:00+08,0,7,7,0,621106,621106,0,169.9,169.9
2023-03-31 16:00:00+08,0,5,5,0,518525,518525,0,147.46,147.46
2023-03-31 20:00:00+08,0,8,8,0,794206,794206,0,172.95,172.95
2023-04-01 00:00:00+08,0,8,8,0,779624,779624,0,174.95,174.95
2023-04-01 04:00:00+08,1,8,9,57830,779624,837454,1.57,206.95,208.52
2023-04-01 08:00:00+08,1,8,9,57830,815474,873304,5.57,199.57,205.14
2023-04-01 12:00:00+08,1,5,6,57830,453152,510982,9.57,104.87,114.44
2023-04-01 16:00:00+08,1,4,5,57830,332208,390038,13.57,59.92,73.49
2023-04-01 20:00:00+08,0,5,5,0,545619,545619,0,61.95,61.95
2023-04-02 00:00:00+08,0,5,5,0,530467,530467,20.44,64.13,84.57
2023-04-02 04:00:00+08,0,4,4,0,429056,429056,20.44,55.68,76.12
2023-04-02 08:00:00+08,0,4,4,0,429056,429056,20.44,71.68,92.12
2023-04-02 12:00:00+08,0,3,3,0,334391,334391,20.44,46.2,66.64
2023-04-02 16:00:00+08,0,3,3,0,334391,334391,20.44,58.2,78.64
2023-04-02 20:00:00+08,0,3,3,0,334391,334391,20.44,70.2,90.64
2023-04-03 00:00:00+08,0,1,1,0,145527,145527,0,28.17,28.17
2023-04-03 04:00:00+08,0,2,2,0,256160,256160,0,33.25,33.25
2023-04-03 08:00:00+08,0,7,7,0,871648,871648,0,52.52,52.52
2023-04-03 12:00:00+08,0,6,6,0,726121,726121,0,40.36,40.36
2023-04-03 16:00:00+08,1,6,7,108770,726121,834891,0.56,64.36,64.92
2023-04-03 20:00:00+08,1,9,10,108770,915937,1024707,4.55,96.28,100.83
2023-04-04 00:00:00+08,1,10,11,108770,1062151,1170921,8.55,134.92,143.47
2023-04-04 04:00:00+08,2,10,12,274308,1062151,1336459,14.07,174.92,188.99
2023-04-04 08:00:00+08,2,8,10,274308,975096,1249404,22.07,186.48,208.55
2023-04-04 12:00:00+08,2,7,9,274308,864463,1138771,30.06,185.4,215.46
2023-04-04 16:00:00+08,1,6,7,165538,750985,916523,13.52,178.94,192.46
2023-04-04 20:00:00+08,0,10,10,0,894657,894657,27.69,136.4,164.09
2023-04-05 00:00:00+08,0,12,12,0,1191446,1191446,46.58,182.72,229.3
2023-04-05 04:00:00+08,0,13,13,0,1216684,1216684,46.58,233.67,280.25
2023-04-05 08:00:00+08,0,13,13,0,1215391,1215391,46.58,226.95,273.53
2023-04-05 12:00:00+08,0,13,13,0,1243219,1243219,46.55,262.72,309.27
2023-04-05 16:00:00+08,1,12,13,112359,1140458,1252817,47.39,267.18,314.57
2023-04-05 20:00:00+08,0,11,11,0,968147,968147,46.6,231.37,277.97
2023-04-06 00:00:00+08,0,11,11,0,1012265,1012265,54.88,246.03,300.91
2023-04-06 04:00:00+08,0,12,12,0,1061377,1061377,54.88,262.59,317.47
2023-04-06 08:00:00+08,0,11,11,0,915163,915163,54.88,251.94,306.82
2023-04-06 12:00:00+08,0,11,11,0,915163,915163,54.88,295.94,350.82
2023-04-06 16:00:00+08,0,11,11,0,915163,915163,54.88,339.94,394.82
2023-04-06 20:00:00+08,1,11,12,120934,915163,1036097,56.23,383.94,440.17
2023-04-07 00:00:00+08,1,4,5,120934,434386,555320,32.53,173.74,206.27
2023-04-07 04:00:00+08,1,5,6,120934,415707,536641,17.67,84.45,102.12
2023-04-07 08:00:00+08,1,11,12,120934,931723,1052657,21.68,118.16,139.84
2023-04-07 12:00:00+08,1,10,11,120934,819364,940298,17.36,125.68,143.04
2023-04-07 16:00:00+08,0,10,10,0,819364,819364,0,165.68,165.68
2023-04-07 20:00:00+08,1,12,13,114106,1025768,1139874,26.32,144.09,170.41
2023-04-08 00:00:00+08,0,11,11,0,947868,947868,24.58,173.74,198.32
2023-04-08 04:00:00+08,0,12,12,0,1074816,1074816,31.77,201.72,233.49
2023-04-08 08:00:00+08,0,11,11,0,1057731,1057731,31.77,197.37,229.14
2023-04-08 12:00:00+08,0,8,8,0,908848,908848,31.77,181.44,213.21
2023-04-08 16:00:00+08,1,8,9,50532,865743,916275,33.86,190.96,224.82
2023-04-08 20:00:00+08,1,9,10,50532,897116,947648,37.86,137.92,175.78
2023-04-09 00:00:00+08,1,10,11,50532,1028363,1078895,41.85,175.61,217.46
2023-04-09 04:00:00+08,2,10,12,197304,1028363,1225667,46.78,215.61,262.39
2023-04-09 08:00:00+08,3,11,14,300952,1137004,1437956,56.9,257.36,314.26
2023-04-09 12:00:00+08,4,8,12,327763,768432,1096195,72.51,171.19,243.7
2023-04-09 16:00:00+08,4,6,10,327763,533392,861155,56.74,119.87,176.61
2023-04-09 20:00:00+08,4,5,9,327763,482551,810314,72.74,116.85,189.59
2023-04-10 00:00:00+08,4,4,8,327763,321573,649336,88.74,106.27,195.01
2023-04-10 04:00:00+08,4,3,7,327763,279990,607753,104.73,85.86,190.59
2023-04-10 08:00:00+08,4,3,7,327763,279990,607753,120.73,97.86,218.59
2023-04-10 12:00:00+08,4,3,7,327783,279990,607773,103.92,109.86,213.78
2023-04-10 16:00:00+08,3,4,7,349506,331090,680596,39.97,123.02,162.99
2023-04-10 20:00:00+08,4,12,16,455034,966253,1421287,179.48,156.06,335.54
2023-04-11 00:00:00+08,4,12,16,455034,966253,1421287,195.48,204.06,399.54
2023-04-11 04:00:00+08,4,13,17,455034,1131435,1586469,211.5,255.77,467.27
2023-04-11 08:00:00+08,4,13,17,455034,1131435,1586469,227.5,307.77,535.27
2023-04-11 12:00:00+08,4,10,14,455034,854238,1309272,172.14,302.75,474.89
2023-04-11 16:00:00+08,4,9,13,455034,803138,1258172,188.16,317.58,505.74
2023-04-11 20:00:00+08,4,7,11,455034,586788,1041822,204.19,233.46,437.65
2023-04-12 00:00:00+08,3,8,11,355968,683435,1039403,133.79,171.87,305.66
2023-04-12 04:00:00+08,3,9,12,355968,814008,1169976,145.78,207.56,353.34
2023-04-12 08:00:00+08,4,10,14,502559,846586,1349145,196.66,200.58,397.24
2023-04-12 12:00:00+08,4,9,13,502559,806484,1309043,212.66,150.17,362.83
2023-04-12 16:00:00+08,3,7,10,398911,653525,1052436,146.6,149.23,295.83
2023-04-12 20:00:00+08,2,6,8,293383,535040,828423,192.43,72.58,265.01
2023-04-13 00:00:00+08,2,8,10,293383,708940,1002323,253.02,101.7,354.72
2023-04-13 04:00:00+08,2,7,9,293383,606079,899462,261.02,104.99,366.01
2023-04-13 08:00:00+08,2,7,9,293383,694878,988261,274.22,109.69,383.91
2023-04-13 12:00:00+08,1,7,8,146792,694878,841670,253.32,137.69,391.01
2023-04-13 16:00:00+08,1,6,7,78231,646166,724397,216.17,104.53,320.7
2023-04-13 20:00:00+08,2,9,11,128928,907596,1036524,223.59,134.99,358.58
2023-04-14 00:00:00+08,2,11,13,128928,1199948,1328876,313.38,173.61,486.99
2023-04-14 04:00:00+08,2,11,13,128928,1101304,1230232,268.78,188.75,457.53
2023-04-14 08:00:00+08,2,12,14,128928,1186984,1315912,276.81,235.6,512.41
2023-04-14 12:00:00+08,3,11,14,210099,1087918,1298017,248.3,227.87,476.17
2023-04-14 16:00:00+08,2,10,12,159402,1025931,1185333,236.88,249.94,486.82
2023-04-14 20:00:00+08,2,11,13,159402,1035974,1195376,184.8,246.19,430.99
2023-04-15 00:00:00+08,2,10,12,159402,945531,1104933,192.79,260.48,453.27
2023-04-15 04:00:00+08,2,9,11,159402,836531,995933,200.8,265.67,466.47
2023-04-15 08:00:00+08,2,8,10,159402,773537,932939,208.78,286.82,495.6
2023-04-15 12:00:00+08,3,6,9,226920,680973,907893,217.12,253.82,470.94
2023-04-15 16:00:00+08,2,3,5,145749,344080,489829,194.43,112.94,307.37
2023-04-15 20:00:00+08,1,7,8,67518,689892,757410,154.44,107.13,261.57
2023-04-16 00:00:00+08,1,7,8,67518,601270,668788,44.26,31.16,75.42
2023-04-16 04:00:00+08,1,8,9,67518,679501,747019,108.16,61.85,170.01
2023-04-16 08:00:00+08,1,8,9,67518,734485,802003,112.16,81.47,193.63
2023-04-16 12:00:00+08,1,6,7,67518,627278,694796,84.24,78.15,162.39
2023-04-16 16:00:00+08,1,6,7,67518,627278,694796,88.24,102.15,190.39
2023-04-16 20:00:00+08,3,6,9,278554,627278,905832,96.22,126.15,222.37
2023-04-17 00:00:00+08,1,6,7,123418,627278,750696,65.61,150.15,215.76
2023-04-17 04:00:00+08,0,6,6,0,585569,585569,48.74,88.74,137.48
2023-04-17 08:00:00+08,0,9,9,0,933514,933514,58.59,120.44,179.03
2023-04-17 12:00:00+08,0,9,9,0,933514,933514,58.59,156.44,215.03
2023-04-17 16:00:00+08,0,9,9,0,933514,933514,58.59,192.44,251.03
2023-04-17 20:00:00+08,0,8,8,0,839140,839140,58.62,183.86,242.48
2023-04-18 00:00:00+08,0,9,9,0,733398,733398,49.23,163.98,213.21
2023-04-18 04:00:00+08,0,9,9,0,769990,769990,9.88,123.61,133.49
2023-04-18 08:00:00+08,0,10,10,0,873881,873881,9.85,163.31,173.16
2023-04-18 12:00:00+08,0,10,10,0,927078,927078,9.85,170.62,180.47
2023-04-18 16:00:00+08,0,9,9,0,862548,862548,9.88,157.18,167.06
2023-04-18 20:00:00+08,0,9,9,0,875875,875875,9.88,171.64,181.52
2023-04-19 00:00:00+08,0,11,11,0,1012347,1012347,9.88,208.9,218.78
2023-04-19 04:00:00+08,1,10,11,153708,923972,1077680,2.72,179.76,182.48
2023-04-19 08:00:00+08,1,9,10,153708,792309,946017,6.72,130.7,137.42
2023-04-19 12:00:00+08,1,8,9,153708,762074,915782,10.72,149.05,159.77
2023-04-19 16:00:00+08,0,6,6,0,589847,589847,0,82.69,82.69
2023-04-19 20:00:00+08,0,7,7,0,738677,738677,0,95.75,95.75
2023-04-20 00:00:00+08,0,8,8,0,892385,892385,18.75,127.72,146.47
2023-04-20 04:00:00+08,0,8,8,0,892385,892385,18.75,159.72,178.47
2023-04-20 08:00:00+08,0,10,10,0,1039372,1039372,18.75,196.19,214.94
2023-04-20 12:00:00+08,0,9,9,0,1010735,1010735,18.75,171.33,190.08
2023-04-20 16:00:00+08,0,7,7,0,909343,909343,18.75,176.24,194.99
2023-04-20 20:00:00+08,0,10,10,0,1046376,1046376,18.75,209.41,228.16
2023-04-21 00:00:00+08,0,10,10,0,1046376,1046376,18.75,249.41,268.16
2023-04-21 04:00:00+08,1,11,12,112516,1098090,1210606,19.52,277.28,296.8
2023-04-21 08:00:00+08,1,11,12,112516,931091,1043607,23.51,216.03,239.54
2023-04-21 12:00:00+08,1,6,7,112516,533083,645599,27.48,105.47,132.95
2023-04-21 16:00:00+08,1,6,7,112516,533083,645599,31.48,129.47,160.95
2023-04-21 20:00:00+08,1,9,10,112516,775766,888282,35.48,159.43,194.91
2023-04-22 00:00:00+08,1,8,9,112516,622058,734574,20.75,143.46,164.21
2023-04-22 04:00:00+08,1,8,9,112516,622058,734574,24.75,175.46,200.21
2023-04-22 08:00:00+08,2,7,9,183911,643619,827530,29.48,149,178.48
2023-04-22 12:00:00+08,2,8,10,183911,721565,905476,37.48,180.44,217.92
2023-04-22 16:00:00+08,3,6,9,204257,520026,724283,47.75,131.62,179.37
2023-04-22 20:00:00+08,2,7,9,91741,674726,766467,19,157.77,176.77
2023-04-23 00:00:00+08,2,7,9,91741,674726,766467,27,185.77,212.77
2023-04-23 04:00:00+08,2,8,10,91741,787242,878983,79.94,217.58,297.52
2023-04-23 08:00:00+08,1,6,7,20346,613177,633523,63.23,187.5,250.73
2023-04-23 12:00:00+08,1,6,7,20346,605145,625491,95.23,129.99,225.22
2023-04-23 16:00:00+08,1,6,7,20346,605145,625491,99.23,153.99,253.22
2023-04-23 20:00:00+08,1,10,11,20346,938535,958881,103.19,185.45,288.64
2023-04-24 00:00:00+08,1,10,11,20346,924063,944409,107.19,211.53,318.72
2023-04-24 04:00:00+08,1,9,10,20346,811547,831893,66.27,223.7,289.97
2023-04-24 08:00:00+08,1,11,12,20346,948466,968812,70.24,205.07,275.31
2023-04-24 12:00:00+08,1,11,12,20346,948466,968812,74.24,249.07,323.31
2023-04-24 16:00:00+08,1,10,11,20346,898031,918377,78.27,271.55,349.82
2023-04-24 20:00:00+08,1,10,11,20346,898031,918377,82.27,311.55,393.82
2023-04-25 00:00:00+08,1,8,9,20346,813779,834125,86.27,304.13,390.4
2023-04-25 04:00:00+08,1,5,6,20346,589639,609985,62.27,177.35,239.62
2023-04-25 08:00:00+08,1,8,9,20346,749607,769953,66.27,174.24,240.51
2023-04-25 12:00:00+08,1,5,6,20346,417529,437875,70.27,92.1,162.37
2023-04-25 16:00:00+08,1,5,6,20346,417529,437875,74.27,112.1,186.37
2023-04-25 20:00:00+08,1,10,11,20346,914423,934769,78.27,140.51,218.78
2023-04-26 00:00:00+08,1,8,9,20346,724657,745003,82.27,84.31,166.58
2023-04-26 04:00:00+08,1,8,9,20346,724657,745003,86.27,116.31,202.58
2023-04-26 08:00:00+08,1,9,10,20346,809927,830273,90.28,100.66,190.94
2023-04-26 12:00:00+08,1,9,10,20346,809927,830273,94.28,136.66,230.94
2023-04-26 16:00:00+08,1,8,9,20346,769449,789795,98.28,150.57,248.85
2023-04-26 20:00:00+08,1,8,9,20346,745614,765960,102.26,121.53,223.79
2023-04-27 00:00:00+08,1,11,12,20346,1178565,1198911,106.26,160.88,267.14
2023-04-27 04:00:00+08,1,11,12,20346,1178565,1198911,110.26,204.88,315.14
2023-04-27 08:00:00+08,1,10,11,20346,1143861,1164207,114.28,223.3,337.58
2023-04-27 12:00:00+08,1,9,10,20346,986785,1007131,118.28,221.93,340.21
2023-04-27 16:00:00+08,0,6,6,0,788014,788014,0,156.48,156.48
2023-04-27 20:00:00+08,0,8,8,0,780437,780437,124.58,137.73,262.31
2023-04-28 00:00:00+08,0,10,10,0,891921,891921,124.59,170.26,294.85
2023-04-28 04:00:00+08,0,11,11,0,926004,926004,124.6,213.04,337.64
2023-04-28 08:00:00+08,0,9,9,0,810997,810997,0,204.99,204.99
2023-04-28 12:00:00+08,0,7,7,0,725031,725031,0,204.02,204.02
2023-04-28 16:00:00+08,0,8,8,0,792301,792301,0,233.01,233.01
2023-04-28 20:00:00+08,0,10,10,0,929869,929869,0,270.48,270.48
2023-04-29 00:00:00+08,0,8,8,0,729557,729557,0,171.53,171.53
2023-04-29 04:00:00+08,0,9,9,0,742990,742990,0,153.61,153.61
2023-04-29 08:00:00+08,0,7,7,0,639174,639174,0,87.4,87.4
2023-04-29 12:00:00+08,0,6,6,0,534574,534574,0,78.95,78.95
2023-04-29 16:00:00+08,0,5,5,0,449869,449869,0,80.11,80.11
2023-04-29 20:00:00+08,0,4,4,0,441076,441076,0,55.11,55.11
2023-04-30 00:00:00+08,0,4,4,0,441076,441076,0,71.11,71.11
2023-04-30 04:00:00+08,0,6,6,0,729134,729134,0,93.75,93.75
2023-04-30 08:00:00+08,0,7,7,0,841650,841650,0,118.79,118.79
2023-04-30 12:00:00+08,0,8,8,0,899850,899850,0,150.44,150.44
2023-04-30 16:00:00+08,1,8,9,51733,899850,951583,1.33,182.44,183.77
2023-04-30 20:00:00+08,1,8,9,51733,899850,951583,5.33,214.44,219.77
2023-05-01 00:00:00+08,0,5,5,0,618968,618968,0,110.11,110.11
2023-05-01 04:00:00+08,0,9,9,0,893449,893449,10.84,137.84,148.68
2023-05-01 08:00:00+08,0,10,10,0,1002470,1002470,10.84,175.98,186.82
2023-05-01 12:00:00+08,0,10,10,0,1002470,1002470,10.84,215.98,226.82
2023-05-01 16:00:00+08,0,10,10,0,1002470,1002470,10.84,255.98,266.82
2023-05-01 20:00:00+08,0,9,9,0,913950,913950,0,243.87,243.87
2023-05-02 00:00:00+08,0,10,10,0,948718,948718,0,282.98,282.98
2023-05-02 04:00:00+08,1,8,9,108730,696867,805597,1.36,226.91,228.27
2023-05-02 08:00:00+08,1,8,9,108730,636286,745016,5.36,231.59,236.95
2023-05-02 12:00:00+08,2,8,10,217500,708174,925674,13.02,231.59,244.61
2023-05-02 16:00:00+08,1,5,6,108730,558441,667171,13.35,184.67,198.02
2023-05-02 20:00:00+08,2,9,11,193513,972122,1165635,28.82,199.89,228.71
2023-05-03 00:00:00+08,2,10,12,193513,1066787,1260300,36.86,236.94,273.8
2023-05-03 04:00:00+08,2,9,11,193513,957766,1151279,44.84,230.79,275.63
2023-05-03 08:00:00+08,2,10,12,193513,991928,1185441,52.84,269.59,322.43
2023-05-03 12:00:00+08,2,11,13,193513,1130539,1324052,60.84,312.52,373.36
2023-05-03 16:00:00+08,2,10,12,193513,1021769,1215282,58.97,334.73,393.7
2023-05-03 20:00:00+08,2,8,10,193513,785862,979375,66.97,224.84,291.81
2023-05-04 00:00:00+08,2,7,9,193513,718692,912205,74.97,226.94,301.91
2023-05-04 04:00:00+08,1,9,10,108730,936014,1044744,49.36,259.25,308.61
2023-05-04 08:00:00+08,1,10,11,108730,1127964,1236694,88.21,286.11,374.32
2023-05-04 12:00:00+08,1,7,8,108730,843158,951888,92.22,216.7,308.92
2023-05-04 16:00:00+08,1,7,8,146696,883273,1029969,34.84,192.12,226.96
2023-05-04 20:00:00+08,1,8,9,146696,953041,1099737,101.02,206.08,307.1
2023-05-05 00:00:00+08,1,10,11,146696,978216,1124912,105.02,239.83,344.85
2023-05-05 04:00:00+08,1,10,11,146696,978216,1124912,109.02,279.83,388.85
2023-05-05 08:00:00+08,1,8,9,146696,859133,1005829,78.17,279.39,357.56
2023-05-05 12:00:00+08,1,8,9,146696,859133,1005829,82.17,311.39,393.56
2023-05-05 16:00:00+08,1,8,9,146696,859133,1005829,86.17,343.39,429.56
2023-05-05 20:00:00+08,1,10,11,146696,859342,1006038,27.99,319.45,347.44
2023-05-06 00:00:00+08,0,10,10,0,771263,771263,0,297.31,297.31
2023-05-06 04:00:00+08,0,10,10,0,884330,884330,0,311.22,311.22
2023-05-06 08:00:00+08,0,9,9,0,1007510,1007510,37.32,294.54,331.86
2023-05-06 12:00:00+08,0,8,8,0,945523,945523,37.32,313.09,350.41
2023-05-06 16:00:00+08,0,7,7,0,860748,860748,37.32,322.81,360.13
2023-05-06 20:00:00+08,0,6,6,0,707155,707155,37.32,297.41,334.73
2023-05-07 00:00:00+08,0,9,9,0,953604,953604,37.32,255.06,292.38
2023-05-07 04:00:00+08,0,8,8,0,903072,903072,37.32,262.29,299.61
2023-05-07 08:00:00+08,0,9,9,0,933303,933303,37.32,297.7,335.02
2023-05-07 12:00:00+08,0,7,7,0,754257,754257,0,290.3,290.3
2023-05-07 16:00:00+08,0,6,6,0,668471,668471,0,284.82,284.82
2023-05-07 20:00:00+08,0,11,11,0,1189787,1189787,0,318.83,318.83
2023-05-08 00:00:00+08,0,11,11,0,1189787,1189787,0,362.83,362.83
2023-05-08 04:00:00+08,0,11,11,0,1189787,1189787,0,406.83,406.83
2023-05-08 08:00:00+08,0,10,10,0,1131280,1131280,0,390.88,390.88
2023-05-08 12:00:00+08,0,7,7,0,827990,827990,0,358.63,358.63
2023-05-08 16:00:00+08,0,5,5,0,637009,637009,0,301.44,301.44
2023-05-08 20:00:00+08,0,8,8,0,832025,832025,0,256.93,256.93
2023-05-09 00:00:00+08,0,10,10,0,1031886,1031886,0,290.26,290.26
2023-05-09 04:00:00+08,0,10,10,0,1031886,1031886,0,330.26,330.26
2023-05-09 08:00:00+08,0,11,11,0,1081849,1081849,0,373.14,373.14
2023-05-09 12:00:00+08,0,10,10,0,1091880,1091880,0,370.77,370.77
2023-05-09 16:00:00+08,0,9,9,0,1020624,1020624,0,390.51,390.51
2023-05-09 20:00:00+08,0,11,11,0,1160387,1160387,0,408.05,408.05
2023-05-10 00:00:00+08,0,11,11,0,1160387,1160387,0,452.05,452.05
2023-05-10 04:00:00+08,0,11,11,0,1160387,1160387,0,496.05,496.05
2023-05-10 08:00:00+08,0,10,10,0,1011122,1011122,0,464.44,464.44
2023-05-10 12:00:00+08,0,9,9,0,961159,961159,0,473.55,473.55
2023-05-10 16:00:00+08,0,8,8,0,794080,794080,0,441.63,441.63
2023-05-10 20:00:00+08,0,8,8,0,679625,679625,0,370.16,370.16
2023-05-11 00:00:00+08,0,10,10,0,950391,950391,0,407.25,407.25
2023-05-11 04:00:00+08,0,10,10,0,950391,950391,0,447.25,447.25
2023-05-11 08:00:00+08,0,7,7,0,754350,754350,0,385.43,385.43
2023-05-11 12:00:00+08,0,5,5,0,574353,574353,0,343.59,343.59
2023-05-11 16:00:00+08,0,5,5,0,574353,574353,0,363.59,363.59
2023-05-11 20:00:00+08,0,5,5,0,587245,587245,0,356.45,356.45
2023-05-12 00:00:00+08,0,7,7,0,644904,644904,0,377.97,377.97
2023-05-12 04:00:00+08,0,8,8,0,680349,680349,0,409.32,409.32
2023-05-12 08:00:00+08,0,8,8,0,680349,680349,0,441.32,441.32
2023-05-12 12:00:00+08,0,6,6,0,527732,527732,0,424.29,424.29
2023-05-12 16:00:00+08,0,8,8,0,774839,774839,0,430.52,430.52
2023-05-12 20:00:00+08,0,9,9,0,872235,872235,0,446,446
2023-05-13 00:00:00+08,1,10,11,116100,1018826,1134926,2.2,483.57,485.77
2023-05-13 04:00:00+08,1,9,10,116100,865232,981332,6.2,468.17,474.37
2023-05-13 08:00:00+08,1,10,11,116100,1119376,1235476,10.21,478.37,488.58
2023-05-13 12:00:00+08,1,8,9,116100,940276,1056376,14.19,434.31,448.5
2023-05-13 16:00:00+08,0,6,6,0,776102,776102,0,418.84,418.84
2023-05-13 20:00:00+08,0,9,9,0,1139731,1139731,18.2,451.8,470
2023-05-14 00:00:00+08,0,9,9,0,1139731,1139731,18.2,487.8,506
2023-05-14 04:00:00+08,0,7,7,0,919971,919971,18.2,448.76,466.96
2023-05-14 08:00:00+08,0,8,8,0,1005861,1005861,18.2,479.76,497.96
2023-05-14 12:00:00+08,0,8,8,0,1005861,1005861,18.2,511.76,529.96
2023-05-14 16:00:00+08,0,6,6,0,766784,766784,18.2,486,504.2
2023-05-14 20:00:00+08,0,9,9,0,1074917,1074917,18.2,514.51,532.71
2023-05-15 00:00:00+08,0,8,8,0,971666,971666,18.2,489.16,507.36
2023-05-15 04:00:00+08,0,8,8,0,971666,971666,18.2,521.16,539.36
2023-05-15 08:00:00+08,0,8,8,0,971666,971666,18.2,553.16,571.36
2023-05-15 12:00:00+08,1,7,8,80229,855566,935795,0.97,541.16,542.13
2023-05-15 16:00:00+08,1,7,8,80229,855566,935795,4.97,569.16,574.13
2023-05-15 20:00:00+08,1,10,11,80229,882517,962746,8.97,534.48,543.45
2023-05-16 00:00:00+08,2,9,11,184223,772782,957005,13.72,545.21,558.93
2023-05-16 04:00:00+08,2,9,11,184223,742875,927098,21.72,525.09,546.81
2023-05-16 08:00:00+08,2,11,13,184223,982122,1166345,29.72,552.36,582.08
2023-05-16 12:00:00+08,3,8,11,210873,795786,1006659,39.52,520.46,559.98
2023-05-16 16:00:00+08,1,6,7,26650,627090,653740,5.82,484.63,490.45
2023-05-16 20:00:00+08,1,9,10,26650,904576,931226,60.26,489.79,550.05
2023-05-17 00:00:00+08,1,8,9,26650,791364,818014,64.24,477.3,541.54
2023-05-17 04:00:00+08,1,9,10,26650,918440,945090,68.24,510.01,578.25
2023-05-17 08:00:00+08,1,9,10,26650,918440,945090,72.24,546.01,618.25
2023-05-17 12:00:00+08,0,9,9,0,918440,918440,50.4,582.01,632.41
2023-05-17 16:00:00+08,0,8,8,0,750280,750280,78.93,558.11,637.04
2023-05-17 20:00:00+08,0,9,9,0,634349,634349,78.95,555.79,634.74
2023-05-18 00:00:00+08,0,8,8,0,584386,584386,78.95,562.76,641.71
2023-05-18 04:00:00+08,0,6,6,0,467167,467167,47.39,551.11,598.5
2023-05-18 08:00:00+08,0,6,6,0,544084,544084,18.82,559.7,578.52
2023-05-18 12:00:00+08,0,6,6,0,544084,544084,18.82,583.7,602.52
2023-05-18 16:00:00+08,0,5,5,0,567872,567872,0,517.84,517.84
2023-05-18 20:00:00+08,0,8,8,0,649301,649301,0,506.25,506.25
2023-05-19 00:00:00+08,0,9,9,0,770531,770531,0,512.82,512.82
2023-05-19 04:00:00+08,0,10,10,0,871211,871211,0,551.48,551.48
2023-05-19 08:00:00+08,0,10,10,0,925376,925376,0,580.46,580.46
2023-05-19 12:00:00+08,0,9,9,0,873705,873705,0,601.33,601.33
2023-05-19 16:00:00+08,0,7,7,0,701539,701539,0,581.58,581.58
2023-05-19 20:00:00+08,0,10,10,0,922777,922777,0,591.42,591.42
2023-05-20 00:00:00+08,0,12,12,0,1156486,1156486,0,634.27,634.27
2023-05-20 04:00:00+08,1,12,13,41583,1156486,1198069,1.4,682.27,683.67
2023-05-20 08:00:00+08,0,10,10,0,1042466,1042466,0,658.43,658.43
2023-05-20 12:00:00+08,0,9,9,0,872126,872126,6.16,192.18,198.34
2023-05-20 16:00:00+08,1,6,7,50525,566955,617480,6.66,117.91,124.57
2023-05-20 20:00:00+08,1,5,6,50525,509125,559650,10.66,115.47,126.13
2023-05-21 00:00:00+08,2,4,6,159166,445828,604994,11.73,103.37,115.1
2023-05-21 04:00:00+08,2,6,8,159166,609340,768506,19.71,123.76,143.47
2023-05-21 08:00:00+08,2,6,8,159166,609340,768506,27.71,147.76,175.47
2023-05-21 12:00:00+08,2,4,6,159166,397221,556387,35.7,95.24,130.94
2023-05-21 16:00:00+08,1,2,3,108641,244497,353138,19.21,54.53,73.74
2023-05-21 20:00:00+08,1,6,7,108641,663379,772020,49.97,69.66,119.63
2023-05-22 00:00:00+08,1,8,9,108641,906989,1015630,53.97,97.06,151.03
2023-05-22 04:00:00+08,1,8,9,108641,906989,1015630,57.97,129.06,187.03
2023-05-22 08:00:00+08,1,7,8,108641,809188,917829,61.97,75.79,137.76
2023-05-22 12:00:00+08,1,7,8,108641,809188,917829,65.97,103.79,169.76
2023-05-22 16:00:00+08,1,5,6,108641,649663,758304,43.22,88.37,131.59
2023-05-22 20:00:00+08,1,7,8,108641,695648,804289,47.22,94.85,142.07
2023-05-23 00:00:00+08,1,9,10,108641,784778,893419,51.22,127.38,178.6
2023-05-23 04:00:00+08,1,9,10,108641,784778,893419,55.22,163.38,218.6
2023-05-23 08:00:00+08,1,10,11,108641,938183,1046824,59.2,166.84,226.04
2023-05-23 12:00:00+08,1,8,9,108641,890226,998867,63.2,169.27,232.47
2023-05-23 16:00:00+08,2,8,10,159270,890226,1049496,67.51,201.3,268.81
2023-05-23 20:00:00+08,2,8,10,159270,832672,991942,75.5,176.7,252.2
2023-05-24 00:00:00+08,2,6,8,159270,633704,792974,83.5,133.48,216.98
2023-05-24 04:00:00+08,2,6,8,159270,633704,792974,91.5,157.48,248.98
2023-05-24 08:00:00+08,2,7,9,159270,619427,778697,99.51,150.99,250.5
2023-05-24 12:00:00+08,2,5,7,159270,450065,609335,107.51,128.84,236.35
2023-05-24 16:00:00+08,2,5,7,159270,450065,609335,115.51,148.84,264.35
2023-05-24 20:00:00+08,2,11,13,159270,904787,1064057,123.5,180.73,304.23
2023-05-25 00:00:00+08,2,7,9,159270,515361,674631,131.51,55.75,187.26
2023-05-25 04:00:00+08,2,7,9,159270,548857,708127,139.5,75.78,215.28
2023-05-25 08:00:00+08,1,7,8,50629,562295,612924,40.3,64.4,104.7
2023-05-25 12:00:00+08,1,8,9,50629,640195,690824,44.3,95.97,140.27
2023-05-25 16:00:00+08,1,8,9,50629,667242,717871,159.9,110.2,270.1
2023-05-25 20:00:00+08,1,10,11,50629,947293,997922,163.94,133.87,297.81
2023-05-26 00:00:00+08,1,10,11,50629,1036090,1086719,167.95,144.97,312.92
2023-05-26 04:00:00+08,1,9,10,50629,941490,992119,171.94,149.95,321.89
2023-05-26 08:00:00+08,1,8,9,50629,873588,924217,175.94,148.31,324.25
2023-05-26 12:00:00+08,1,5,6,50629,632040,682669,179.92,101.02,280.94
2023-05-26 16:00:00+08,0,5,5,0,632040,632040,111.63,121.02,232.65
2023-05-26 20:00:00+08,0,8,8,0,893295,893295,185.63,147.13,332.76
2023-05-27 00:00:00+08,0,9,9,0,1034753,1034753,185.63,181.07,366.7
2023-05-27 04:00:00+08,0,9,9,0,1034753,1034753,185.63,217.07,402.7
2023-05-27 08:00:00+08,0,10,10,0,963624,963624,185.62,174.01,359.63
2023-05-27 12:00:00+08,0,10,10,0,963624,963624,185.62,214.01,399.63
2023-05-27 16:00:00+08,0,6,6,0,563609,563609,0,113.32,113.32
2023-05-27 20:00:00+08,0,9,9,0,779336,779336,0,118.21,118.21
2023-05-28 00:00:00+08,1,9,10,26811,855060,881871,3.93,138.23,142.16
2023-05-28 04:00:00+08,1,7,8,26811,725217,752028,7.93,99.14,107.07
2023-05-28 08:00:00+08,1,8,9,26811,748174,774985,11.94,107.56,119.5
2023-05-28 12:00:00+08,1,7,8,26811,685180,711991,15.94,121.7,137.64
2023-05-28 16:00:00+08,0,8,8,0,724538,724538,0,150.89,150.89
2023-05-28 20:00:00+08,0,9,9,0,824870,824870,20.67,173.57,194.24
2023-05-29 00:00:00+08,0,9,9,0,824870,824870,20.67,209.57,230.24
2023-05-29 04:00:00+08,0,8,8,0,786988,786988,20.66,223.12,243.78
2023-05-29 08:00:00+08,0,6,6,0,656529,656529,0,202.43,202.43
2023-05-29 12:00:00+08,0,4,4,0,409543,409543,0,125.66,125.66
2023-05-29 16:00:00+08,0,5,5,0,489813,489813,0,144.5,144.5
2023-05-29 20:00:00+08,0,7,7,0,603878,603878,0,66.06,66.06
2023-05-30 00:00:00+08,0,8,8,0,696402,696402,0,62.49,62.49
2023-05-30 04:00:00+08,0,8,8,0,696402,696402,0,94.49,94.49
2023-05-30 08:00:00+08,0,9,9,0,856596,856596,0,128.72,128.72
2023-05-30 12:00:00+08,0,7,7,0,727148,727148,0,106.23,106.23
2023-05-30 16:00:00+08,0,5,5,0,597419,597419,0,96.6,96.6
2023-05-30 20:00:00+08,0,8,8,0,841645,841645,0,122.72,122.72
2023-05-31 00:00:00+08,0,8,8,0,905518,905518,0,120.01,120.01
2023-05-31 04:00:00+08,0,9,9,0,972551,972551,0,154.94,154.94
2023-05-31 08:00:00+08,0,8,8,0,796816,796816,0,122.55,122.55
2023-05-31 12:00:00+08,0,7,7,0,711981,711981,0,136.8,136.8
2023-05-31 16:00:00+08,0,6,6,0,647251,647251,0,141.84,141.84
2023-05-31 20:00:00+08,0,7,7,0,673271,673271,0,168.03,168.03
2023-06-01 00:00:00+08,0,9,9,0,790094,790094,0,156.87,156.87
2023-06-01 04:00:00+08,0,7,7,0,548527,548527,0,101.93,101.93
2023-06-01 08:00:00+08,0,8,8,0,634207,634207,0,133.06,133.06
2023-06-01 12:00:00+08,0,6,6,0,557791,557791,0,122.26,122.26
2023-06-01 16:00:00+08,0,5,5,0,531771,531771,0,124.06,124.06
2023-06-01 20:00:00+08,0,8,8,0,759089,759089,0,149.81,149.81
2023-06-02 00:00:00+08,0,9,9,0,765973,765973,0,182.67,182.67
2023-06-02 04:00:00+08,0,10,10,0,899866,899866,0,196.95,196.95
2023-06-02 08:00:00+08,0,10,10,0,899866,899866,0,236.95,236.95
2023-06-02 12:00:00+08,0,9,9,0,832833,832833,0,218.03,218.03
2023-06-02 16:00:00+08,0,6,6,0,545862,545862,0,149.79,149.79
2023-06-02 20:00:00+08,0,10,10,0,811205,811205,0,116.78,116.78
2023-06-03 00:00:00+08,0,11,11,0,904757,904757,0,157.61,157.61
2023-06-03 04:00:00+08,0,11,11,0,1051393,1051393,0,174.85,174.85
2023-06-03 08:00:00+08,0,10,10,0,1021206,1021206,0,204.41,204.41
2023-06-03 12:00:00+08,0,7,7,0,792008,792008,0,173.97,173.97
2023-06-03 16:00:00+08,0,5,5,0,557483,557483,0,139.1,139.1
2023-06-03 20:00:00+08,0,6,6,0,638654,638654,0,162.9,162.9
2023-06-04 00:00:00+08,0,7,7,0,706731,706731,0,158.21,158.21
2023-06-04 04:00:00+08,0,6,6,0,567396,567396,0,136.89,136.89
2023-06-04 08:00:00+08,0,6,6,0,491349,491349,0,128.23,128.23
2023-06-04 12:00:00+08,0,6,6,0,491349,491349,0,152.23,152.23
2023-06-04 16:00:00+08,0,6,6,0,491349,491349,0,176.23,176.23
2023-06-04 20:00:00+08,0,7,7,0,603865,603865,0,201.42,201.42
2023-06-05 00:00:00+08,0,8,8,0,645455,645455,0,230.62,230.62
2023-06-05 04:00:00+08,0,7,7,0,594923,594923,0,234.16,234.16
2023-06-05 08:00:00+08,0,6,6,0,542410,542410,0,234.78,234.78
2023-06-05 12:00:00+08,0,4,4,0,307719,307719,0,156.88,156.88
2023-06-05 16:00:00+08,0,1,1,0,34289,34289,0,93.36,93.36
2023-06-05 20:00:00+08,0,3,3,0,166264,166264,0,102.82,102.82
2023-06-06 00:00:00+08,0,5,5,0,399944,399944,0,116.56,116.56
2023-06-06 04:00:00+08,0,5,5,0,399944,399944,0,136.56,136.56
2023-06-06 08:00:00+08,2,6,8,142010,446805,588815,3.94,51.6,55.54
2023-06-06 12:00:00+08,2,5,7,142010,418603,560613,11.94,57.33,69.27
2023-06-06 16:00:00+08,2,4,6,142010,314830,456840,19.93,54.13,74.06
2023-06-06 20:00:00+08,2,4,6,142010,377883,519893,27.91,38.22,66.13
2023-06-07 00:00:00+08,2,6,8,142010,582548,724558,35.91,57.5,93.41
2023-06-07 04:00:00+08,2,8,10,142010,674950,816960,43.94,89.3,133.24
2023-06-07 08:00:00+08,2,8,10,142010,674950,816960,51.94,121.3,173.24
2023-06-07 12:00:00+08,2,7,9,142010,637488,779498,59.91,127.69,187.6
2023-06-07 16:00:00+08,2,6,8,142010,586675,728685,67.92,121.64,189.56
2023-06-07 20:00:00+08,2,8,10,142010,610818,752828,75.93,106.85,182.78
2023-06-08 00:00:00+08,2,10,12,142010,862310,1004320,83.92,119.78,203.7
2023-06-08 04:00:00+08,3,11,14,223152,892545,1115697,93.17,162.14,255.31
2023-06-08 08:00:00+08,3,10,13,223152,858462,1081614,105.17,191.58,296.75
2023-06-08 12:00:00+08,3,10,13,223152,858462,1081614,117.17,231.58,348.75
2023-06-08 16:00:00+08,2,11,13,142010,1003850,1145860,115.92,273.73,389.65
2023-06-08 20:00:00+08,2,12,14,142010,1084992,1227002,139.06,319.84,458.9
2023-06-09 00:00:00+08,2,13,15,142010,1091876,1233886,147.06,369.06,516.12
2023-06-09 04:00:00+08,2,10,12,142010,911407,1053417,155.06,294.78,449.84
2023-06-09 08:00:00+08,1,6,7,40478,535297,575775,88.47,138.73,227.2
2023-06-09 12:00:00+08,1,6,7,40478,606594,647072,168.11,131.32,299.43
2023-06-09 16:00:00+08,0,7,7,0,745205,745205,90.78,156.35,247.13
2023-06-09 20:00:00+08,0,9,9,0,859826,859826,159.1,165.5,324.6
2023-06-10 00:00:00+08,1,10,11,115700,965371,1081071,161.62,202.64,364.26
2023-06-10 04:00:00+08,1,9,10,115700,958487,1074187,165.62,213.42,379.04
2023-06-10 08:00:00+08,1,8,9,115700,918009,1033709,86.16,235.56,321.72
2023-06-10 12:00:00+08,0,6,6,0,721766,721766,75.63,187.14,262.77
2023-06-10 16:00:00+08,0,7,7,0,851027,851027,93.92,147.42,241.34
2023-06-10 20:00:00+08,0,10,10,0,1035878,1035878,18.28,150.33,168.61
2023-06-11 00:00:00+08,0,11,11,0,1042190,1042190,18.25,134.55,152.8
2023-06-11 04:00:00+08,0,10,10,0,899717,899717,18.27,118.04,136.31
2023-06-11 08:00:00+08,1,10,11,90388,1020330,1110718,18.66,135.08,153.74
2023-06-11 12:00:00+08,1,9,10,90388,957336,1047724,22.66,156.02,178.68
2023-06-11 16:00:00+08,1,8,9,90388,957885,1048273,26.66,154.2,180.86
2023-06-11 20:00:00+08,1,9,10,90388,1071774,1162162,30.69,187.58,218.27
2023-06-12 00:00:00+08,1,8,9,90388,1005088,1095476,34.69,200.72,235.41
2023-06-12 04:00:00+08,1,7,8,90388,854940,945328,38.66,174.71,213.37
2023-06-12 08:00:00+08,1,5,6,90388,599397,689785,42.66,103.48,146.14
2023-06-12 12:00:00+08,1,3,4,90388,375398,465786,28.41,58.97,87.38
2023-06-12 16:00:00+08,1,4,5,90388,491098,581486,32.42,71.67,104.09
2023-06-12 20:00:00+08,1,8,9,90388,804272,894660,36.42,96,132.42
2023-06-13 00:00:00+08,1,8,9,90388,804272,894660,40.42,128,168.42
2023-06-13 04:00:00+08,1,9,10,90388,959774,1050162,44.42,163.46,207.88
2023-06-13 08:00:00+08,1,8,9,90388,845885,936273,48.39,162.08,210.47
2023-06-13 12:00:00+08,1,8,9,90388,845885,936273,52.39,194.08,246.47
2023-06-13 16:00:00+08,0,7,7,0,730185,730185,0,201.37,201.37
2023-06-13 20:00:00+08,1,8,9,93552,798707,892259,60.44,146.18,206.62
2023-06-14 00:00:00+08,2,8,10,128997,782944,911941,67.1,149.32,216.42
2023-06-14 04:00:00+08,2,7,9,128997,761531,890528,75.1,147.08,222.18
2023-06-14 08:00:00+08,2,6,8,128997,726500,855497,83.1,166.08,249.18
2023-06-14 12:00:00+08,2,6,8,128997,639718,768715,91.11,135.71,226.82
2023-06-14 16:00:00+08,1,5,6,93552,438442,531994,80.45,98.23,178.68
2023-06-14 20:00:00+08,1,10,11,93552,778993,872545,104.73,126.74,231.47
2023-06-15 00:00:00+08,1,11,12,93552,918328,1011880,108.73,170.7,279.43
2023-06-15 04:00:00+08,1,10,11,93552,805894,899446,112.74,181.02,293.76
2023-06-15 08:00:00+08,1,8,9,93552,728605,822157,96.46,190.4,286.86
2023-06-15 12:00:00+08,1,8,9,93552,728605,822157,100.46,222.4,322.86
2023-06-15 16:00:00+08,0,4,4,0,451486,451486,0,134.3,134.3
2023-06-15 20:00:00+08,0,7,7,0,590516,590516,48.14,57.08,105.22
2023-06-16 00:00:00+08,0,8,8,0,620747,620747,48.14,86.24,134.38
2023-06-16 04:00:00+08,0,7,7,0,526040,526040,48.14,84.8,132.94
2023-06-16 08:00:00+08,0,8,8,0,642755,642755,48.14,103.64,151.78
2023-06-16 12:00:00+08,0,5,5,0,415397,415397,48.14,59.57,107.71
2023-06-16 16:00:00+08,0,4,4,0,321845,321845,0,57.92,57.92
2023-06-16 20:00:00+08,0,4,4,0,354614,354614,0,54.57,54.57
2023-06-17 00:00:00+08,0,4,4,0,354614,354614,0,70.57,70.57
2023-06-17 04:00:00+08,0,4,4,0,367529,367529,0,53.77,53.77
2023-06-17 08:00:00+08,0,5,5,0,513929,513929,0,49.62,49.62
2023-06-17 12:00:00+08,0,4,4,0,450929,450929,0,51.81,51.81
2023-06-17 16:00:00+08,0,4,4,0,450929,450929,0,67.81,67.81
2023-06-17 20:00:00+08,0,7,7,0,760128,760128,0,90.23,90.23
2023-06-18 00:00:00+08,0,10,10,0,1046511,1046511,0,120.51,120.51
2023-06-18 04:00:00+08,1,11,12,105082,1193564,1298646,0.88,140.32,141.2
2023-06-18 08:00:00+08,1,11,12,105082,1193564,1298646,4.88,184.32,189.2
2023-06-18 12:00:00+08,2,9,11,155779,999959,1155738,11.09,198.14,209.23
2023-06-18 16:00:00+08,2,9,11,155779,999959,1155738,19.09,234.14,253.23
2023-06-18 20:00:00+08,1,7,8,105082,809249,914331,16.88,188.33,205.21
2023-06-19 00:00:00+08,0,8,8,0,946628,946628,13.69,156.93,170.62
2023-06-19 04:00:00+08,0,7,7,0,815594,815594,13.69,159.07,172.76
2023-06-19 08:00:00+08,0,8,8,0,905200,905200,38.73,155.34,194.07
2023-06-19 12:00:00+08,0,7,7,0,751686,751686,38.73,131.17,169.9
2023-06-19 16:00:00+08,0,4,4,0,469653,469653,25.02,58.82,83.84
2023-06-19 20:00:00+08,0,7,7,0,795026,795026,25.02,82.42,107.44
2023-06-20 00:00:00+08,0,8,8,0,952102,952102,25.02,111.89,136.91
2023-06-20 04:00:00+08,0,8,8,0,952102,952102,25.02,143.89,168.91
2023-06-20 08:00:00+08,0,9,9,0,978973,978973,25.02,178.05,203.07
2023-06-20 12:00:00+08,0,9,9,0,966736,966736,25.02,198.8,223.82
2023-06-20 16:00:00+08,0,8,8,0,939865,939865,25.02,224.64,249.66
2023-06-20 20:00:00+08,0,7,7,0,726448,726448,0,148.19,148.19
2023-06-21 00:00:00+08,0,10,10,0,1077613,1077613,0,179.61,179.61
2023-06-21 04:00:00+08,0,10,10,0,1077613,1077613,0,219.61,219.61
2023-06-21 08:00:00+08,0,10,10,0,1077613,1077613,0,259.61,259.61
2023-06-21 12:00:00+08,0,10,10,0,1018382,1018382,0,248.38,248.38
2023-06-21 16:00:00+08,0,10,10,0,1018382,1018382,0,288.38,288.38
2023-06-21 20:00:00+08,0,11,11,0,1065227,1065227,0,189.11,189.11
2023-06-22 00:00:00+08,0,11,11,0,1065227,1065227,0,233.11,233.11
2023-06-22 04:00:00+08,0,9,9,0,999368,999368,0,195.38,195.38
2023-06-22 08:00:00+08,0,11,11,0,1068786,1068786,0,175.84,175.84
2023-06-22 12:00:00+08,0,10,10,0,1087975,1087975,0,178.78,178.78
2023-06-22 16:00:00+08,0,9,9,0,977975,977975,0,178.76,178.76
2023-06-22 20:00:00+08,0,11,11,0,1021216,1021216,0,156.65,156.65
2023-06-23 00:00:00+08,0,12,12,0,1028100,1028100,0,200.93,200.93
2023-06-23 04:00:00+08,0,12,12,0,1117263,1117263,0,229.62,229.62
2023-06-23 08:00:00+08,0,11,11,0,1063619,1063619,0,251,251
2023-06-23 12:00:00+08,0,11,11,0,958411,958411,0,233.6,233.6
2023-06-23 16:00:00+08,0,9,9,0,865877,865877,0,234.16,234.16
2023-06-23 20:00:00+08,0,10,10,0,793256,793256,0,165,165
2023-06-24 00:00:00+08,0,11,11,0,1008143,1008143,0,177.14,177.14
2023-06-24 04:00:00+08,0,11,11,0,1008143,1008143,0,221.14,221.14
2023-06-24 08:00:00+08,0,9,9,0,959676,959676,0,212.06,212.06
2023-06-24 12:00:00+08,0,6,6,0,612796,612796,0,114.01,114.01
2023-06-24 16:00:00+08,0,4,4,0,417475,417475,0,76.62,76.62
2023-06-24 20:00:00+08,0,7,7,0,646088,646088,0,98.97,98.97
2023-06-25 00:00:00+08,0,6,6,0,595219,595219,0,96.98,96.98
2023-06-25 04:00:00+08,0,6,6,0,692797,692797,0,112.16,112.16
2023-06-25 08:00:00+08,0,5,5,0,562224,562224,0,99.49,99.49
2023-06-25 12:00:00+08,0,3,3,0,340511,340511,0,63.93,63.93
2023-06-25 16:00:00+08,0,3,3,0,359601,359601,0,35.56,35.56
2023-06-25 20:00:00+08,0,5,5,0,599174,599174,0,50.57,50.57
2023-06-26 00:00:00+08,0,6,6,0,739839,739839,0,72.44,72.44
2023-06-26 04:00:00+08,0,6,6,0,739839,739839,0,96.44,96.44
2023-06-26 08:00:00+08,0,6,6,0,739839,739839,0,120.44,120.44
2023-06-26 12:00:00+08,1,6,7,68819,739839,808658,1.79,144.44,146.23
2023-06-26 16:00:00+08,0,4,4,0,498804,498804,0,110.18,110.18
2023-06-26 20:00:00+08,0,9,9,0,948283,948283,7.9,135.22,143.12
2023-06-27 00:00:00+08,1,10,11,22314,1104338,1126652,10,173.05,183.05
2023-06-27 04:00:00+08,1,10,11,22314,1104338,1126652,14,213.05,227.05
2023-06-27 08:00:00+08,1,11,12,22314,1134527,1156841,18.01,255.3,273.31
2023-06-27 12:00:00+08,1,9,10,22314,935135,957449,14.11,239.89,254
2023-06-27 16:00:00+08,1,7,8,22314,766740,789054,18.11,232.65,250.76
2023-06-27 20:00:00+08,0,10,10,0,1024012,1024012,0,256.57,256.57
2023-06-28 00:00:00+08,0,11,11,0,1046326,1046326,24.97,297.7,322.67
2023-06-28 04:00:00+08,0,11,11,0,1046326,1046326,24.97,341.7,366.67
2023-06-28 08:00:00+08,0,10,10,0,1021084,1021084,24.97,336.62,361.59
2023-06-28 12:00:00+08,0,8,8,0,711337,711337,24.98,280.97,305.95
2023-06-28 16:00:00+08,0,6,6,0,499416,499416,24.98,224.27,249.25
2023-06-28 20:00:00+08,0,8,8,0,717196,717196,0,208.84,208.84
2023-06-29 00:00:00+08,0,10,10,0,928236,928236,0,243.02,243.02
2023-06-29 04:00:00+08,0,10,10,0,928236,928236,0,283.02,283.02
2023-06-29 08:00:00+08,0,9,9,0,885572,885572,0,296.79,296.79
2023-06-29 12:00:00+08,0,8,8,0,929444,929444,0,289.31,289.31
2023-06-29 16:00:00+08,0,7,7,0,787393,787393,0,224.52,224.52
2023-06-29 20:00:00+08,1,9,10,118888,864302,983190,2.6,257.01,259.61
2023-06-30 00:00:00+08,1,9,10,118888,740613,859501,6.6,264.56,271.16
2023-06-30 04:00:00+08,1,9,10,118888,740613,859501,10.6,300.56,311.16
2023-06-30 08:00:00+08,1,9,10,118888,740613,859501,14.6,336.56,351.16
2023-06-30 12:00:00+08,1,8,9,118888,655098,773986,18.6,234.55,253.15
2023-06-30 16:00:00+08,0,5,5,0,396310,396310,0,129.09,129.09
2023-06-30 20:00:00+08,0,7,7,0,571992,571992,25.24,120.19,145.43
2023-07-01 00:00:00+08,0,7,7,0,477134,477134,25.24,82.63,107.87
2023-07-01 04:00:00+08,0,7,7,0,477134,477134,25.24,110.63,135.87
2023-07-01 08:00:00+08,0,6,6,0,470250,470250,25.24,105.68,130.92
2023-07-01 12:00:00+08,0,5,5,0,382632,382632,25.24,112.5,137.74
2023-07-01 16:00:00+08,0,5,5,0,382632,382632,25.24,132.5,157.74
2023-07-01 20:00:00+08,0,9,9,0,744788,744788,25.24,137.97,163.21
2023-07-02 00:00:00+08,1,9,10,26650,835147,861797,25.92,152.54,178.46
2023-07-02 04:00:00+08,1,9,10,26650,835147,861797,29.92,188.54,218.46
2023-07-02 08:00:00+08,2,7,9,101103,544001,645104,8.94,134.65,143.59
2023-07-02 12:00:00+08,2,6,8,101103,605235,706338,16.94,80.56,97.5
2023-07-02 16:00:00+08,1,6,7,26650,697691,724341,16.67,51.88,68.55
2023-07-02 20:00:00+08,1,8,9,26650,871210,897860,30.87,79.98,110.85
2023-07-03 00:00:00+08,1,8,9,26650,871210,897860,34.87,111.98,146.85
2023-07-03 04:00:00+08,1,8,9,26650,871210,897860,38.87,143.98,182.85
2023-07-03 08:00:00+08,1,9,10,26650,934207,960857,42.87,178.26,221.13
2023-07-03 12:00:00+08,1,8,9,26650,853036,879686,46.9,193.36,240.26
2023-07-03 16:00:00+08,1,5,6,26650,531111,557761,40.67,131.86,172.53
2023-07-03 20:00:00+08,1,9,10,26650,793952,820602,44.68,161,205.68
2023-07-04 00:00:00+08,1,10,11,26650,947690,974340,48.68,199.29,247.97
2023-07-04 04:00:00+08,1,10,11,26650,947690,974340,52.68,239.29,291.97
2023-07-04 08:00:00+08,1,9,10,26650,955642,982292,56.67,226.66,283.33
2023-07-04 12:00:00+08,1,7,8,26650,835163,861813,60.67,202.33,263
2023-07-04 16:00:00+08,1,6,7,26650,772166,798816,64.67,196.05,260.72
2023-07-04 20:00:00+08,1,4,5,26650,527213,553863,68.67,121.7,190.37
2023-07-05 00:00:00+08,1,4,5,26650,527213,553863,72.67,137.7,210.37
2023-07-05 04:00:00+08,1,4,5,26650,527213,553863,76.67,153.7,230.37
2023-07-05 08:00:00+08,1,4,5,26650,527213,553863,80.67,169.7,250.37
2023-07-05 12:00:00+08,1,4,5,26650,527213,553863,84.67,185.7,270.37
2023-07-05 16:00:00+08,0,4,4,0,527213,527213,0,201.7,201.7
2023-07-05 20:00:00+08,0,6,6,0,648524,648524,89.38,223.03,312.41
2023-07-06 00:00:00+08,0,6,6,0,648524,648524,89.38,247.03,336.41
2023-07-06 04:00:00+08,0,7,7,0,710370,710370,89.38,218.97,308.35
2023-07-06 08:00:00+08,0,8,8,0,809456,809456,89.38,249.82,339.2
2023-07-06 12:00:00+08,0,6,6,0,629068,629068,0,200.25,200.25
2023-07-06 16:00:00+08,0,6,6,0,629068,629068,0,224.25,224.25
2023-07-06 20:00:00+08,0,6,6,0,537140,537140,0,82.17,82.17
2023-07-07 00:00:00+08,0,7,7,0,570501,570501,0,88.24,88.24
2023-07-07 04:00:00+08,0,9,9,0,887704,887704,0,90.32,90.32
2023-07-07 08:00:00+08,0,10,10,0,1026611,1026611,0,126.67,126.67
2023-07-07 12:00:00+08,0,9,9,0,854519,854519,0,116.33,116.33
2023-07-07 16:00:00+08,0,9,9,0,902521,902521,0,136.21,136.21
2023-07-07 20:00:00+08,0,11,11,0,1139962,1139962,0,173.44,173.44
2023-07-08 00:00:00+08,0,11,11,0,1186863,1186863,0,202.95,202.95
2023-07-08 04:00:00+08,0,11,11,0,1186863,1186863,0,246.95,246.95
2023-07-08 08:00:00+08,0,8,8,0,892014,892014,0,142.2,142.2
2023-07-08 12:00:00+08,0,9,9,0,951886,951886,0,162.04,162.04
2023-07-08 16:00:00+08,0,8,8,0,883839,883839,0,180.93,180.93
2023-07-08 20:00:00+08,0,10,10,0,1048927,1048927,0,215.99,215.99
2023-07-09 00:00:00+08,0,9,9,0,998395,998395,0,237.21,237.21
2023-07-09 04:00:00+08,1,9,10,67518,947689,1015207,0.8,254.84,255.64
2023-07-09 08:00:00+08,1,10,11,67518,1038132,1105650,4.8,292.78,297.58
2023-07-09 12:00:00+08,0,9,9,0,896109,896109,0,274.15,274.15
2023-07-09 16:00:00+08,0,7,7,0,872036,872036,0,189.89,189.89
2023-07-09 20:00:00+08,1,9,10,26811,982404,1009215,14.94,139.14,154.08
2023-07-10 00:00:00+08,1,10,11,26811,1099255,1126066,18.94,175.7,194.64
2023-07-10 04:00:00+08,1,9,10,26811,995641,1022452,22.94,206.82,229.76
2023-07-10 08:00:00+08,1,9,10,26811,995641,1022452,26.94,242.82,269.76
2023-07-10 12:00:00+08,1,6,7,26811,645173,671984,16.12,119.92,136.04
2023-07-10 16:00:00+08,0,6,6,0,709430,709430,0,110.6,110.6
2023-07-10 20:00:00+08,0,6,6,0,626540,626540,21.16,89.1,110.26
2023-07-11 00:00:00+08,0,7,7,0,730188,730188,21.16,113.68,134.84
2023-07-11 04:00:00+08,0,10,10,0,1049351,1049351,21.16,146.73,167.89
2023-07-11 08:00:00+08,0,10,10,0,1079152,1079152,0,163.1,163.1
2023-07-11 12:00:00+08,0,9,9,0,932360,932360,0,156.46,156.46
2023-07-11 16:00:00+08,0,9,9,0,932360,932360,0,192.46,192.46
2023-07-11 20:00:00+08,0,11,11,0,1111796,1111796,0,233.42,233.42
2023-07-12 00:00:00+08,0,10,10,0,1084822,1084822,0,259.17,259.17
2023-07-12 04:00:00+08,0,8,8,0,918008,918008,0,220.53,220.53
2023-07-12 08:00:00+08,0,7,7,0,814360,814360,0,219.96,219.96
2023-07-12 12:00:00+08,0,8,8,0,764996,764996,0,184.52,184.52
2023-07-12 16:00:00+08,0,6,6,0,514687,514687,0,156.93,156.93
2023-07-12 20:00:00+08,0,8,8,0,613775,613775,0,186.05,186.05
2023-07-13 00:00:00+08,0,8,8,0,613775,613775,0,218.05,218.05
2023-07-13 04:00:00+08,0,8,8,0,613775,613775,0,250.05,250.05
2023-07-13 08:00:00+08,0,8,8,0,657592,657592,0,270.44,270.44
2023-07-13 12:00:00+08,0,7,7,0,592587,592587,0,283.81,283.81
2023-07-13 16:00:00+08,0,6,6,0,497922,497922,0,266.23,266.23
2023-07-13 20:00:00+08,0,6,6,0,531819,531819,0,185.66,185.66
2023-07-14 00:00:00+08,0,7,7,0,650902,650902,0,170.78,170.78
2023-07-14 04:00:00+08,0,9,9,0,848641,848641,0,204.97,204.97
2023-07-14 08:00:00+08,0,10,10,0,905710,905710,0,219.38,219.38
2023-07-14 12:00:00+08,0,11,11,0,1044617,1044617,0,263.03,263.03
2023-07-14 16:00:00+08,0,11,11,0,1044617,1044617,0,307.03,307.03
2023-07-14 20:00:00+08,0,11,11,0,1171636,1171636,0,320.07,320.07
2023-07-15 00:00:00+08,0,11,11,0,1171636,1171636,0,364.07,364.07
2023-07-15 04:00:00+08,0,12,12,0,1235036,1235036,0,408.4,408.4
2023-07-15 08:00:00+08,0,11,11,0,1118375,1118375,0,386.68,386.68
2023-07-15 12:00:00+08,0,11,11,0,1118375,1118375,0,430.68,430.68
2023-07-15 16:00:00+08,0,10,10,0,1048033,1048033,0,411.51,411.51
2023-07-15 20:00:00+08,0,11,11,0,1173867,1173867,0,438.76,438.76
2023-07-16 00:00:00+08,0,13,13,0,1288681,1288681,0,484.22,484.22
2023-07-16 04:00:00+08,0,13,13,0,1225257,1225257,0,504.13,504.13
2023-07-16 08:00:00+08,0,14,14,0,1372242,1372242,0,534.63,534.63
2023-07-16 12:00:00+08,0,13,13,0,1342133,1342133,0,568.48,568.48
2023-07-16 16:00:00+08,0,9,9,0,877313,877313,0,457.44,457.44
2023-07-16 20:00:00+08,0,10,10,0,1018788,1018788,0,470.88,470.88
2023-07-17 00:00:00+08,1,12,13,63069,1324256,1387325,0.22,516.52,516.74
2023-07-17 04:00:00+08,1,10,11,63069,1201669,1264738,4.22,522.96,527.18
2023-07-17 08:00:00+08,1,9,10,63069,1047961,1111030,8.22,519.86,528.08
2023-07-17 12:00:00+08,1,7,8,63069,808374,871443,12.22,401.22,413.44
2023-07-17 16:00:00+08,1,7,8,63069,808374,871443,16.22,429.22,445.44
2023-07-17 20:00:00+08,1,9,10,63069,857166,920235,20.23,425.55,445.78
2023-07-18 00:00:00+08,2,11,13,85383,970662,1056045,27.56,464.84,492.4
2023-07-18 04:00:00+08,2,11,13,85383,970662,1056045,35.56,508.84,544.4
2023-07-18 08:00:00+08,1,13,14,22314,1148764,1171078,11.34,558.32,569.66
2023-07-18 12:00:00+08,3,13,16,192917,1126047,1318964,55.27,569.58,624.85
2023-07-18 16:00:00+08,3,11,14,192917,985347,1178264,67.27,552.64,619.91
2023-07-18 20:00:00+08,2,12,14,170603,1092405,1263008,55.9,575.82,631.72
2023-07-19 00:00:00+08,2,11,13,170603,1035410,1206013,90.96,551.53,642.49
2023-07-19 04:00:00+08,2,11,13,170603,1035410,1206013,98.96,595.53,694.49
2023-07-19 08:00:00+08,2,12,14,170603,1162486,1333089,106.96,642.01,748.97
2023-07-19 12:00:00+08,2,12,14,170603,1125795,1296398,114.96,656.32,771.28
2023-07-19 16:00:00+08,0,10,10,0,965485,965485,27.02,653.6,680.62
2023-07-19 20:00:00+08,0,11,11,0,977098,977098,67.71,542.4,610.11
2023-07-20 00:00:00+08,0,11,11,0,977098,977098,67.71,586.4,654.11
2023-07-20 04:00:00+08,1,11,12,101717,977098,1078815,71.18,630.4,701.58
2023-07-20 08:00:00+08,1,9,10,101717,763946,865663,41.21,568.01,609.22
2023-07-20 12:00:00+08,1,8,9,101717,822949,924666,45.21,561.34,606.55
2023-07-20 16:00:00+08,0,7,7,0,753953,753953,33.73,366.34,400.07
2023-07-20 20:00:00+08,0,10,10,0,915625,915625,18,334.12,352.12
2023-07-21 00:00:00+08,0,13,13,0,1089456,1089456,18,336.01,354.01
2023-07-21 04:00:00+08,0,14,14,0,1235139,1235139,18,390.84,408.84
2023-07-21 08:00:00+08,0,13,13,0,1200371,1200371,18,433.5,451.5
2023-07-21 12:00:00+08,0,13,13,0,1200371,1200371,18,485.5,503.5
2023-07-21 16:00:00+08,0,11,11,0,1081430,1081430,18,480.1,498.1
2023-07-21 20:00:00+08,0,10,10,0,993226,993226,0,241.97,241.97
2023-07-22 00:00:00+08,2,11,13,147265,1059167,1206432,7.54,234.71,242.25
2023-07-22 04:00:00+08,2,11,13,147265,1059167,1206432,15.54,278.71,294.25
2023-07-22 08:00:00+08,2,10,12,147265,1052283,1199548,23.54,289.47,313.01
2023-07-22 12:00:00+08,2,10,12,147265,992623,1139888,31.54,288.55,320.09
2023-07-22 16:00:00+08,2,8,10,147265,861060,1008325,39.52,266.33,305.85
2023-07-22 20:00:00+08,2,8,10,147265,759889,907154,47.52,225.08,272.6
2023-07-23 00:00:00+08,1,7,8,85797,675198,760995,27.63,146.76,174.39
2023-07-23 04:00:00+08,1,8,9,85797,796536,882333,63.27,160.52,223.79
2023-07-23 08:00:00+08,1,8,9,85797,796536,882333,67.27,192.52,259.79
2023-07-23 12:00:00+08,1,8,9,85797,844290,930087,71.28,209.59,280.87
2023-07-23 16:00:00+08,1,5,6,85797,500588,586385,75.27,116.36,191.63
2023-07-23 20:00:00+08,1,8,9,85797,794750,880547,79.27,75.53,154.8
2023-07-24 00:00:00+08,1,8,9,85797,816328,902125,51.63,70,121.63
2023-07-24 04:00:00+08,1,9,10,85797,849402,935199,55.63,102.16,157.79
2023-07-24 08:00:00+08,1,9,10,85797,849402,935199,59.63,138.16,197.79
2023-07-24 12:00:00+08,1,8,9,85797,783437,869234,63.63,155.82,219.45
2023-07-24 16:00:00+08,1,8,9,85797,783437,869234,67.63,187.82,255.45
2023-07-24 20:00:00+08,1,8,9,85797,745305,831102,71.63,136.99,208.62
2023-07-25 00:00:00+08,1,7,8,85797,652467,738264,75.64,102.28,177.92
2023-07-25 04:00:00+08,0,8,8,0,808665,808665,0,131.52,131.52
2023-07-25 08:00:00+08,0,10,10,0,915875,915875,80.56,168.57,249.13
2023-07-25 12:00:00+08,0,10,10,0,915875,915875,80.56,208.57,289.13
2023-07-25 16:00:00+08,0,5,5,0,557821,557821,80.57,122.55,203.12
2023-07-25 20:00:00+08,0,7,7,0,769528,769528,80.57,145.55,226.12
2023-07-26 00:00:00+08,0,9,9,0,877220,877220,80.58,178.15,258.73
2023-07-26 04:00:00+08,0,8,8,0,738609,738609,80.58,158.9,239.48
2023-07-26 08:00:00+08,0,9,9,0,885784,885784,80.58,156.55,237.13
2023-07-26 12:00:00+08,0,7,7,0,786924,786924,0,147.73,147.73
2023-07-26 16:00:00+08,0,5,5,0,536097,536097,0,119.66,119.66
2023-07-26 20:00:00+08,0,9,9,0,766288,766288,0,77,77
2023-07-27 00:00:00+08,1,10,11,103994,913080,1017074,2.91,114.75,117.66
2023-07-27 04:00:00+08,2,10,12,197546,913080,1110626,8.66,154.75,163.41
2023-07-27 08:00:00+08,2,10,12,197546,913080,1110626,16.66,194.75,211.41
2023-07-27 12:00:00+08,2,7,9,197546,702251,899797,24.64,157.43,182.07
2023-07-27 16:00:00+08,1,6,7,93552,672016,765568,13.75,163.44,177.19
2023-07-27 20:00:00+08,1,10,11,93552,941531,1035083,38.91,135.92,174.83
2023-07-28 00:00:00+08,1,11,12,93552,973876,1067428,42.91,136.24,179.15
2023-07-28 04:00:00+08,1,11,12,93552,973876,1067428,46.91,180.24,227.15
2023-07-28 08:00:00+08,1,10,11,93552,939576,1033128,50.91,209.99,260.9
2023-07-28 12:00:00+08,1,9,10,93552,809003,902555,54.9,208.55,263.45
2023-07-28 16:00:00+08,0,6,6,0,546523,546523,21.15,159.28,180.43
2023-07-28 20:00:00+08,0,9,9,0,921049,921049,61.84,126.33,188.17
2023-07-29 00:00:00+08,0,10,10,0,984043,984043,61.84,163.49,225.33
2023-07-29 04:00:00+08,0,8,8,0,810312,810312,61.83,141.27,203.1
2023-07-29 08:00:00+08,0,7,7,0,803428,803428,61.83,140.54,202.37
2023-07-29 12:00:00+08,0,7,7,0,737691,737691,61.83,126.57,188.4
2023-07-29 16:00:00+08,0,6,6,0,674697,674697,61.83,137.41,199.24
2023-07-29 20:00:00+08,0,8,8,0,897590,897590,40.7,117.58,158.28
2023-07-30 00:00:00+08,1,10,11,145527,1005865,1151392,44.16,152.07,196.23
2023-07-30 04:00:00+08,1,10,11,145527,1017320,1162847,7.46,160.18,167.64
2023-07-30 08:00:00+08,1,10,11,145527,1017320,1162847,11.46,200.18,211.64
2023-07-30 12:00:00+08,1,8,9,145527,836233,981760,15.45,185.03,200.48
2023-07-30 16:00:00+08,1,7,8,145527,840834,986361,19.47,166.26,185.73
2023-07-30 20:00:00+08,1,7,8,145527,799510,945037,23.48,130.98,154.46
2023-07-31 00:00:00+08,1,9,10,145527,981250,1126777,27.47,135.91,163.38
2023-07-31 04:00:00+08,2,8,10,226698,913453,1140151,32.46,143,175.46
2023-07-31 08:00:00+08,2,7,9,226698,794618,1021316,40.46,137.42,177.88
2023-07-31 12:00:00+08,1,6,7,81171,648638,729809,8.99,100.33,109.32
2023-07-31 16:00:00+08,1,5,6,81171,708005,789176,55.99,84.2,140.19
2023-07-31 20:00:00+08,1,7,8,81171,857287,938458,59.99,107.16,167.15
2023-08-01 00:00:00+08,1,9,10,81171,1033304,1114475,63.99,138.62,202.61
2023-08-01 04:00:00+08,1,9,10,81171,1033304,1114475,67.99,174.62,242.61
2023-08-01 08:00:00+08,1,10,11,81171,940540,1021711,71.99,178,249.99
2023-08-01 12:00:00+08,1,10,11,81171,940540,1021711,75.99,218,293.99
2023-08-01 16:00:00+08,1,9,10,81171,952421,1033592,79.99,221.36,301.35
2023-08-01 20:00:00+08,1,7,8,81171,796130,877301,83.99,215.34,299.33
2023-08-02 00:00:00+08,1,9,10,81171,1002344,1083515,87.99,245.65,333.64
2023-08-02 04:00:00+08,1,9,10,81171,1091261,1172432,91.99,263,354.99
2023-08-02 08:00:00+08,1,9,10,81171,1002616,1083787,95.99,242.43,338.42
2023-08-02 12:00:00+08,1,8,9,81171,863281,944452,99.95,209.12,309.07
2023-08-02 16:00:00+08,1,7,8,81171,714289,795460,103.97,198.19,302.16
2023-08-02 20:00:00+08,1,9,10,81171,886670,967841,107.97,230.83,338.8
2023-08-03 00:00:00+08,1,9,10,81171,808244,889415,111.95,192.19,304.14
2023-08-03 04:00:00+08,1,8,9,81171,736988,818159,115.95,192.11,308.06
2023-08-03 08:00:00+08,1,7,8,81171,702674,783845,119.95,199.36,319.31
2023-08-03 12:00:00+08,1,3,4,81171,293820,374991,80.99,92.23,173.22
2023-08-03 16:00:00+08,1,1,2,81171,111614,192785,84.99,41.16,126.15
2023-08-03 20:00:00+08,1,5,6,81171,394447,475618,88.99,52.19,141.18
2023-08-04 00:00:00+08,0,6,6,0,362685,362685,0,26.97,26.97
2023-08-04 04:00:00+08,0,6,6,0,362685,362685,0,50.97,50.97
2023-08-04 08:00:00+08,0,7,7,0,539543,539543,98.24,67.32,165.56
2023-08-04 12:00:00+08,0,6,6,0,489580,489580,98.24,78.58,176.82
2023-08-04 16:00:00+08,0,5,5,0,437524,437524,98.24,80.5,178.74
2023-08-04 20:00:00+08,0,9,9,0,687579,687579,98.25,107.6,205.85
2023-08-05 00:00:00+08,1,8,9,146778,606408,753186,3.63,124.86,128.49
2023-08-05 04:00:00+08,1,7,8,146778,599524,746302,7.63,128.03,135.66
2023-08-05 08:00:00+08,1,5,6,146778,396101,542879,11.63,93.17,104.8
2023-08-05 12:00:00+08,1,6,7,146778,501263,648041,15.63,114.09,129.72
2023-08-05 16:00:00+08,1,5,6,146778,471032,617810,19.63,116.44,136.07
2023-08-05 20:00:00+08,2,7,9,193713,686408,880121,27.19,93.35,120.54
2023-08-06 00:00:00+08,2,8,10,193713,805732,999445,35.19,124.06,159.25
2023-08-06 04:00:00+08,3,8,11,303448,805732,1109180,46.42,156.06,202.48
2023-08-06 08:00:00+08,3,5,8,303448,512736,816184,58.44,73.86,132.3
2023-08-06 12:00:00+08,2,6,8,156670,630069,786739,30.82,97.46,128.28
2023-08-06 16:00:00+08,2,6,8,156670,713697,870367,81.12,100.12,181.24
2023-08-06 20:00:00+08,3,9,12,224185,1035305,1259490,92.11,128.99,221.1
2023-08-07 00:00:00+08,3,8,11,224185,930143,1154328,104.11,128.11,232.22
2023-08-07 04:00:00+08,3,8,11,224185,930143,1154328,116.11,160.11,276.22
2023-08-07 08:00:00+08,4,9,13,246499,1038784,1285283,128.98,195.11,324.09
2023-08-07 12:00:00+08,4,10,14,246499,1080367,1326866,144.99,234.24,379.23
2023-08-07 16:00:00+08,3,9,12,199564,1001337,1200901,113.42,219.73,333.15
2023-08-07 20:00:00+08,2,9,11,132049,932075,1064124,148.36,172.39,320.75
2023-08-08 00:00:00+08,2,11,13,132049,1042362,1174411,186.24,182.77,369.01
2023-08-08 04:00:00+08,2,11,13,132049,1042362,1174411,194.24,226.77,421.01
2023-08-08 08:00:00+08,2,10,12,132049,1067056,1199105,152.36,237.05,389.41
2023-08-08 12:00:00+08,3,9,12,182581,947732,1130313,162.72,214.33,377.05
2023-08-08 16:00:00+08,3,8,11,182581,832049,1014630,174.75,211.51,386.26
2023-08-08 20:00:00+08,2,10,12,160267,1060940,1221207,149.78,228.75,378.53
2023-08-09 00:00:00+08,2,11,13,160267,1065939,1226206,153,165.97,318.97
2023-08-09 04:00:00+08,1,11,12,109735,1152018,1261753,112.76,182.71,295.47
2023-08-09 08:00:00+08,1,12,13,109735,1097013,1206748,136.33,168.06,304.39
2023-08-09 12:00:00+08,1,12,13,109735,1097013,1206748,140.33,216.06,356.39
2023-08-09 16:00:00+08,1,9,10,109735,938623,1048358,106.79,198.2,304.99
2023-08-09 20:00:00+08,1,12,13,109735,1213578,1323313,110.79,240.71,351.5
2023-08-10 00:00:00+08,2,12,14,236811,1213578,1450389,116.32,288.71,405.03
2023-08-10 04:00:00+08,2,11,13,236811,1174694,1411505,124.32,269.13,393.45
2023-08-10 08:00:00+08,1,9,10,127076,1157091,1284167,112.63,247.66,360.29
2023-08-10 12:00:00+08,1,7,8,127076,932648,1059724,116.62,197.19,313.81
2023-08-10 16:00:00+08,1,4,5,127076,559400,686476,120.63,81.57,202.2
2023-08-10 20:00:00+08,1,7,8,105007,658591,763598,103.64,104.47,208.11
2023-08-11 00:00:00+08,1,9,10,105007,877325,982332,132.78,90.2,222.98
2023-08-11 04:00:00+08,1,10,11,105007,884209,989216,136.78,129.76,266.54
2023-08-11 08:00:00+08,1,11,12,105007,964438,1069445,140.78,173.76,314.54
2023-08-11 12:00:00+08,1,9,10,105007,899704,1004711,144.78,181.28,326.06
2023-08-11 16:00:00+08,1,9,10,105007,899704,1004711,148.78,217.28,366.06
2023-08-11 20:00:00+08,1,11,12,105007,963849,1068856,49.68,172.76,222.44
2023-08-12 00:00:00+08,1,10,11,105007,929392,1034399,53.68,186.35,240.03
2023-08-12 04:00:00+08,1,9,10,105007,828712,933719,57.7,197.69,255.39
2023-08-12 08:00:00+08,1,7,8,105007,762241,867248,61.7,187.96,249.66
2023-08-12 12:00:00+08,1,5,6,105007,554936,659943,40.56,147.56,188.12
2023-08-12 16:00:00+08,0,5,5,0,559659,559659,0,146.72,146.72
2023-08-12 20:00:00+08,0,4,4,0,426788,426788,45.62,73.91,119.53
2023-08-13 00:00:00+08,0,4,4,0,426788,426788,45.62,89.91,135.53
2023-08-13 04:00:00+08,0,4,4,0,426788,426788,45.62,105.91,151.53
2023-08-13 08:00:00+08,0,3,3,0,223593,223593,45.64,34.65,80.29
2023-08-13 12:00:00+08,0,3,3,0,223593,223593,45.64,46.65,92.29
2023-08-13 16:00:00+08,0,3,3,0,223593,223593,45.64,58.65,104.29
2023-08-13 20:00:00+08,1,5,6,104357,538387,642744,46.9,48.96,95.86
2023-08-14 00:00:00+08,1,5,6,104357,501282,605639,5.22,39.22,44.44
2023-08-14 04:00:00+08,1,6,7,104357,657457,761814,9.22,61.54,70.76
2023-08-14 08:00:00+08,1,6,7,104357,709449,813806,13.21,60.86,74.07
2023-08-14 12:00:00+08,2,6,8,154986,709449,864435,19.28,84.86,104.14
2023-08-14 16:00:00+08,2,6,8,154986,709449,864435,27.28,108.86,136.14
2023-08-14 20:00:00+08,2,6,8,154986,625431,780417,35.29,106.68,141.97
2023-08-15 00:00:00+08,2,6,8,154986,625431,780417,43.29,130.68,173.97
2023-08-15 04:00:00+08,2,7,9,154986,744525,899511,51.29,158.44,209.73
2023-08-15 08:00:00+08,2,8,10,154986,808605,963591,59.3,158.26,217.56
2023-08-15 12:00:00+08,2,8,10,154986,808605,963591,67.3,190.26,257.56
2023-08-15 16:00:00+08,2,5,7,154986,553758,708744,75.29,120.14,195.43
2023-08-15 20:00:00+08,1,8,9,104357,777237,881594,49.22,133.78,183
2023-08-16 00:00:00+08,1,11,12,104357,1064105,1168462,89.32,169.94,259.26
2023-08-16 04:00:00+08,1,11,12,104357,1064105,1168462,93.32,213.94,307.26
2023-08-16 08:00:00+08,1,10,11,104357,822998,927355,97.3,172.78,270.08
2023-08-16 12:00:00+08,0,7,7,0,603185,603185,36.06,146.23,182.29
2023-08-16 16:00:00+08,0,5,5,0,371843,371843,36.06,82.59,118.65
2023-08-16 20:00:00+08,0,8,8,0,707033,707033,107.59,85.71,193.3
2023-08-17 00:00:00+08,0,10,10,0,820519,820519,107.59,120.21,227.8
2023-08-17 04:00:00+08,0,10,10,0,820519,820519,107.59,160.21,267.8
2023-08-17 08:00:00+08,0,9,9,0,776206,776206,71.52,142.54,214.06
2023-08-17 12:00:00+08,0,8,8,0,749395,749395,71.52,159.72,231.24
2023-08-17 16:00:00+08,0,6,6,0,635909,635909,71.52,157.24,228.76
2023-08-17 20:00:00+08,0,10,10,0,946197,946197,71.5,189.31,260.81
2023-08-18 00:00:00+08,0,11,11,0,953081,953081,71.5,229.62,301.12
2023-08-18 04:00:00+08,1,10,11,13803,858416,872219,71.89,221.34,293.23
2023-08-18 08:00:00+08,1,9,10,13803,833178,846981,75.9,247.6,323.5
2023-08-18 12:00:00+08,1,5,6,13803,515664,529467,8.38,153.58,161.96
2023-08-18 16:00:00+08,0,5,5,0,515664,515664,0,173.58,173.58
2023-08-18 20:00:00+08,0,8,8,0,639235,639235,14.54,133.5,148.04
2023-08-19 00:00:00+08,0,7,7,0,532251,532251,14.54,136.06,150.6
2023-08-19 04:00:00+08,0,8,8,0,671158,671158,14.54,167.88,182.42
2023-08-19 08:00:00+08,0,6,6,0,548195,548195,14.55,128.65,143.2
2023-08-19 12:00:00+08,0,4,4,0,471392,471392,0,116,116
2023-08-19 16:00:00+08,0,2,2,0,242474,242474,0,37.66,37.66
2023-08-19 20:00:00+08,0,4,4,0,390473,390473,0,49.96,49.96
2023-08-20 00:00:00+08,0,6,6,0,641427,641427,0,67.51,67.51
2023-08-20 04:00:00+08,0,5,5,0,537860,537860,0,57.69,57.69
2023-08-20 08:00:00+08,0,7,7,0,877773,877773,0,72.76,72.76
2023-08-20 12:00:00+08,0,7,7,0,877773,877773,0,100.76,100.76
2023-08-20 16:00:00+08,0,6,6,0,774159,774159,0,112.2,112.2
2023-08-20 20:00:00+08,0,8,8,0,990759,990759,0,139.18,139.18
2023-08-21 00:00:00+08,0,7,7,0,882118,882118,0,140.36,140.36
2023-08-21 04:00:00+08,0,8,8,0,948804,948804,0,168.43,168.43
2023-08-21 08:00:00+08,0,9,9,0,1029042,1029042,0,202.02,202.02
2023-08-21 12:00:00+08,0,8,8,0,890135,890135,0,178.2,178.2
2023-08-21 16:00:00+08,0,7,7,0,781513,781513,0,188.72,188.72
2023-08-21 20:00:00+08,0,5,5,0,523186,523186,0,139.86,139.86
2023-08-22 00:00:00+08,0,7,7,0,734939,734939,0,165.17,165.17
2023-08-22 04:00:00+08,0,8,8,0,756409,756409,0,196.35,196.35
2023-08-22 08:00:00+08,0,8,8,0,640413,640413,0,148.57,148.57
2023-08-22 12:00:00+08,0,9,9,0,805584,805584,0,184.55,184.55
2023-08-22 16:00:00+08,0,9,9,0,805584,805584,0,220.55,220.55
2023-08-22 20:00:00+08,0,5,5,0,492198,492198,0,109.2,109.2
2023-08-23 00:00:00+08,0,4,4,0,487022,487022,0,86.13,86.13
2023-08-23 04:00:00+08,0,5,5,0,571710,571710,0,104.3,104.3
2023-08-23 08:00:00+08,0,7,7,0,656806,656806,0,128.35,128.35
2023-08-23 12:00:00+08,0,7,7,0,656806,656806,0,156.35,156.35
2023-08-23 16:00:00+08,0,7,7,0,656806,656806,0,184.35,184.35
2023-08-23 20:00:00+08,0,9,9,0,736333,736333,0,200.4,200.4
2023-08-24 00:00:00+08,0,9,9,0,736333,736333,0,236.4,236.4
2023-08-24 04:00:00+08,1,8,9,115700,571162,686862,2.2,228.42,230.62
2023-08-24 08:00:00+08,1,9,10,115700,761629,877329,6.2,225.14,231.34
2023-08-24 12:00:00+08,1,7,8,115700,641483,757183,10.2,214.41,224.61
2023-08-24 16:00:00+08,1,4,5,115700,356932,472632,14.21,111.88,126.09
2023-08-24 20:00:00+08,1,8,9,115700,496124,611824,18.21,137.55,155.76
2023-08-25 00:00:00+08,1,9,10,115700,503008,618708,22.21,170.05,192.26
2023-08-25 04:00:00+08,1,8,9,115700,422770,538470,26.21,112.46,138.67
2023-08-25 08:00:00+08,0,7,7,0,466344,466344,0,108.71,108.71
2023-08-25 12:00:00+08,0,5,5,0,330308,330308,0,88.32,88.32
2023-08-25 16:00:00+08,0,3,3,0,251144,251144,37.22,28.31,65.53
2023-08-25 20:00:00+08,0,6,6,0,523201,523201,37.2,45.79,82.99
2023-08-26 00:00:00+08,0,6,6,0,523201,523201,37.2,69.79,106.99
2023-08-26 04:00:00+08,0,7,7,0,745550,745550,37.2,69.55,106.75
2023-08-26 08:00:00+08,0,8,8,0,787140,787140,37.2,97.78,134.98
2023-08-26 12:00:00+08,0,7,7,0,658580,658580,37.2,98.94,136.14
2023-08-26 16:00:00+08,0,6,6,0,595185,595185,37.2,104.8,142
2023-08-26 20:00:00+08,0,7,7,0,734520,734520,37.2,130.87,168.07
2023-08-27 00:00:00+08,0,9,9,0,932469,932469,37.2,160.62,197.82
2023-08-27 04:00:00+08,0,7,7,0,783749,783749,37.2,112.65,149.85
2023-08-27 08:00:00+08,0,7,7,0,621223,621223,37.23,86.95,124.18
2023-08-27 12:00:00+08,0,5,5,0,411971,411971,0,56.96,56.96
2023-08-27 16:00:00+08,0,5,5,0,411971,411971,0,76.96,76.96
2023-08-27 20:00:00+08,0,6,6,0,641276,641276,0,72.35,72.35
2023-08-28 00:00:00+08,0,7,7,0,722870,722870,0,96.59,96.59
2023-08-28 04:00:00+08,0,7,7,0,722870,722870,0,124.59,124.59
2023-08-28 08:00:00+08,0,6,6,0,621338,621338,0,121.02,121.02
2023-08-28 12:00:00+08,0,6,6,0,621338,621338,0,145.02,145.02
2023-08-28 16:00:00+08,1,6,7,111614,621338,732952,2.65,169.02,171.67
2023-08-28 20:00:00+08,1,9,10,111614,848582,960196,6.68,173.66,180.34
2023-08-29 00:00:00+08,1,8,9,111614,766988,878602,10.68,185.43,196.11
2023-08-29 04:00:00+08,1,6,7,111614,555099,666713,14.65,130.92,145.57
2023-08-29 08:00:00+08,1,7,8,111614,494365,605979,18.65,98.33,116.98
2023-08-29 12:00:00+08,1,8,9,111614,667574,779188,22.65,115.42,138.07
2023-08-29 16:00:00+08,0,6,6,0,538409,538409,0,70.01,70.01
2023-08-29 20:00:00+08,1,9,10,115700,794183,909883,28.55,100.67,129.22
2023-08-30 00:00:00+08,1,9,10,115700,836824,952524,32.54,118.25,150.79
2023-08-30 04:00:00+08,2,9,11,142350,836824,979174,37.49,154.25,191.74
2023-08-30 08:00:00+08,2,9,11,142350,769654,912004,45.5,153.09,198.59
2023-08-30 12:00:00+08,2,8,10,142350,667993,810343,53.5,147.36,200.86
2023-08-30 16:00:00+08,1,4,5,115700,386252,501952,48.55,79.14,127.69
2023-08-30 20:00:00+08,1,7,8,115700,514897,630597,66.5,103.7,170.2
2023-08-31 00:00:00+08,3,8,11,390727,668699,1059426,74.03,133.87,207.9
2023-08-31 04:00:00+08,3,10,13,390727,959560,1350287,86.02,167.37,253.39
2023-08-31 08:00:00+08,3,10,13,390727,980704,1371431,84.07,181.87,265.94
2023-08-31 12:00:00+08,3,9,12,390727,946000,1336727,96.07,193.12,289.19
2023-08-31 16:00:00+08,2,8,10,260272,952043,1212315,90.75,165.45,256.2
2023-08-31 20:00:00+08,1,11,12,144572,1159102,1303674,41.7,155.18,196.88
2023-09-01 00:00:00+08,2,13,15,222518,1338339,1560857,96.98,203.5,300.48
2023-09-01 04:00:00+08,2,13,15,222518,1338339,1560857,104.98,255.5,360.48
2023-09-01 08:00:00+08,2,13,15,222518,1334237,1556755,112.99,238.34,351.33
2023-09-01 12:00:00+08,1,13,14,144572,1334283,1478855,119.74,260.69,380.43
2023-09-01 16:00:00+08,1,10,11,144572,998355,1142927,104.22,225.39,329.61
2023-09-01 20:00:00+08,1,12,13,144572,1116264,1260836,108.21,270.22,378.43
2023-09-02 00:00:00+08,1,12,13,144572,1107978,1252550,112.21,274.12,386.33
2023-09-02 04:00:00+08,1,10,11,144572,1009673,1154245,116.21,257.77,373.98
2023-09-02 08:00:00+08,1,10,11,144572,1255637,1400209,120.21,239.03,359.24
2023-09-02 12:00:00+08,1,10,11,144572,1255637,1400209,124.21,279.03,403.24
2023-09-02 16:00:00+08,1,10,11,144572,1255637,1400209,128.21,319.03,447.24
2023-09-02 20:00:00+08,0,9,9,0,950804,950804,11.12,186.57,197.69
2023-09-03 00:00:00+08,0,8,8,0,872858,872858,0,185.32,185.32
2023-09-03 04:00:00+08,0,9,9,0,1017430,1017430,74.65,220.9,295.55
2023-09-03 08:00:00+08,0,9,9,0,1017430,1017430,74.65,256.9,331.55
2023-09-03 12:00:00+08,0,7,7,0,827622,827622,74.64,194.26,268.9
2023-09-03 16:00:00+08,0,7,7,0,827622,827622,74.64,222.26,296.9
2023-09-03 20:00:00+08,0,7,7,0,856185,856185,74.64,168.36,243
2023-09-04 00:00:00+08,0,8,8,0,937538,937538,74.64,198.63,273.27
2023-09-04 04:00:00+08,0,8,8,0,937538,937538,74.64,230.63,305.27
2023-09-04 08:00:00+08,0,6,6,0,721032,721032,74.64,169.9,244.54
2023-09-04 12:00:00+08,0,6,6,0,721032,721032,74.64,193.9,268.54
2023-09-04 16:00:00+08,0,5,5,0,639679,639679,74.64,199.64,274.28
2023-09-04 20:00:00+08,0,3,3,0,432038,432038,0,149.91,149.91
2023-09-05 00:00:00+08,0,3,3,0,432038,432038,0,161.91,161.91
2023-09-05 04:00:00+08,0,3,3,0,432038,432038,0,173.91,173.91
2023-09-05 08:00:00+08,0,3,3,0,432038,432038,0,185.91,185.91
2023-09-05 12:00:00+08,0,3,3,0,432038,432038,0,197.91,197.91
2023-09-05 16:00:00+08,0,3,3,0,432038,432038,0,209.91,209.91
2023-09-05 20:00:00+08,0,10,10,0,1069821,1069821,0,232.95,232.95
2023-09-06 00:00:00+08,0,11,11,0,1164421,1164421,0,274.1,274.1
2023-09-06 04:00:00+08,0,11,11,0,1164421,1164421,0,318.1,318.1
2023-09-06 08:00:00+08,0,11,11,0,1051996,1051996,0,264.38,264.38
2023-09-06 12:00:00+08,0,11,11,0,1165790,1165790,0,293.89,293.89
2023-09-06 16:00:00+08,1,9,10,50716,994811,1045527,3.83,295.23,299.06
2023-09-06 20:00:00+08,1,13,14,50716,1115115,1165831,7.83,314.38,322.21
2023-09-07 00:00:00+08,1,13,14,50716,1115115,1165831,11.83,366.38,378.21
2023-09-07 04:00:00+08,0,12,12,0,975780,975780,0,300.72,300.72
2023-09-07 08:00:00+08,0,9,9,0,673555,673555,17.42,189.04,206.46
2023-09-07 12:00:00+08,0,7,7,0,477875,477875,17.42,123.4,140.82
2023-09-07 16:00:00+08,0,5,5,0,426227,426227,17.42,107.82,125.24
2023-09-07 20:00:00+08,0,5,5,0,423634,423634,17.43,63.83,81.26
2023-09-08 00:00:00+08,0,7,7,0,589920,589920,17.43,76.58,94.01
2023-09-08 04:00:00+08,0,8,8,0,596804,596804,17.43,107.64,125.07
2023-09-08 08:00:00+08,0,9,9,0,707437,707437,17.43,140.56,157.99
2023-09-08 12:00:00+08,0,8,8,0,725768,725768,0,130.91,130.91
2023-09-08 16:00:00+08,0,6,6,0,638955,638955,0,126.68,126.68
2023-09-08 20:00:00+08,0,8,8,0,821169,821169,0,155.43,155.43
2023-09-09 00:00:00+08,0,10,10,0,1023059,1023059,0,190.04,190.04
2023-09-09 04:00:00+08,0,10,10,0,1023059,1023059,0,230.04,230.04
2023-09-09 08:00:00+08,0,10,10,0,1048525,1048525,0,242.06,242.06
2023-09-09 12:00:00+08,0,10,10,0,1048525,1048525,0,282.06,282.06
2023-09-09 16:00:00+08,0,7,7,0,725294,725294,0,172.8,172.8
2023-09-09 20:00:00+08,0,8,8,0,868027,868027,0,165.52,165.52
2023-09-10 00:00:00+08,0,9,9,0,973521,973521,0,111.49,111.49
2023-09-10 04:00:00+08,0,9,9,0,973521,973521,0,147.49,147.49
2023-09-10 08:00:00+08,0,9,9,0,973521,973521,0,183.49,183.49
2023-09-10 12:00:00+08,0,8,8,0,915691,915691,0,183.25,183.25
2023-09-10 16:00:00+08,0,6,6,0,778334,778334,0,162.81,162.81
2023-09-10 20:00:00+08,0,6,6,0,689491,689491,0,120.06,120.06
2023-09-11 00:00:00+08,0,7,7,0,715004,715004,0,91.97,91.97
2023-09-11 04:00:00+08,0,7,7,0,715004,715004,0,119.97,119.97
2023-09-11 08:00:00+08,0,7,7,0,715004,715004,0,147.97,147.97
2023-09-11 12:00:00+08,0,4,4,0,398289,398289,0,102.65,102.65
2023-09-11 16:00:00+08,0,3,3,0,347514,347514,0,101.82,101.82
2023-09-11 20:00:00+08,0,7,7,0,783793,783793,0,119.98,119.98
2023-09-12 00:00:00+08,0,7,7,0,783793,783793,0,147.98,147.98
2023-09-12 04:00:00+08,0,8,8,0,889338,889338,0,176.14,176.14
2023-09-12 08:00:00+08,0,9,9,0,837265,837265,0,155.72,155.72
2023-09-12 12:00:00+08,0,9,9,0,892415,892415,0,177.33,177.33
2023-09-12 16:00:00+08,0,8,8,0,747044,747044,0,123.84,123.84
2023-09-12 20:00:00+08,0,6,6,0,618461,618461,0,96.93,96.93
2023-09-13 00:00:00+08,0,7,7,0,753120,753120,0,103.4,103.4
2023-09-13 04:00:00+08,0,7,7,0,753120,753120,0,131.4,131.4
2023-09-13 08:00:00+08,0,7,7,0,678417,678417,0,95.25,95.25
2023-09-13 12:00:00+08,0,6,6,0,593712,593712,0,102.5,102.5
2023-09-13 16:00:00+08,0,5,5,0,436636,436636,0,81.85,81.85
2023-09-13 20:00:00+08,0,7,7,0,632952,632952,0,107.16,107.16
2023-09-14 00:00:00+08,0,8,8,0,780214,780214,0,113.18,113.18
2023-09-14 04:00:00+08,0,9,9,0,907272,907272,0,148.9,148.9
2023-09-14 08:00:00+08,0,9,9,0,907272,907272,0,184.9,184.9
2023-09-14 12:00:00+08,0,7,7,0,804793,804793,0,178.99,178.99
2023-09-14 16:00:00+08,0,5,5,0,589869,589869,0,112.01,112.01
2023-09-14 20:00:00+08,0,8,8,0,728409,728409,0,137.06,137.06
2023-09-15 00:00:00+08,0,10,10,0,845293,845293,0,171.87,171.87
2023-09-15 04:00:00+08,0,9,9,0,704628,704628,0,144.31,144.31
2023-09-15 08:00:00+08,1,11,12,26811,940065,966876,3.07,186.11,189.18
2023-09-15 12:00:00+08,1,8,9,26811,801525,828336,7.09,177.06,184.15
2023-09-15 16:00:00+08,0,8,8,0,801525,801525,0,209.06,209.06
2023-09-15 20:00:00+08,0,10,10,0,857245,857245,12.6,218.87,231.47
2023-09-16 00:00:00+08,0,8,8,0,613336,613336,12.6,156.4,169
2023-09-16 04:00:00+08,0,9,9,0,726408,726408,12.6,192.22,204.82
2023-09-16 08:00:00+08,0,10,10,0,856981,856981,12.6,230.87,243.47
2023-09-16 12:00:00+08,0,7,7,0,479806,479806,12.6,140.49,153.09
2023-09-16 16:00:00+08,0,6,6,0,370979,370979,12.6,133.77,146.37
2023-09-16 20:00:00+08,0,7,7,0,718340,718340,0,69.32,69.32
2023-09-17 00:00:00+08,0,7,7,0,718340,718340,0,97.32,97.32
2023-09-17 04:00:00+08,0,7,7,0,718340,718340,0,125.32,125.32
2023-09-17 08:00:00+08,0,7,7,0,801531,801531,0,140.86,140.86
2023-09-17 12:00:00+08,0,6,6,0,670958,670958,0,138.21,138.21
2023-09-17 16:00:00+08,0,5,5,0,629375,629375,0,116.14,116.14
2023-09-17 20:00:00+08,0,5,5,0,656912,656912,0,94.22,94.22
2023-09-18 00:00:00+08,0,5,5,0,669449,669449,0,86.74,86.74
2023-09-18 04:00:00+08,0,5,5,0,669449,669449,0,106.74,106.74
2023-09-18 08:00:00+08,0,5,5,0,669449,669449,0,126.74,126.74
2023-09-18 12:00:00+08,0,4,4,0,570383,570383,0,105.08,105.08
2023-09-18 16:00:00+08,0,4,4,0,570383,570383,0,121.08,121.08
2023-09-18 20:00:00+08,0,6,6,0,698060,698060,0,142.28,142.28
2023-09-19 00:00:00+08,0,8,8,0,854622,854622,0,171.27,171.27
2023-09-19 04:00:00+08,0,8,8,0,782060,782060,0,172.07,172.07
2023-09-19 08:00:00+08,0,8,8,0,782060,782060,0,204.07,204.07
2023-09-19 12:00:00+08,0,7,7,0,742001,742001,0,217.76,217.76
2023-09-19 16:00:00+08,0,4,4,0,403098,403098,0,98.19,98.19
2023-09-19 20:00:00+08,0,8,8,0,519103,519103,0,52.24,52.24
2023-09-20 00:00:00+08,1,11,12,146696,794562,941258,3.22,90.72,93.94
2023-09-20 04:00:00+08,1,11,12,146696,794562,941258,7.22,134.72,141.94
2023-09-20 08:00:00+08,1,12,13,146696,853415,1000111,11.22,169.41,180.63
2023-09-20 12:00:00+08,1,8,9,146696,619144,765840,15.22,109.51,124.73
2023-09-20 16:00:00+08,1,7,8,146696,568455,715151,19.22,124.01,143.23
2023-09-20 20:00:00+08,1,7,8,146696,651867,798563,23.22,95.57,118.79
2023-09-21 00:00:00+08,1,10,11,146696,847015,993711,27.22,97.03,124.25
2023-09-21 04:00:00+08,1,10,11,146696,847015,993711,31.22,137.03,168.25
2023-09-21 08:00:00+08,1,12,13,146696,1103386,1250082,35.22,178.92,214.14
2023-09-21 12:00:00+08,2,10,12,189676,1000887,1190563,40.96,184.67,225.63
2023-09-21 16:00:00+08,2,9,11,189676,958785,1148461,48.94,202.51,251.45
2023-09-21 20:00:00+08,2,11,13,189676,987494,1177170,56.95,219.52,276.47
2023-09-22 00:00:00+08,2,12,14,189676,1000597,1190273,64.96,239.79,304.75
2023-09-22 04:00:00+08,2,11,13,189676,864903,1054579,72.96,230.37,303.33
2023-09-22 08:00:00+08,1,11,12,42980,847981,890961,21.74,239.47,261.21
2023-09-22 12:00:00+08,1,10,11,42980,810976,853956,86.96,203.49,290.45
2023-09-22 16:00:00+08,1,7,8,42980,680738,723718,90.96,162.93,253.89
2023-09-22 20:00:00+08,1,8,9,42980,650110,693090,94.96,132.31,227.27
2023-09-23 00:00:00+08,2,8,10,152948,671885,824833,102.61,116.05,218.66
2023-09-23 04:00:00+08,2,8,10,152948,623279,776227,110.6,104.76,215.36
2023-09-23 08:00:00+08,2,8,10,152948,623279,776227,118.6,136.76,255.36
2023-09-23 12:00:00+08,2,6,8,152948,475391,628339,126.61,134.61,261.22
2023-09-23 16:00:00+08,2,8,10,152948,753398,906346,134.62,128.26,262.88
2023-09-23 20:00:00+08,2,9,11,152948,948220,1101168,142.63,137.69,280.32
2023-09-24 00:00:00+08,1,10,11,42980,1013209,1056189,122.96,174.69,297.65
2023-09-24 04:00:00+08,1,10,11,42980,1100863,1143843,157.16,163.93,321.09
2023-09-24 08:00:00+08,1,10,11,42980,1100863,1143843,161.16,203.93,365.09
2023-09-24 12:00:00+08,1,10,11,42980,1100863,1143843,165.16,243.93,409.09
2023-09-24 16:00:00+08,1,10,11,42980,1100863,1143843,169.16,283.93,453.09
2023-09-24 20:00:00+08,1,8,9,42980,880330,923310,173.16,265.86,439.02
2023-09-25 00:00:00+08,1,7,8,42980,763890,806870,177.17,249.25,426.42
2023-09-25 04:00:00+08,1,6,7,42980,698901,741881,181.17,248.25,429.42
2023-09-25 08:00:00+08,1,7,8,42980,779443,822423,123.94,208,331.94
2023-09-25 12:00:00+08,1,7,8,42980,779443,822423,127.94,236,363.94
2023-09-25 16:00:00+08,1,8,9,42980,925380,968360,131.94,267.07,399.01
2023-09-25 20:00:00+08,1,10,11,42980,965203,1008183,135.94,301.87,437.81
2023-09-26 00:00:00+08,2,9,11,189403,848271,1037674,143.09,285.06,428.15
2023-09-26 04:00:00+08,2,10,12,189403,967451,1156854,151.09,324.07,475.16
2023-09-26 08:00:00+08,2,11,13,189403,997640,1187043,159.09,366.55,525.64
2023-09-26 12:00:00+08,2,10,12,185031,892790,1077821,154.8,330.66,485.46
2023-09-26 16:00:00+08,2,8,10,185031,837805,1022836,162.81,304.18,466.99
2023-09-26 20:00:00+08,2,11,13,185031,1109509,1294540,162.06,278.06,440.12
2023-09-27 00:00:00+08,2,12,14,185031,1213200,1398231,170.06,323.64,493.7
2023-09-27 04:00:00+08,2,12,14,185031,1213200,1398231,178.06,371.64,549.7
2023-09-27 08:00:00+08,3,12,15,253394,1195619,1449013,187.28,397.79,585.07
2023-09-27 12:00:00+08,3,13,16,253394,1237720,1491114,199.27,448.79,648.06
2023-09-27 16:00:00+08,4,9,13,392729,824763,1217492,214.7,321.23,535.93
2023-09-27 20:00:00+08,5,10,15,472132,902751,1374883,231.79,270.86,502.65
2023-09-28 00:00:00+08,4,10,14,403769,902751,1306520,234.56,310.86,545.42
2023-09-28 04:00:00+08,4,11,15,403769,846590,1250359,271.03,289.1,560.13
2023-09-28 08:00:00+08,3,10,13,264434,693516,957950,267.63,238.07,505.7
2023-09-28 12:00:00+08,3,11,14,264434,832851,1097285,300.47,280.65,581.12
2023-09-28 16:00:00+08,3,8,11,264434,681466,945900,291.96,276.2,568.16
2023-09-28 20:00:00+08,3,11,14,264434,877568,1142002,303.95,289.38,593.33
2023-09-29 00:00:00+08,3,10,13,264434,852330,1116764,315.95,327.88,643.83
2023-09-29 04:00:00+08,4,9,13,368428,788920,1157348,331.88,346.97,678.85
2023-09-29 08:00:00+08,3,9,12,289025,782290,1071315,310.83,339.03,649.86
2023-09-29 12:00:00+08,3,9,12,289025,799706,1088731,363.57,357.22,720.79
2023-09-29 16:00:00+08,2,7,9,185031,581992,767023,338.21,301.66,639.87
2023-09-29 20:00:00+08,1,10,11,142051,832864,974915,163.29,275.19,438.48
2023-09-30 00:00:00+08,1,11,12,142051,882999,1025050,372.21,287.24,659.45
2023-09-30 04:00:00+08,1,11,12,142051,882999,1025050,376.21,331.24,707.45
2023-09-30 08:00:00+08,1,11,12,142051,882999,1025050,380.21,375.24,755.45
2023-09-30 12:00:00+08,1,8,9,142051,728416,870467,384.18,329.88,714.06
2023-09-30 16:00:00+08,0,7,7,0,649013,649013,244.53,333.55,578.08
2023-09-30 20:00:00+08,0,11,11,0,934911,934911,328.58,311.39,639.97
2023-10-01 00:00:00+08,0,9,9,0,841062,841062,123.68,300.3,423.98
2023-10-01 04:00:00+08,1,10,11,37929,1017753,1055682,125.6,331.37,456.97
2023-10-01 08:00:00+08,2,9,11,180021,983670,1163691,130.33,357.22,487.55
2023-10-01 12:00:00+08,1,8,9,142092,879676,1021768,109.58,352.1,461.68
2023-10-01 16:00:00+08,1,6,7,142092,618530,760622,113.58,298.8,412.38
2023-10-01 20:00:00+08,1,10,11,142092,946620,1088712,134.41,306.96,441.37
2023-10-02 00:00:00+08,1,10,11,142092,1019869,1161961,138.41,325.29,463.7
2023-10-02 04:00:00+08,1,11,12,142092,1070697,1212789,142.41,365.69,508.1
2023-10-02 08:00:00+08,2,11,13,281427,1070697,1352124,148.46,409.69,558.15
2023-10-02 12:00:00+08,2,9,11,281427,998359,1279786,139.64,418.77,558.41
2023-10-02 16:00:00+08,2,8,10,281427,884470,1165897,147.64,409.94,557.58
2023-10-02 20:00:00+08,2,8,10,281427,761369,1042796,155.61,403.61,559.22
2023-10-03 00:00:00+08,2,9,11,281427,948519,1229946,163.61,417.27,580.88
2023-10-03 04:00:00+08,3,10,13,400315,998482,1398797,174.26,453.44,627.7
2023-10-03 08:00:00+08,3,9,12,400315,961548,1361863,186.26,235.71,421.97
2023-10-03 12:00:00+08,2,8,10,260980,821307,1082287,168.24,227.79,396.03
2023-10-03 16:00:00+08,2,5,7,260980,574067,835047,103.8,94.52,198.32
2023-10-03 20:00:00+08,2,7,9,260980,775071,1036051,111.8,97.34,209.14
2023-10-04 00:00:00+08,2,6,8,260980,628280,889260,119.8,70.68,190.48
2023-10-04 04:00:00+08,2,7,9,260980,722654,983634,127.81,98.66,226.47
2023-10-04 08:00:00+08,2,6,8,260980,672691,933671,135.81,98.49,234.3
2023-10-04 12:00:00+08,1,6,7,142092,622222,764314,109.16,105.95,215.11
2023-10-04 16:00:00+08,1,5,6,142092,434597,576689,113.16,89.63,202.79
2023-10-04 20:00:00+08,1,10,11,142092,967969,1110061,158.07,119.89,277.96
2023-10-05 00:00:00+08,1,10,11,142092,967969,1110061,162.07,159.89,321.96
2023-10-05 04:00:00+08,1,9,10,142092,864402,1006494,166.04,166.24,332.28
2023-10-05 08:00:00+08,2,9,11,243809,864402,1108211,173.16,202.24,375.4
2023-10-05 12:00:00+08,2,6,8,243809,695968,939777,181.16,152.8,333.96
2023-10-05 16:00:00+08,1,5,6,142092,616565,758657,178.04,154.81,332.85
2023-10-05 20:00:00+08,1,9,10,142092,900398,1042490,195.91,138.66,334.57
2023-10-06 00:00:00+08,0,9,9,0,846953,846953,54.75,120.59,175.34
2023-10-06 04:00:00+08,0,9,9,0,846953,846953,54.75,156.59,211.34
2023-10-06 08:00:00+08,0,8,8,0,919311,919311,172.08,167.91,339.99
2023-10-06 12:00:00+08,1,8,9,26811,874139,900950,174.32,185.92,360.24
2023-10-06 16:00:00+08,2,8,10,89961,874139,964100,180.12,217.92,398.04
2023-10-06 20:00:00+08,2,8,10,89961,874139,964100,188.12,249.92,438.04
2023-10-07 00:00:00+08,2,8,10,89961,874139,964100,196.12,281.92,478.04
2023-10-07 04:00:00+08,3,4,7,231984,316739,548723,151.36,77.48,228.84
2023-10-07 08:00:00+08,3,10,13,231984,909467,1141451,163.37,106.91,270.28
2023-10-07 12:00:00+08,3,10,13,231984,1010933,1242917,175.39,122.15,297.54
2023-10-07 16:00:00+08,2,11,13,205173,1052523,1257696,157.14,164.32,321.46
2023-10-07 20:00:00+08,5,12,17,494804,1079334,1574138,201.09,211.31,412.4
2023-10-08 00:00:00+08,5,14,19,494804,1206684,1701488,221.03,261.72,482.75
2023-10-08 04:00:00+08,3,12,15,378871,1142872,1521743,191.28,268.13,459.41
2023-10-08 08:00:00+08,2,11,13,255912,1125565,1381477,244.73,265.83,510.56
2023-10-08 12:00:00+08,2,11,13,255912,1093824,1349736,265.24,248.89,514.13
2023-10-08 16:00:00+08,1,10,11,142023,990963,1132986,253.02,258.98,512
2023-10-08 20:00:00+08,1,8,9,142023,908352,1050375,187.33,224.52,411.85
2023-10-09 00:00:00+08,1,8,9,142023,895165,1037188,217.78,216.91,434.69
2023-10-09 04:00:00+08,1,6,7,142023,657576,799599,221.78,157.95,379.73
2023-10-09 08:00:00+08,2,6,8,281358,657576,938934,228.56,181.95,410.51
2023-10-09 12:00:00+08,2,4,6,281358,494640,775998,221.01,139.98,360.99
2023-10-09 16:00:00+08,1,3,4,142023,352548,494571,100.89,72.57,173.46
2023-10-09 20:00:00+08,1,5,6,142023,517903,659926,118.95,87.14,206.09
2023-10-10 00:00:00+08,1,7,8,142023,639453,781476,122.95,108.54,231.49
2023-10-10 04:00:00+08,1,9,10,142023,848167,990190,126.96,143.17,270.13
2023-10-10 08:00:00+08,1,10,11,142023,875141,1017164,130.96,181.25,312.21
2023-10-10 12:00:00+08,1,7,8,142023,612273,754296,96.08,113.61,209.69
2023-10-10 16:00:00+08,1,6,7,142023,496573,638596,100.08,94.86,194.94
2023-10-10 20:00:00+08,1,7,8,142023,684938,826961,104.08,82.43,186.51
2023-10-11 00:00:00+08,1,9,10,142023,932431,1074454,108.1,73.8,181.9
2023-10-11 04:00:00+08,1,10,11,142023,1027060,1169083,112.1,113.55,225.65
2023-10-11 08:00:00+08,1,10,11,142023,1027060,1169083,116.1,153.55,269.65
2023-10-11 12:00:00+08,1,11,12,142023,1061764,1203787,120.1,195.2,315.3
2023-10-11 16:00:00+08,1,10,11,142023,1021286,1163309,124.1,222.29,346.39
2023-10-11 20:00:00+08,1,9,10,142023,926230,1068253,128.1,195.92,324.02
2023-10-12 00:00:00+08,1,10,11,142023,993500,1135523,132.1,232.34,364.44
2023-10-12 04:00:00+08,1,10,11,142023,993500,1135523,136.1,272.34,408.44
2023-10-12 08:00:00+08,1,9,10,142023,1064697,1206720,140.1,275.99,416.09
2023-10-12 12:00:00+08,1,8,9,142023,933434,1075457,144.1,270.76,414.86
2023-10-12 16:00:00+08,1,6,7,142023,788052,930075,148.1,220.71,368.81
2023-10-12 20:00:00+08,1,10,11,142023,1093495,1235518,152.1,253.69,405.79
2023-10-13 00:00:00+08,1,11,12,142023,1107298,1249321,156.1,294.94,451.04
2023-10-13 04:00:00+08,1,12,13,142023,1114182,1256205,160.1,339.94,500.04
2023-10-13 08:00:00+08,1,11,12,142023,1034458,1176481,164.1,344.13,508.23
2023-10-13 12:00:00+08,0,8,8,0,739292,739292,0,203.27,203.27
2023-10-13 16:00:00+08,0,6,6,0,480434,480434,0,122.28,122.28
2023-10-13 20:00:00+08,1,10,11,65364,902073,967437,161.22,143.47,304.69
2023-10-14 00:00:00+08,1,10,11,65364,859064,924428,165.21,155.45,320.66
2023-10-14 04:00:00+08,1,10,11,65364,859064,924428,169.21,195.45,364.66
2023-10-14 08:00:00+08,1,9,10,65364,822074,887438,173.21,221.24,394.45
2023-10-14 12:00:00+08,1,7,8,65364,752196,817560,177.2,206.42,383.62
2023-10-14 16:00:00+08,1,5,6,65364,545044,610408,181.21,149,330.21
2023-10-14 20:00:00+08,1,6,7,65364,745388,810752,185.21,144.75,329.96
2023-10-15 00:00:00+08,1,6,7,65364,674717,740081,189.21,77.69,266.9
2023-10-15 04:00:00+08,1,5,6,65364,656399,721763,193.21,94.78,287.99
2023-10-15 08:00:00+08,2,6,8,210638,765129,975767,199.24,117.44,316.68
2023-10-15 12:00:00+08,2,6,8,210638,790276,1000914,207.25,127.29,334.54
2023-10-15 16:00:00+08,2,5,7,210638,673101,883739,215.25,105.8,321.05
2023-10-15 20:00:00+08,2,7,9,210638,868135,1078773,223.25,128.51,351.76
2023-10-16 00:00:00+08,2,8,10,210638,999382,1210020,231.25,157.42,388.67
2023-10-16 04:00:00+08,1,7,8,145274,870888,1016162,180.06,160.93,340.99
2023-10-16 08:00:00+08,1,8,9,145274,936252,1081526,245.68,190.5,436.18
2023-10-16 12:00:00+08,1,8,9,145274,936252,1081526,249.68,222.5,472.18
2023-10-16 16:00:00+08,1,7,8,145274,796106,941380,253.68,207.16,460.84
2023-10-16 20:00:00+08,0,6,6,0,692187,692187,0,123.75,123.75
2023-10-17 00:00:00+08,1,8,9,26650,985902,1012552,43.95,150.66,194.61
2023-10-17 04:00:00+08,1,7,8,26650,877172,903822,47.95,136.02,183.97
2023-10-17 08:00:00+08,2,10,12,107792,1016858,1124650,54.17,171.87,226.04
2023-10-17 12:00:00+08,2,7,9,107792,683972,791764,62.17,101.32,163.49
2023-10-17 16:00:00+08,1,6,7,81142,552725,633867,51.25,88.41,139.66
2023-10-17 20:00:00+08,1,9,10,81142,722500,803642,75.56,120,195.56
2023-10-18 00:00:00+08,1,10,11,81142,925932,1007074,79.55,139.08,218.63
2023-10-18 04:00:00+08,1,9,10,81142,875969,957111,83.55,156.45,240
2023-10-18 08:00:00+08,1,10,11,81142,970730,1051872,87.57,182.88,270.45
2023-10-18 12:00:00+08,1,8,9,81142,770214,851356,71.28,137.34,208.62
2023-10-18 16:00:00+08,1,7,8,81142,711864,793006,75.28,147.44,222.72
2023-10-18 20:00:00+08,1,9,10,81142,943847,1024989,79.26,131.42,210.68
2023-10-19 00:00:00+08,1,10,11,81142,1002047,1083189,83.26,168.24,251.5
2023-10-19 04:00:00+08,1,10,11,81142,1002047,1083189,87.26,208.24,295.5
2023-10-19 08:00:00+08,1,10,11,81142,1031427,1112569,91.26,221.3,312.56
2023-10-19 12:00:00+08,1,9,10,81142,997265,1078407,95.26,235.5,330.76
2023-10-19 16:00:00+08,1,8,9,81142,902604,983746,99.26,230.11,329.37
2023-10-19 20:00:00+08,0,11,11,0,1050234,1050234,0,176.24,176.24
2023-10-20 00:00:00+08,0,11,11,0,1073176,1073176,65.36,196.27,261.63
2023-10-20 04:00:00+08,0,13,13,0,1240272,1240272,65.36,246.08,311.44
2023-10-20 08:00:00+08,0,14,14,0,1247156,1247156,65.36,300.5,365.86
2023-10-20 12:00:00+08,0,12,12,0,1097343,1097343,65.36,322.27,387.63
2023-10-20 16:00:00+08,0,7,7,0,761640,761640,65.36,232.45,297.81
2023-10-20 20:00:00+08,0,7,7,0,609201,609201,0,131.01,131.01
2023-10-21 00:00:00+08,0,9,9,0,822758,822758,0,130.56,130.56
2023-10-21 04:00:00+08,0,9,9,0,822758,822758,0,166.56,166.56
2023-10-21 08:00:00+08,0,8,8,0,830522,830522,0,178.59,178.59
2023-10-21 12:00:00+08,0,7,7,0,823638,823638,0,180.18,180.18
2023-10-21 16:00:00+08,0,5,5,0,599948,599948,0,98.78,98.78
2023-10-21 20:00:00+08,0,8,8,0,841732,841732,0,104.34,104.34
2023-10-22 00:00:00+08,0,8,8,0,841732,841732,0,136.34,136.34
2023-10-22 04:00:00+08,1,6,7,72968,692942,765910,2.94,131.53,134.47
2023-10-22 08:00:00+08,1,5,6,72968,562487,635455,6.94,122.71,129.65
2023-10-22 12:00:00+08,1,5,6,72968,562487,635455,10.94,142.71,153.65
2023-10-22 16:00:00+08,1,5,6,72968,602539,675507,14.94,143.23,158.17
2023-10-22 20:00:00+08,1,6,7,72968,749130,822098,18.94,167.22,186.16
2023-10-23 00:00:00+08,1,7,8,72968,850887,923855,22.94,165.56,188.5
2023-10-23 04:00:00+08,1,6,7,72968,711958,784926,26.94,146.39,173.33
2023-10-23 08:00:00+08,1,5,6,72968,600344,673312,30.94,131.63,162.57
2023-10-23 12:00:00+08,1,5,6,72968,600344,673312,34.94,151.63,186.57
2023-10-23 16:00:00+08,0,4,4,0,549737,549737,0,155.47,155.47
2023-10-23 20:00:00+08,0,6,6,0,722273,722273,42.36,59.98,102.34
2023-10-24 00:00:00+08,0,7,7,0,908743,908743,42.36,84.55,126.91
2023-10-24 04:00:00+08,1,8,9,110387,1054426,1164813,42.45,116.43,158.88
2023-10-24 08:00:00+08,1,8,9,110387,1054426,1164813,46.45,148.43,194.88
2023-10-24 12:00:00+08,1,8,9,110387,1054426,1164813,50.45,180.43,230.88
2023-10-24 16:00:00+08,1,7,8,110387,1001643,1112030,54.45,189.68,244.13
2023-10-24 20:00:00+08,1,9,10,110387,1045803,1156190,16.09,197.49,213.58
2023-10-25 00:00:00+08,1,10,11,110387,1154102,1264489,20.09,236.15,256.24
2023-10-25 04:00:00+08,1,11,12,110387,1204915,1315302,24.09,276.74,300.83
2023-10-25 08:00:00+08,1,8,9,110387,867456,977843,28.09,183.76,211.85
2023-10-25 12:00:00+08,0,9,9,0,912650,912650,0,202.8,202.8
2023-10-25 16:00:00+08,0,9,9,0,836567,836567,35.93,198.38,234.31
2023-10-25 20:00:00+08,0,9,9,0,725561,725561,35.93,140.06,175.99
2023-10-26 00:00:00+08,0,11,11,0,850461,850461,35.94,180.29,216.23
2023-10-26 04:00:00+08,0,11,11,0,850461,850461,35.94,224.29,260.23
2023-10-26 08:00:00+08,0,9,9,0,786585,786585,35.94,226.63,262.57
2023-10-26 12:00:00+08,0,8,8,0,787638,787638,35.94,212.62,248.56
2023-10-26 16:00:00+08,1,7,8,145980,757403,903383,37.41,225.37,262.78
2023-10-26 20:00:00+08,1,9,10,145980,817861,963841,5.47,163.74,169.21
2023-10-27 00:00:00+08,1,10,11,145980,964075,1110055,9.49,202.49,211.98
2023-10-27 04:00:00+08,1,10,11,145980,910679,1056659,13.47,132.95,146.42
2023-10-27 08:00:00+08,1,10,11,145980,882795,1028775,17.47,161.91,179.38
2023-10-27 12:00:00+08,1,9,10,145980,809827,955807,21.47,159.83,181.3
2023-10-27 16:00:00+08,1,6,7,145980,576050,722030,25.47,121.05,146.52
2023-10-27 20:00:00+08,1,9,10,145980,788556,934536,29.47,152.25,181.72
2023-10-28 00:00:00+08,1,9,10,145980,821843,967823,33.47,140.43,173.9
2023-10-28 04:00:00+08,1,10,11,145980,965903,1111883,37.49,178.92,216.41
2023-10-28 08:00:00+08,1,11,12,145980,1074903,1220883,41.49,222.07,263.56
2023-10-28 12:00:00+08,1,11,12,145980,1110121,1256101,45.49,237.36,282.85
2023-10-28 16:00:00+08,1,8,9,145980,834428,980408,49.49,191.68,241.17
2023-10-28 20:00:00+08,1,9,10,145980,923210,1069190,53.49,202.57,256.06
2023-10-29 00:00:00+08,1,11,12,145980,1079681,1225661,57.49,243.75,301.24
2023-10-29 04:00:00+08,1,11,12,145980,1079681,1225661,61.49,287.75,349.24
2023-10-29 08:00:00+08,0,12,12,0,1022570,1022570,2.6,301.08,303.68
2023-10-29 12:00:00+08,0,9,9,0,819211,819211,2.6,282.82,285.42
2023-10-29 16:00:00+08,0,8,8,0,755816,755816,2.58,294.84,297.42
2023-10-29 20:00:00+08,0,5,5,0,446958,446958,0,204.25,204.25
2023-10-30 00:00:00+08,0,6,6,0,611448,611448,0,176.01,176.01
2023-10-30 04:00:00+08,1,5,6,13803,462398,476201,0.69,124.26,124.95
2023-10-30 08:00:00+08,1,7,8,13803,659094,672897,91.59,150.05,241.64
2023-10-30 12:00:00+08,1,6,7,13803,543101,556904,95.59,138.07,233.66
2023-10-30 16:00:00+08,0,4,4,0,368211,368211,86.9,125.53,212.43
2023-10-30 20:00:00+08,0,7,7,0,560222,560222,101.29,148.96,250.25
2023-10-31 00:00:00+08,0,9,9,0,824140,824140,101.29,179.1,280.39
2023-10-31 04:00:00+08,0,8,8,0,773424,773424,101.29,191.87,293.16
2023-10-31 08:00:00+08,1,9,10,145527,1013654,1159181,89.92,214.14,304.06
2023-10-31 12:00:00+08,1,9,10,145527,1013654,1159181,93.92,250.14,344.06
2023-10-31 16:00:00+08,1,7,8,145527,840946,986473,97.92,221.91,319.83
2023-10-31 20:00:00+08,1,11,12,145527,974540,1120067,101.92,257.87,359.79
2023-11-01 00:00:00+08,1,12,13,145527,1040423,1185950,105.92,274.17,380.09
2023-11-01 04:00:00+08,1,13,14,145527,1166949,1312476,109.92,325.75,435.67
2023-11-01 08:00:00+08,1,13,14,145527,1166949,1312476,113.92,377.75,491.67
2023-11-01 12:00:00+08,1,14,15,145527,1201653,1347180,117.92,430.99,548.91
2023-11-01 16:00:00+08,0,8,8,0,717263,717263,0,285.49,285.49
2023-11-01 20:00:00+08,0,10,10,0,882075,882075,38,238.84,276.84
2023-11-02 00:00:00+08,0,11,11,0,1035668,1035668,38.01,280.51,318.52
2023-11-02 04:00:00+08,0,11,11,0,1035668,1035668,38.01,324.51,362.52
2023-11-02 08:00:00+08,0,10,10,0,1008643,1008643,38.01,354.51,392.52
2023-11-02 12:00:00+08,0,9,9,0,973939,973939,38.01,369.27,407.28
2023-11-02 16:00:00+08,0,6,6,0,643887,643887,38.01,304.29,342.3
2023-11-02 20:00:00+08,0,9,9,0,928688,928688,38,332.79,370.79
2023-11-03 00:00:00+08,0,11,11,0,1089315,1089315,38,345.03,383.03
2023-11-03 04:00:00+08,0,11,11,0,1089315,1089315,38,389.03,427.03
2023-11-03 08:00:00+08,0,12,12,0,1233887,1233887,38,433.6,471.6
2023-11-03 12:00:00+08,0,12,12,0,1206314,1206314,38,465.17,503.17
2023-11-03 16:00:00+08,0,9,9,0,947213,947213,38,360.26,398.26
2023-11-03 20:00:00+08,0,9,9,0,768659,768659,38.01,307.92,345.93
2023-11-04 00:00:00+08,0,11,11,0,993622,993622,38.01,325.84,363.85
2023-11-04 04:00:00+08,0,12,12,0,1023816,1023816,38.01,372.55,410.56
2023-11-04 08:00:00+08,0,11,11,0,883207,883207,38,383.65,421.65
2023-11-04 12:00:00+08,0,8,8,0,823815,823815,38,373.86,411.86
2023-11-04 16:00:00+08,0,6,6,0,677065,677065,0,300.36,300.36
2023-11-04 20:00:00+08,0,8,8,0,853911,853911,0,327.44,327.44
2023-11-05 00:00:00+08,0,8,8,0,915914,915914,0,331.95,331.95
2023-11-05 04:00:00+08,0,7,7,0,811557,811557,0,335.2,335.2
2023-11-05 08:00:00+08,0,8,8,0,916988,916988,0,365.86,365.86
2023-11-05 12:00:00+08,1,7,8,190668,772416,963084,2.85,345.29,348.14
2023-11-05 16:00:00+08,1,8,9,190668,916559,1107227,6.85,376.12,382.97
2023-11-05 20:00:00+08,1,9,10,190668,934844,1125512,10.85,383.7,394.55
2023-11-06 00:00:00+08,1,9,10,190668,934844,1125512,14.85,419.7,434.55
2023-11-06 04:00:00+08,1,9,10,190668,903338,1094006,18.85,415.5,434.35
2023-11-06 08:00:00+08,0,9,9,0,978031,978031,0,407.16,407.16
2023-11-06 12:00:00+08,0,9,9,0,1012461,1012461,24.48,382.14,406.62
2023-11-06 16:00:00+08,0,7,7,0,856255,856255,24.48,367.59,392.07
2023-11-06 20:00:00+08,0,6,6,0,796632,796632,24.48,375.6,400.08
2023-11-07 00:00:00+08,0,7,7,0,902160,902160,24.48,399.67,424.15
2023-11-07 04:00:00+08,0,8,8,0,952954,952954,24.48,431.16,455.64
2023-11-07 08:00:00+08,0,9,9,0,1094882,1094882,24.48,199.07,223.55
2023-11-07 12:00:00+08,0,9,9,0,1094882,1094882,24.48,235.07,259.55
2023-11-07 16:00:00+08,0,9,9,0,1094882,1094882,24.48,271.07,295.55
2023-11-07 20:00:00+08,0,10,10,0,1044626,1044626,24.45,239.82,264.27
2023-11-08 00:00:00+08,0,8,8,0,741787,741787,0,198.67,198.67
2023-11-08 04:00:00+08,0,10,10,0,978896,978896,0,207.11,207.11
2023-11-08 08:00:00+08,0,9,9,0,873368,873368,0,215.03,215.03
2023-11-08 12:00:00+08,0,6,6,0,489035,489035,0,130.98,130.98
2023-11-08 16:00:00+08,0,4,4,0,397489,397489,0,104.48,104.48
2023-11-08 20:00:00+08,0,5,5,0,475658,475658,0,84.92,84.92
2023-11-09 00:00:00+08,0,6,6,0,546997,546997,0,108.83,108.83
2023-11-09 04:00:00+08,0,6,6,0,546997,546997,0,132.83,132.83
2023-11-09 08:00:00+08,0,5,5,0,533381,533381,0,132.59,132.59
2023-11-09 12:00:00+08,0,6,6,0,554794,554794,0,153.25,153.25
2023-11-09 16:00:00+08,0,6,6,0,554794,554794,0,177.25,177.25
2023-11-09 20:00:00+08,0,9,9,0,681457,681457,0,181.19,181.19
2023-11-10 00:00:00+08,0,7,7,0,592404,592404,0,186.39,186.39
2023-11-10 04:00:00+08,0,11,11,0,845976,845976,0,227.46,227.46
2023-11-10 08:00:00+08,1,13,14,67515,1040426,1107941,1.47,274.84,276.31
2023-11-10 12:00:00+08,1,10,11,67515,844180,911695,5.46,257.92,263.38
2023-11-10 16:00:00+08,0,7,7,0,630021,630021,0,193.36,193.36
2023-11-10 20:00:00+08,0,11,11,0,972096,972096,12.8,226.14,238.94
2023-11-11 00:00:00+08,0,10,10,0,832761,832761,12.8,155.23,168.03
2023-11-11 04:00:00+08,0,10,10,0,832761,832761,12.8,195.23,208.03
2023-11-11 08:00:00+08,0,9,9,0,764859,764859,12.84,198.4,211.24
2023-11-11 12:00:00+08,0,7,7,0,690460,690460,0,182.77,182.77
2023-11-11 16:00:00+08,0,4,4,0,391685,391685,0,128.36,128.36
2023-11-11 20:00:00+08,0,4,4,0,405739,405739,0,69.88,69.88
2023-11-12 00:00:00+08,0,5,5,0,452543,452543,0,45.52,45.52
2023-11-12 04:00:00+08,0,6,6,0,560521,560521,0,68.91,68.91
2023-11-12 08:00:00+08,0,5,5,0,542304,542304,0,81.27,81.27
2023-11-12 12:00:00+08,0,4,4,0,439443,439443,0,59.78,59.78
2023-11-12 16:00:00+08,0,4,4,0,439443,439443,0,75.78,75.78
2023-11-12 20:00:00+08,0,4,4,0,497806,497806,0,69.27,69.27
2023-11-13 00:00:00+08,0,7,7,0,924075,924075,0,92.92,92.92
2023-11-13 04:00:00+08,0,7,7,0,924075,924075,0,120.92,120.92
2023-11-13 08:00:00+08,0,7,7,0,924075,924075,0,148.92,148.92
2023-11-13 12:00:00+08,0,7,7,0,924075,924075,0,176.92,176.92
2023-11-13 16:00:00+08,0,5,5,0,693136,693136,0,122.03,122.03
2023-11-13 20:00:00+08,0,4,4,0,536961,536961,0,93.7,93.7
2023-11-14 00:00:00+08,0,4,4,0,536961,536961,0,109.7,109.7
2023-11-14 04:00:00+08,0,5,5,0,656055,656055,0,129.11,129.11
2023-11-14 08:00:00+08,0,7,7,0,750507,750507,0,152.26,152.26
2023-11-14 12:00:00+08,0,7,7,0,749815,749815,0,138.44,138.44
2023-11-14 16:00:00+08,0,7,7,0,749815,749815,0,166.44,166.44
2023-11-14 20:00:00+08,0,8,8,0,814662,814662,0,196.17,196.17
2023-11-15 00:00:00+08,0,9,9,0,828422,828422,0,228.25,228.25
2023-11-15 04:00:00+08,0,8,8,0,806952,806952,0,242.93,242.93
2023-11-15 08:00:00+08,0,8,8,0,806952,806952,0,274.93,274.93
2023-11-15 12:00:00+08,0,6,6,0,508553,508553,0,178.4,178.4
2023-11-15 16:00:00+08,0,4,4,0,429946,429946,0,164.59,164.59
2023-11-15 20:00:00+08,0,5,5,0,387115,387115,0,83.59,83.59
2023-11-16 00:00:00+08,0,5,5,0,387115,387115,0,103.59,103.59
2023-11-16 04:00:00+08,0,7,7,0,631123,631123,0,130.91,130.91
2023-11-16 08:00:00+08,0,9,9,0,765902,765902,0,149.98,149.98
2023-11-16 12:00:00+08,0,8,8,0,678284,678284,0,168.08,168.08
2023-11-16 16:00:00+08,0,7,7,0,643970,643970,0,171.36,171.36
2023-11-16 20:00:00+08,0,10,10,0,708270,708270,0,82.96,82.96
2023-11-17 00:00:00+08,0,10,10,0,708270,708270,0,122.96,122.96
2023-11-17 04:00:00+08,0,11,11,0,812667,812667,0,166.47,166.47
2023-11-17 08:00:00+08,0,11,11,0,812667,812667,0,210.47,210.47
2023-11-17 12:00:00+08,0,8,8,0,541201,541201,0,144.22,144.22
2023-11-17 16:00:00+08,0,4,4,0,345146,345146,0,79.69,79.69
2023-11-17 20:00:00+08,0,8,8,0,582103,582103,0,59.9,59.9
2023-11-18 00:00:00+08,0,9,9,0,698100,698100,0,94.31,94.31
2023-11-18 04:00:00+08,0,9,9,0,698100,698100,0,130.31,130.31
2023-11-18 08:00:00+08,0,8,8,0,662655,662655,0,153.17,153.17
2023-11-18 12:00:00+08,0,4,4,0,369452,369452,0,67.37,67.37
2023-11-18 16:00:00+08,0,4,4,0,409374,409374,0,62.71,62.71
2023-11-18 20:00:00+08,0,5,5,0,504683,504683,0,55.41,55.41
2023-11-19 00:00:00+08,0,5,5,0,538662,538662,0,49.43,49.43
2023-11-19 04:00:00+08,0,6,6,0,481452,481452,0,43.5,43.5
2023-11-19 08:00:00+08,0,8,8,0,701804,701804,0,70.16,70.16
2023-11-19 12:00:00+08,0,7,7,0,684607,684607,0,92.51,92.51
2023-11-19 16:00:00+08,0,5,5,0,579617,579617,0,84.71,84.71
2023-11-19 20:00:00+08,0,5,5,0,579617,579617,0,104.71,104.71
2023-11-20 00:00:00+08,0,5,5,0,579617,579617,0,124.71,124.71
2023-11-20 04:00:00+08,0,5,5,0,579617,579617,0,144.71,144.71
2023-11-20 08:00:00+08,0,4,4,0,486072,486072,0,128.24,128.24
2023-11-20 12:00:00+08,0,4,4,0,486072,486072,0,144.24,144.24
2023-11-20 16:00:00+08,0,3,3,0,378306,378306,0,85.07,85.07
2023-11-20 20:00:00+08,0,4,4,0,477080,477080,0,97.79,97.79
2023-11-21 00:00:00+08,0,5,5,0,617321,617321,0,116.54,116.54
2023-11-21 04:00:00+08,0,5,5,0,606783,606783,0,92.44,92.44
2023-11-21 08:00:00+08,0,5,5,0,606783,606783,0,112.44,112.44
2023-11-21 12:00:00+08,0,5,5,0,606783,606783,0,132.44,132.44
2023-11-21 16:00:00+08,0,5,5,0,606783,606783,0,152.44,152.44
2023-11-21 20:00:00+08,0,8,8,0,752148,752148,0,96.58,96.58
2023-11-22 00:00:00+08,0,8,8,0,752148,752148,0,128.58,128.58
2023-11-22 04:00:00+08,0,7,7,0,636448,636448,0,122.52,122.52
2023-11-22 08:00:00+08,0,6,6,0,609501,609501,0,138.44,138.44
2023-11-22 12:00:00+08,0,4,4,0,335392,335392,0,77.86,77.86
2023-11-22 16:00:00+08,0,4,4,0,335392,335392,0,93.86,93.86
2023-11-22 20:00:00+08,1,4,5,107492,335392,442884,3.44,109.86,113.3
2023-11-23 00:00:00+08,0,4,4,0,335392,335392,0,125.86,125.86
2023-11-23 04:00:00+08,0,3,3,0,268091,268091,5.63,53.05,58.68
2023-11-23 08:00:00+08,0,8,8,0,723595,723595,24.77,79.49,104.26
2023-11-23 12:00:00+08,0,7,7,0,688891,688891,24.77,83.83,108.6
2023-11-23 16:00:00+08,0,7,7,0,674681,674681,19.14,103.34,122.48
2023-11-23 20:00:00+08,0,7,7,0,674681,674681,19.14,131.34,150.48
2023-11-24 00:00:00+08,0,7,7,0,674681,674681,19.14,159.34,178.48
2023-11-24 04:00:00+08,0,7,7,0,674681,674681,19.14,187.34,206.48
2023-11-24 08:00:00+08,0,7,7,0,674681,674681,19.14,215.34,234.48
2023-11-24 12:00:00+08,0,8,8,0,865349,865349,19.14,243.4,262.54
2023-11-24 16:00:00+08,1,9,10,113964,953186,1067150,21.3,278.46,299.76
2023-11-24 20:00:00+08,1,12,13,113964,1124313,1238277,25.3,318.12,343.42
2023-11-25 00:00:00+08,2,14,16,165707,1166157,1331864,32.86,369.62,402.48
2023-11-25 04:00:00+08,2,12,14,165707,1047958,1213665,40.86,338.54,379.4
2023-11-25 08:00:00+08,1,13,14,51743,1079953,1131696,19.02,326.59,345.61
2023-11-25 12:00:00+08,1,13,14,51743,1208553,1260296,43.84,219.21,263.05
2023-11-25 16:00:00+08,0,12,12,0,1104862,1104862,20.84,212.46,233.3
2023-11-25 20:00:00+08,0,11,11,0,1017097,1017097,43.2,205.48,248.68
2023-11-26 00:00:00+08,0,13,13,0,1223893,1223893,43.25,237.91,281.16
2023-11-26 04:00:00+08,0,12,12,0,1158325,1158325,43.25,237.4,280.65
2023-11-26 08:00:00+08,2,13,15,242069,1192408,1434477,50.37,289.39,339.76
2023-11-26 12:00:00+08,2,12,14,242069,1165597,1407666,58.37,312.83,371.2
2023-11-26 16:00:00+08,1,7,8,130455,729766,860221,11.31,183.06,194.37
2023-11-26 20:00:00+08,0,5,5,0,527610,527610,14.67,98.5,113.17
2023-11-27 00:00:00+08,0,7,7,0,713534,713534,14.67,82.66,97.33
2023-11-27 04:00:00+08,0,8,8,0,843989,843989,34.64,113.99,148.63
2023-11-27 08:00:00+08,0,8,8,0,843989,843989,34.64,145.99,180.63
2023-11-27 12:00:00+08,0,8,8,0,843989,843989,34.64,177.99,212.63
2023-11-27 16:00:00+08,0,6,6,0,673429,673429,34.65,145.51,180.16
2023-11-27 20:00:00+08,0,8,8,0,916182,916182,34.65,151.9,186.55
2023-11-28 00:00:00+08,0,8,8,0,916182,916182,34.65,183.9,218.55
2023-11-28 04:00:00+08,0,8,8,0,916182,916182,34.65,215.9,250.55
2023-11-28 08:00:00+08,0,10,10,0,1096718,1096718,34.68,252.56,287.24
2023-11-28 12:00:00+08,0,10,10,0,1087517,1087517,34.68,218.18,252.86
2023-11-28 16:00:00+08,0,9,9,0,1048434,1048434,34.68,237.27,271.95
2023-11-28 20:00:00+08,0,11,11,0,1194748,1194748,34.68,276.92,311.6
2023-11-29 00:00:00+08,0,10,10,0,1064293,1064293,14.65,273.63,288.28
2023-11-29 04:00:00+08,0,10,10,0,1064293,1064293,14.65,313.63,328.28
2023-11-29 08:00:00+08,0,9,9,0,833000,833000,14.68,223.61,238.29
2023-11-29 12:00:00+08,0,10,10,0,846720,846720,14.67,201.69,216.36
2023-11-29 16:00:00+08,0,8,8,0,588732,588732,0,107.31,107.31
2023-11-29 20:00:00+08,0,8,8,0,732062,732062,0,82.8,82.8
2023-11-30 00:00:00+08,1,9,10,142148,891676,1033824,3.06,116.86,119.92
2023-11-30 04:00:00+08,1,11,12,142148,1095298,1237446,7.06,160.47,167.53
2023-11-30 08:00:00+08,1,11,12,142148,1095298,1237446,11.06,204.47,215.53
2023-11-30 12:00:00+08,1,9,10,142148,972226,1114374,15.06,191.73,206.79
2023-11-30 16:00:00+08,1,10,11,142148,1066891,1209039,19.06,229.55,248.61
2023-11-30 20:00:00+08,1,10,11,142148,1016518,1158666,23.06,210.64,233.7
2023-12-01 00:00:00+08,1,10,11,142148,1016518,1158666,27.06,250.64,277.7
2023-12-01 04:00:00+08,2,9,11,155908,865344,1021252,33.97,202,235.97
2023-12-01 08:00:00+08,2,7,9,155908,699079,854987,41.98,193.61,235.59
2023-12-01 12:00:00+08,1,5,6,13760,511179,524939,10.92,131.61,142.53
2023-12-01 16:00:00+08,1,5,6,13760,591340,605100,55.72,138.22,193.94
2023-12-01 20:00:00+08,1,7,8,13760,781079,794839,59.72,134.55,194.27
2023-12-02 00:00:00+08,1,8,9,13760,787963,801723,63.73,165.96,229.69
2023-12-02 04:00:00+08,1,8,9,13760,787963,801723,67.73,197.96,265.69
2023-12-02 08:00:00+08,1,9,10,13760,875581,889341,71.73,230.59,302.32
2023-12-02 12:00:00+08,1,6,7,13760,711038,724798,75.72,188.68,264.4
2023-12-02 16:00:00+08,1,6,7,13760,706242,720002,79.75,143.17,222.92
2023-12-02 20:00:00+08,1,9,10,99066,897798,996864,84.97,170.6,255.57
2023-12-03 00:00:00+08,1,10,11,99066,919211,1018277,88.96,210.61,299.57
2023-12-03 04:00:00+08,1,10,11,99066,964433,1063499,92.92,201.74,294.66
2023-12-03 08:00:00+08,1,12,13,99066,1133026,1232092,96.92,247.54,344.46
2023-12-03 12:00:00+08,1,7,8,99066,661398,760464,18.52,88.48,107
2023-12-03 16:00:00+08,1,6,7,99066,599789,698855,22.52,106.48,129
2023-12-03 20:00:00+08,1,5,6,99066,549933,648999,26.52,113.58,140.1
2023-12-04 00:00:00+08,2,4,6,209066,528520,737586,31.81,105.58,137.39
2023-12-04 04:00:00+08,1,6,7,110000,588320,698320,5.29,123.82,129.11
2023-12-04 08:00:00+08,1,8,9,110000,812953,922953,46.01,124.33,170.34
2023-12-04 12:00:00+08,1,7,8,110000,794736,904736,50.01,146.26,196.27
2023-12-04 16:00:00+08,2,6,8,168350,753153,921503,54.54,162.09,216.63
2023-12-04 20:00:00+08,2,8,10,168350,858636,1026986,62.54,188.13,250.67
2023-12-05 00:00:00+08,4,8,12,347691,858636,1206327,75.36,220.13,295.49
2023-12-05 04:00:00+08,4,8,12,347691,858636,1206327,91.36,252.13,343.49
2023-12-05 08:00:00+08,3,9,12,289341,817857,1107198,90.82,226.15,316.97
2023-12-05 12:00:00+08,3,10,13,289341,890392,1179733,121.88,197.71,319.59
2023-12-05 16:00:00+08,4,7,11,370935,652012,1022947,135.09,143.81,278.9
2023-12-05 20:00:00+08,4,11,15,370935,1001937,1372872,151.07,144.31,295.38
2023-12-06 00:00:00+08,4,10,14,370935,961459,1332394,167.1,159.49,326.59
2023-12-06 04:00:00+08,5,11,16,397585,1092114,1489699,150.3,160.74,311.04
2023-12-06 08:00:00+08,4,11,15,232047,996733,1228780,136.17,155.79,291.96
2023-12-06 12:00:00+08,4,12,16,232047,1138235,1370282,169.07,177.18,346.25
2023-12-06 16:00:00+08,1,10,11,110000,1043351,1153351,101.25,183.68,284.93
2023-12-06 20:00:00+08,1,14,15,110000,1285894,1395894,197.29,202.33,399.62
2023-12-07 00:00:00+08,1,14,15,110000,1285894,1395894,201.29,258.33,459.62
2023-12-07 04:00:00+08,1,12,13,110000,1110904,1220904,205.26,250.12,455.38
2023-12-07 08:00:00+08,1,11,12,110000,1007256,1117256,209.27,266.55,475.82
2023-12-07 12:00:00+08,2,10,12,254572,1053665,1308237,169.43,270.66,440.09
2023-12-07 16:00:00+08,1,7,8,144572,877374,1021946,41.85,210.12,251.97
2023-12-07 20:00:00+08,1,7,8,144572,752445,897017,45.85,171.67,217.52
2023-12-08 00:00:00+08,0,7,7,0,696907,696907,93.36,165.42,258.78
2023-12-08 04:00:00+08,0,9,9,0,892844,892844,93.4,196.89,290.29
2023-12-08 08:00:00+08,0,10,10,0,1015713,1015713,112.38,191.05,303.43
2023-12-08 12:00:00+08,0,9,9,0,963657,963657,112.38,213.9,326.28
2023-12-08 16:00:00+08,0,10,10,0,970541,970541,112.38,252.06,364.44
2023-12-08 20:00:00+08,0,9,9,0,747547,747547,112.39,144.43,256.82
2023-12-09 00:00:00+08,0,9,9,0,747547,747547,112.39,180.43,292.82
2023-12-09 04:00:00+08,0,8,8,0,681664,681664,112.39,194.93,307.32
2023-12-09 08:00:00+08,0,9,9,0,789167,789167,112.4,228.01,340.41
2023-12-09 12:00:00+08,0,4,4,0,322018,322018,19,76.23,95.23
2023-12-09 16:00:00+08,0,4,4,0,425102,425102,19,68.33,87.33
2023-12-09 20:00:00+08,0,6,6,0,600605,600605,0,24.14,24.14
2023-12-10 00:00:00+08,0,7,7,0,731639,731639,0,49.29,49.29
2023-12-10 04:00:00+08,0,8,8,0,782480,782480,0,80.29,80.29
2023-12-10 08:00:00+08,0,7,7,0,716590,716590,0,99.31,99.31
2023-12-10 12:00:00+08,0,7,7,0,747920,747920,0,114.22,114.22
2023-12-10 16:00:00+08,0,7,7,0,747920,747920,0,142.22,142.22
2023-12-10 20:00:00+08,0,7,7,0,799940,799940,0,152.41,152.41
2023-12-11 00:00:00+08,0,7,7,0,799940,799940,0,180.41,180.41
2023-12-11 04:00:00+08,0,7,7,0,799940,799940,0,208.41,208.41
2023-12-11 08:00:00+08,0,4,4,0,453425,453425,0,117.5,117.5
2023-12-11 12:00:00+08,0,5,5,0,470622,470622,0,136.78,136.78
2023-12-11 16:00:00+08,0,5,5,0,470622,470622,0,156.78,156.78
2023-12-11 20:00:00+08,0,3,3,0,306227,306227,0,90.59,90.59
2023-12-12 00:00:00+08,0,1,1,0,101779,101779,0,4.99,4.99
2023-12-12 04:00:00+08,0,1,1,0,101779,101779,0,8.99,8.99
2023-12-12 08:00:00+08,0,2,2,0,227722,227722,0,15.96,15.96
2023-12-12 12:00:00+08,0,3,3,0,329383,329383,0,26.79,26.79
2023-12-12 16:00:00+08,0,4,4,0,438210,438210,0,41.68,41.68
2023-12-12 20:00:00+08,0,5,5,0,586176,586176,0,57.93,57.93
2023-12-13 00:00:00+08,0,5,5,0,586176,586176,0,77.93,77.93
2023-12-13 04:00:00+08,0,5,5,0,586176,586176,0,97.93,97.93
2023-12-13 08:00:00+08,0,5,5,0,516747,516747,0,84.03,84.03
2023-12-13 12:00:00+08,0,5,5,0,442624,442624,0,81.63,81.63
2023-12-13 16:00:00+08,0,4,4,0,438133,438133,0,57.13,57.13
2023-12-13 20:00:00+08,0,5,5,0,522904,522904,0,74.62,74.62
2023-12-14 00:00:00+08,0,4,4,0,421243,421243,0,55.8,55.8
2023-12-14 04:00:00+08,0,5,5,0,481835,481835,0,75.61,75.61
2023-12-14 08:00:00+08,0,5,5,0,402034,402034,0,60.52,60.52
2023-12-14 12:00:00+08,0,5,5,0,410310,410310,0,56.26,56.26
2023-12-14 16:00:00+08,0,3,3,0,257374,257374,0,45.62,45.62
2023-12-14 20:00:00+08,0,8,8,0,590685,590685,0,63.5,63.5
2023-12-15 00:00:00+08,0,9,9,0,735257,735257,0,98.66,98.66
2023-12-15 04:00:00+08,0,11,11,0,896167,896167,0,140.83,140.83
2023-12-15 08:00:00+08,0,11,11,0,967072,967072,0,154.27,154.27
2023-12-15 12:00:00+08,0,11,11,0,880499,880499,0,137.84,137.84
2023-12-15 16:00:00+08,0,8,8,0,727961,727961,0,106.12,106.12
2023-12-15 20:00:00+08,0,9,9,0,750275,750275,0,139.37,139.37
2023-12-16 00:00:00+08,0,10,10,0,834980,834980,0,179.36,179.36
2023-12-16 04:00:00+08,0,10,10,0,834980,834980,0,219.36,219.36
2023-12-16 08:00:00+08,0,11,11,0,961033,961033,0,262.19,262.19
2023-12-16 12:00:00+08,0,9,9,0,879162,879162,0,227.02,227.02
2023-12-16 16:00:00+08,1,8,9,139335,848927,988262,0.98,234.37,235.35
2023-12-16 20:00:00+08,2,5,7,191006,493130,684136,6.8,120.05,126.85
2023-12-17 00:00:00+08,1,8,9,139335,697256,836591,12.97,146.1,159.07
2023-12-17 04:00:00+08,1,9,10,139335,729853,869188,16.95,151.83,168.78
2023-12-17 08:00:00+08,1,8,9,139335,657637,796972,20.98,116.34,137.32
2023-12-17 12:00:00+08,1,9,10,139335,721064,860399,24.95,150.27,175.22
2023-12-17 16:00:00+08,1,8,9,139335,669393,808728,24.99,168.43,193.42
2023-12-17 20:00:00+08,2,4,6,247685,347658,595343,29.28,66.06,95.34
2023-12-18 00:00:00+08,1,6,7,108350,553354,661704,4.29,86.17,90.46
2023-12-18 04:00:00+08,2,7,9,238923,727395,966318,45.03,73.14,118.17
2023-12-18 08:00:00+08,1,8,9,108350,873818,982168,47.7,102.49,150.19
2023-12-18 12:00:00+08,1,7,8,108350,812182,920532,51.7,118.67,170.37
2023-12-18 16:00:00+08,1,8,9,108350,942755,1051105,65.85,149.85,215.7
2023-12-18 20:00:00+08,1,8,9,108350,942755,1051105,69.85,181.85,251.7
2023-12-19 00:00:00+08,1,8,9,108350,942755,1051105,73.85,213.85,287.7
2023-12-19 04:00:00+08,1,8,9,108350,942755,1051105,77.85,245.85,323.7
2023-12-19 08:00:00+08,1,6,7,108350,787629,895979,81.89,186.96,268.85
2023-12-19 12:00:00+08,1,6,7,108350,787629,895979,85.89,210.96,296.85
2023-12-19 16:00:00+08,0,6,6,0,833440,833440,45.58,197.77,243.35
2023-12-19 20:00:00+08,0,8,8,0,979326,979326,93.45,162.59,256.04
2023-12-20 00:00:00+08,0,8,8,0,979326,979326,93.45,194.59,288.04
2023-12-20 04:00:00+08,0,9,9,0,1019804,1019804,93.45,229.06,322.51
2023-12-20 08:00:00+08,2,9,11,219000,1019804,1238804,97.43,265.06,362.49
2023-12-20 12:00:00+08,2,9,11,219000,1019804,1238804,105.43,301.06,406.49
2023-12-20 16:00:00+08,1,9,10,146696,909906,1056602,104.61,276.35,380.96
2023-12-20 20:00:00+08,1,10,11,146696,901600,1048296,110.76,258.42,369.18
2023-12-21 00:00:00+08,1,9,10,146696,806570,953266,79.34,208.46,287.8
2023-12-21 04:00:00+08,2,8,10,211426,754057,965483,83.5,211.57,295.07
2023-12-21 08:00:00+08,1,7,8,64730,625389,690119,16.49,171.57,188.06
2023-12-21 12:00:00+08,1,7,8,64730,625389,690119,20.49,199.57,220.06
2023-12-21 16:00:00+08,0,6,6,0,591500,591500,43.5,122.61,166.11
2023-12-21 20:00:00+08,0,5,5,0,466363,466363,46.22,46.77,92.99
2023-12-22 00:00:00+08,0,6,6,0,553200,553200,46.22,43.66,89.88
2023-12-22 04:00:00+08,0,5,5,0,471644,471644,46.22,47,93.22
2023-12-22 08:00:00+08,0,8,8,0,790318,790318,46.22,64.05,110.27
2023-12-22 12:00:00+08,0,8,8,0,790318,790318,46.22,96.05,142.27
2023-12-22 16:00:00+08,0,8,8,0,790318,790318,46.22,128.05,174.27
2023-12-22 20:00:00+08,0,9,9,0,791698,791698,46.22,129.1,175.32
2023-12-23 00:00:00+08,0,10,10,0,793439,793439,31.16,138.1,169.26
2023-12-23 04:00:00+08,0,11,11,0,915586,915586,31.17,152.36,183.53
2023-12-23 08:00:00+08,0,13,13,0,1190123,1190123,31.17,198.93,230.1
2023-12-23 12:00:00+08,0,13,13,0,1190123,1190123,31.17,250.93,282.1
2023-12-23 16:00:00+08,1,13,14,39164,1190123,1229287,31.28,302.93,334.21
2023-12-23 20:00:00+08,1,12,13,39164,1168172,1207336,35.24,272.09,307.33
2023-12-24 00:00:00+08,2,14,16,153053,1294443,1447496,41.05,323.63,364.68
2023-12-24 04:00:00+08,2,12,14,153053,1024788,1177841,17.89,269.71,287.6
2023-12-24 08:00:00+08,2,12,14,153053,1024788,1177841,25.89,317.71,343.6
2023-12-24 12:00:00+08,2,9,11,153053,969680,1122733,33.91,246.35,280.26
2023-12-24 16:00:00+08,2,9,11,153053,969680,1122733,41.91,282.35,324.26
2023-12-24 20:00:00+08,2,7,9,153053,713112,866165,49.93,212.45,262.38
2023-12-25 00:00:00+08,2,5,7,153053,511984,665037,57.92,171.88,229.8
2023-12-25 04:00:00+08,2,2,4,153053,185626,338679,65.93,62.98,128.91
2023-12-25 08:00:00+08,2,2,4,153053,185626,338679,73.93,70.98,144.91
2023-12-25 12:00:00+08,2,1,3,153053,144043,297096,81.92,42.07,123.99
2023-12-25 16:00:00+08,2,1,3,153053,144043,297096,89.92,46.07,135.99
2023-12-25 20:00:00+08,3,1,4,178291,144043,322334,99.58,50.07,149.65
2023-12-26 00:00:00+08,3,1,4,178291,144043,322334,111.58,54.07,165.65
2023-12-26 04:00:00+08,3,1,4,178291,144043,322334,123.58,58.07,181.65
2023-12-26 08:00:00+08,3,1,4,178291,144043,322334,135.58,62.07,197.65
2023-12-26 12:00:00+08,3,1,4,178291,144043,322334,147.58,66.07,213.65
2023-12-26 16:00:00+08,0,2,2,0,218499,218499,0,72.89,72.89
2023-12-26 20:00:00+08,0,6,6,0,588112,588112,93.51,85.35,178.86
2023-12-27 00:00:00+08,0,12,12,0,1184311,1184311,169.95,123.55,293.5
2023-12-27 04:00:00+08,1,13,14,142020,1218625,1360645,172.65,173.97,346.62
2023-12-27 08:00:00+08,1,13,14,142020,1296248,1438268,152.41,215.3,367.71
2023-12-27 12:00:00+08,1,14,15,142020,1323119,1465139,156.41,269.07,425.48
2023-12-27 16:00:00+08,1,12,13,142020,1234860,1376880,160.38,278.32,438.7
2023-12-27 20:00:00+08,3,12,15,243421,1234860,1478281,167.22,326.32,493.54
2023-12-28 00:00:00+08,1,10,11,142020,1168806,1310826,91.97,311.7,403.67
2023-12-28 04:00:00+08,1,12,13,142020,1270207,1412227,107.67,358.84,466.51
2023-12-28 08:00:00+08,1,14,15,142020,1367261,1509281,111.7,410.97,522.67
2023-12-28 12:00:00+08,1,12,13,142020,1139459,1281479,115.7,395.09,510.79
2023-12-28 16:00:00+08,1,11,12,142020,1025570,1167590,50.46,398.5,448.96
2023-12-28 20:00:00+08,1,7,8,142020,746103,888123,54.46,298.19,352.65
2023-12-29 00:00:00+08,1,6,7,142020,602060,744080,58.5,200.1,258.6
2023-12-29 04:00:00+08,1,10,11,142020,900286,1042306,62.45,232.44,294.89
2023-12-29 08:00:00+08,1,10,11,142020,951209,1093229,60.02,243.44,303.46
2023-12-29 12:00:00+08,0,6,6,0,677609,677609,0,160.11,160.11
2023-12-29 16:00:00+08,0,9,9,0,1070291,1070291,59.6,193.15,252.75
2023-12-29 20:00:00+08,0,9,9,0,1070291,1070291,59.6,229.15,288.75
2023-12-30 00:00:00+08,0,9,9,0,1150520,1150520,59.6,243.49,303.09
2023-12-30 04:00:00+08,0,12,12,0,1373296,1373296,59.6,288.31,347.91
2023-12-30 08:00:00+08,0,13,13,0,1380180,1380180,59.6,337.13,396.73
2023-12-30 12:00:00+08,0,12,12,0,1225480,1225480,59.56,303.56,363.12
2023-12-30 16:00:00+08,0,11,11,0,1115093,1115093,59.56,314.44,374
2023-12-30 20:00:00+08,0,10,10,0,1089070,1089070,59.6,266.11,325.71
2023-12-31 00:00:00+08,0,12,12,0,1291017,1291017,59.6,312.76,372.36
2023-12-31 04:00:00+08,0,10,10,0,964221,964221,59.58,178.23,237.81
2023-12-31 08:00:00+08,0,11,11,0,1125809,1125809,59.6,193.72,253.32
2023-12-31 12:00:00+08,1,10,11,61636,1118925,1180561,63.34,208.9,272.24
2023-12-31 16:00:00+08,1,8,9,61636,925133,986769,67.34,191.32,258.66
2023-12-31 20:00:00+08,1,6,7,61636,733150,794786,11.75,148.46,160.21
2024-01-01 00:00:00+08,1,5,6,61636,584743,646379,15.75,124.29,140.04
2024-01-01 04:00:00+08,1,5,6,61636,606178,667814,19.75,114.62,134.37
2024-01-01 08:00:00+08,4,5,9,384956,606178,991134,31.04,134.62,165.66
2024-01-01 12:00:00+08,4,5,9,384956,606178,991134,47.04,154.62,201.66
2024-01-01 16:00:00+08,6,5,11,521187,606178,1127365,67.51,174.62,242.13
2024-01-01 20:00:00+08,6,5,11,521187,606178,1127365,91.51,194.62,286.13
2024-01-02 00:00:00+08,6,5,11,521187,606178,1127365,115.51,214.62,330.13
2024-01-02 04:00:00+08,7,5,12,581826,606178,1188004,142.24,234.62,376.86
2024-01-02 08:00:00+08,7,5,12,581826,606178,1188004,170.24,254.62,424.86
2024-01-02 12:00:00+08,7,5,12,581826,606178,1188004,198.24,274.62,472.86
2024-01-02 16:00:00+08,4,5,9,345849,606178,952027,111.62,294.62,406.24
2024-01-02 20:00:00+08,4,10,14,345849,984225,1330074,223.45,318.84,542.29
2024-01-03 00:00:00+08,6,12,18,434842,1179512,1614354,273.77,365.3,639.07
2024-01-03 04:00:00+08,5,11,16,349327,1108173,1457500,258.69,341.89,600.58
2024-01-03 08:00:00+08,5,11,16,349327,1084861,1434188,320.65,302.63,623.28
2024-01-03 12:00:00+08,5,12,17,349327,1162214,1511541,340.64,333.94,674.58
2024-01-03 16:00:00+08,4,10,14,263521,1049862,1313383,212.58,342.21,554.79
2024-01-03 20:00:00+08,4,10,14,268956,942867,1211823,230.77,198.01,428.78
2024-01-04 00:00:00+08,4,11,15,268956,1173038,1441994,312.93,211.38,524.31
2024-01-04 04:00:00+08,4,11,15,268956,1181243,1450199,292.07,226.16,518.23
2024-01-04 08:00:00+08,4,11,15,268956,1121764,1390720,266.13,246.01,512.14
2024-01-04 12:00:00+08,4,9,13,268956,948449,1217405,282.13,183.3,465.43
2024-01-04 16:00:00+08,3,5,8,191015,512868,703883,192.27,79.58,271.85
2024-01-04 20:00:00+08,3,9,12,191015,745275,936290,250.89,102.2,353.09
2024-01-05 00:00:00+08,3,10,13,191015,936285,1127300,262.9,127.86,390.76
2024-01-05 04:00:00+08,3,10,13,191015,936285,1127300,274.9,167.86,442.76
2024-01-05 08:00:00+08,4,9,13,321588,901517,1223105,290.77,195.64,486.41
2024-01-05 12:00:00+08,4,9,13,321588,901517,1223105,306.77,231.64,538.41
2024-01-05 16:00:00+08,3,6,9,260949,658016,918965,123.3,186.14,309.44
2024-01-05 20:00:00+08,1,9,10,130573,957189,1087762,105.57,142.04,247.61
2024-01-06 00:00:00+08,1,10,11,130573,968241,1098814,181,179.28,360.28
2024-01-06 04:00:00+08,1,10,11,130573,1024612,1155185,240.16,214.69,454.85
2024-01-06 08:00:00+08,2,10,12,234264,993665,1227929,245.91,218.79,464.7
2024-01-06 12:00:00+08,2,9,11,234264,958636,1192900,182.48,208.77,391.25
2024-01-06 16:00:00+08,1,5,6,103691,556454,660145,64.94,74.47,139.41
2024-01-06 20:00:00+08,1,8,9,103691,908005,1011696,108.44,98.5,206.94
2024-01-07 00:00:00+08,1,11,12,103691,1057756,1161447,112.44,139.29,251.73
2024-01-07 04:00:00+08,1,10,11,103691,918421,1022112,116.44,148.71,265.15
2024-01-07 08:00:00+08,1,7,8,103691,696660,800351,120.43,114.83,235.26
2024-01-07 12:00:00+08,1,6,7,103691,666471,770162,124.43,129.68,254.11
2024-01-07 16:00:00+08,1,6,7,103691,666471,770162,128.43,153.68,282.11
2024-01-07 20:00:00+08,1,5,6,103691,611942,715633,132.43,128.1,260.53
2024-01-08 00:00:00+08,1,5,6,103691,611942,715633,136.43,148.1,284.53
2024-01-08 04:00:00+08,0,4,4,0,492618,492618,39.47,116.52,155.99
2024-01-08 08:00:00+08,1,6,7,74453,736874,811327,90.21,135.09,225.3
2024-01-08 12:00:00+08,1,5,6,74453,557680,632133,54.75,105.96,160.71
2024-01-08 16:00:00+08,0,4,4,0,539362,539362,47.8,118.33,166.13
2024-01-08 20:00:00+08,0,6,6,0,614890,614890,62.17,87.61,149.78
2024-01-09 00:00:00+08,0,7,7,0,755036,755036,62.17,115.2,177.37
2024-01-09 04:00:00+08,0,7,7,0,755036,755036,62.17,143.2,205.37
2024-01-09 08:00:00+08,0,9,9,0,848199,848199,62.18,176.01,238.19
2024-01-09 12:00:00+08,0,9,9,0,848199,848199,62.18,212.01,274.19
2024-01-09 16:00:00+08,0,5,5,0,489574,489574,0,94.55,94.55
2024-01-09 20:00:00+08,0,7,7,0,642969,642969,0,116.28,116.28
2024-01-10 00:00:00+08,0,7,7,0,642969,642969,0,144.28,144.28
2024-01-10 04:00:00+08,0,6,6,0,563566,563566,0,149.71,149.71
2024-01-10 08:00:00+08,0,6,6,0,563566,563566,0,173.71,173.71
2024-01-10 12:00:00+08,0,6,6,0,563566,563566,0,197.71,197.71
2024-01-10 16:00:00+08,0,6,6,0,563566,563566,0,221.71,221.71
2024-01-10 20:00:00+08,0,6,6,0,563566,563566,0,245.71,245.71
2024-01-11 00:00:00+08,0,6,6,0,563566,563566,0,269.71,269.71
2024-01-11 04:00:00+08,0,6,6,0,583968,583968,0,248.12,248.12
2024-01-11 08:00:00+08,0,6,6,0,605744,605744,0,235.83,235.83
2024-01-11 12:00:00+08,0,5,5,0,515356,515356,0,219.18,219.18
2024-01-11 16:00:00+08,0,5,5,0,515356,515356,0,239.18,239.18
2024-01-11 20:00:00+08,0,7,7,0,679232,679232,0,190.92,190.92
2024-01-12 00:00:00+08,0,6,6,0,547474,547474,0,111.92,111.92
2024-01-12 04:00:00+08,0,5,5,0,407328,407328,0,56.34,56.34
2024-01-12 08:00:00+08,0,6,6,0,441558,441558,0,77.55,77.55
2024-01-12 12:00:00+08,0,5,5,0,356775,356775,0,72.76,72.76
2024-01-12 16:00:00+08,0,4,4,0,371864,371864,0,55.84,55.84
2024-01-12 20:00:00+08,0,7,7,0,611486,611486,0,63.28,63.28
2024-01-13 00:00:00+08,0,7,7,0,562528,562528,0,66.27,66.27
2024-01-13 04:00:00+08,0,7,7,0,562528,562528,0,94.27,94.27
2024-01-13 08:00:00+08,0,6,6,0,335241,335241,0,66.49,66.49
2024-01-13 12:00:00+08,0,7,7,0,480242,480242,0,80.06,80.06
2024-01-13 16:00:00+08,0,7,7,0,480242,480242,0,108.06,108.06
2024-01-13 20:00:00+08,0,7,7,0,480242,480242,0,136.06,136.06
2024-01-14 00:00:00+08,0,5,5,0,403094,403094,0,107.72,107.72
2024-01-14 04:00:00+08,0,9,9,0,768586,768586,0,132.33,132.33
2024-01-14 08:00:00+08,0,10,10,0,789999,789999,0,172.33,172.33
2024-01-14 12:00:00+08,0,7,7,0,675748,675748,0,113.99,113.99
2024-01-14 16:00:00+08,0,6,6,0,654335,654335,0,129.99,129.99
2024-01-14 20:00:00+08,0,5,5,0,624148,624148,0,137.67,137.67
2024-01-15 00:00:00+08,0,6,6,0,642365,642365,0,160.51,160.51
2024-01-15 04:00:00+08,0,7,7,0,769441,769441,0,186.33,186.33
2024-01-15 08:00:00+08,0,7,7,0,691188,691188,0,186.06,186.06
2024-01-15 12:00:00+08,0,4,4,0,451144,451144,0,132.07,132.07
2024-01-15 16:00:00+08,0,4,4,0,451144,451144,0,148.07,148.07
2024-01-15 20:00:00+08,0,5,5,0,657891,657891,0,155.2,155.2
2024-01-16 00:00:00+08,0,6,6,0,752520,752520,0,179.11,179.11
2024-01-16 04:00:00+08,0,6,6,0,742376,742376,0,180.87,180.87
2024-01-16 08:00:00+08,0,10,10,0,1054517,1054517,0,210.12,210.12
2024-01-16 12:00:00+08,0,9,9,0,912466,912466,0,159.55,159.55
2024-01-16 16:00:00+08,0,9,9,0,907766,907766,0,117.81,117.81
2024-01-16 20:00:00+08,0,9,9,0,859549,859549,0,102.72,102.72
2024-01-17 00:00:00+08,0,9,9,0,859549,859549,0,138.72,138.72
2024-01-17 04:00:00+08,1,11,12,109000,995197,1104197,1.96,179.91,181.87
2024-01-17 08:00:00+08,1,12,13,109000,1141989,1250989,5.96,224.9,230.86
2024-01-17 12:00:00+08,1,12,13,109000,1126003,1235003,9.96,243.6,253.56
2024-01-17 16:00:00+08,0,11,11,0,1064016,1064016,0,258.61,258.61
2024-01-17 20:00:00+08,0,9,9,0,785645,785645,0,174.57,174.57
2024-01-18 00:00:00+08,0,13,13,0,1233288,1233288,19.98,198.42,218.4
2024-01-18 04:00:00+08,0,13,13,0,1233288,1233288,19.98,250.42,270.4
2024-01-18 08:00:00+08,0,10,10,0,1076822,1076822,19.98,215.49,235.47
2024-01-18 12:00:00+08,0,10,10,0,1098562,1098562,19.95,219.01,238.96
2024-01-18 16:00:00+08,0,11,11,0,1207074,1207074,19.98,205.82,225.8
2024-01-18 20:00:00+08,0,11,11,0,1195956,1195956,19.98,225.94,245.92
2024-01-19 00:00:00+08,0,11,11,0,1210490,1210490,19.98,245.98,265.96
2024-01-19 04:00:00+08,0,12,12,0,1249873,1249873,19.98,293.97,313.95
2024-01-19 08:00:00+08,0,11,11,0,1140873,1140873,0,307.97,307.97
2024-01-19 12:00:00+08,0,11,11,0,1130895,1130895,0,317.29,317.29
2024-01-19 16:00:00+08,1,8,9,139335,863578,1002913,2.77,261.51,264.28
2024-01-19 20:00:00+08,1,13,14,139335,1261253,1400588,6.77,272.39,279.16
2024-01-20 00:00:00+08,2,13,15,224110,1114511,1338621,11.46,277.07,288.53
2024-01-20 04:00:00+08,2,13,15,224110,1114511,1338621,19.46,329.07,348.53
2024-01-20 08:00:00+08,2,10,12,224110,876042,1100152,27.45,257.52,284.97
2024-01-20 12:00:00+08,2,9,11,224110,724235,948345,35.44,238.91,274.35
2024-01-20 16:00:00+08,1,8,9,84775,670826,755601,16.67,169.85,186.52
2024-01-20 20:00:00+08,1,12,13,84775,1081419,1166194,50.11,205.04,255.15
2024-01-21 00:00:00+08,1,9,10,84775,841174,925949,54.11,115.98,170.09
2024-01-21 04:00:00+08,1,11,12,84775,1020542,1105317,58.11,159.43,217.54
2024-01-21 08:00:00+08,1,9,10,84775,853251,938026,62.11,154.04,216.15
2024-01-21 12:00:00+08,1,10,11,84775,965069,1049844,66.11,181.44,247.55
2024-01-21 16:00:00+08,0,10,10,0,1092628,1092628,29.43,180.6,210.03
2024-01-21 20:00:00+08,0,9,9,0,1032095,1032095,72.19,149.96,222.15
2024-01-22 00:00:00+08,0,9,9,0,1032095,1032095,72.19,185.96,258.15
2024-01-22 04:00:00+08,0,10,10,0,987031,987031,72.19,199.21,271.4
2024-01-22 08:00:00+08,0,7,7,0,743121,743121,72.19,147.05,219.24
2024-01-22 12:00:00+08,0,6,6,0,725924,725924,72.19,166.06,238.25
2024-01-22 16:00:00+08,0,5,5,0,641149,641149,29.43,168.15,197.58
2024-01-22 20:00:00+08,0,7,7,0,771454,771454,0,86.85,86.85
2024-01-23 00:00:00+08,0,6,6,0,719711,719711,0,90.94,90.94
2024-01-23 04:00:00+08,0,6,6,0,719711,719711,0,114.94,114.94
2024-01-23 08:00:00+08,0,9,9,0,1036456,1036456,0,144.13,144.13
2024-01-23 12:00:00+08,0,9,9,0,1036456,1036456,0,180.13,180.13
2024-01-23 16:00:00+08,0,9,9,0,1131557,1131557,0,196.64,196.64
2024-01-23 20:00:00+08,0,11,11,0,1092774,1092774,0,179.92,179.92
2024-01-24 00:00:00+08,0,11,11,0,1115312,1115312,0,198.04,198.04
2024-01-24 04:00:00+08,0,10,10,0,976701,976701,0,179.38,179.38
2024-01-24 08:00:00+08,0,10,10,0,1107901,1107901,0,209.56,209.56
2024-01-24 12:00:00+08,0,9,9,0,1041879,1041879,0,203.69,203.69
2024-01-24 16:00:00+08,0,8,8,0,911424,911424,0,205.83,205.83
2024-01-24 20:00:00+08,0,9,9,0,1007860,1007860,0,213.76,213.76
2024-01-25 00:00:00+08,0,8,8,0,922102,922102,0,158.08,158.08
2024-01-25 04:00:00+08,0,9,9,0,973835,973835,0,193.86,193.86
2024-01-25 08:00:00+08,1,9,10,142023,965781,1107804,3.59,212.5,216.09
2024-01-25 12:00:00+08,1,9,10,142023,965781,1107804,7.59,248.5,256.09
2024-01-25 16:00:00+08,2,8,10,177414,935587,1113001,14,263.51,277.51
2024-01-25 20:00:00+08,2,9,11,177414,1008449,1185863,22,274.02,296.02
2024-01-26 00:00:00+08,1,9,10,142023,1126371,1268394,19.59,292.04,311.63
2024-01-26 04:00:00+08,1,10,11,142023,1066842,1208865,36.39,251.72,288.11
2024-01-26 08:00:00+08,1,10,11,142023,1118757,1260780,40.39,260.85,301.24
2024-01-26 12:00:00+08,1,11,12,142023,1129809,1271832,44.41,302.24,346.65
2024-01-26 16:00:00+08,1,10,11,142023,974560,1116583,48.45,302.41,350.86
2024-01-26 20:00:00+08,1,8,9,142023,829434,971457,39.59,298.77,338.36
2024-01-27 00:00:00+08,1,6,7,142023,646495,788518,43.59,232.85,276.44
2024-01-27 04:00:00+08,1,6,7,142023,646495,788518,47.59,256.85,304.44
2024-01-27 08:00:00+08,2,7,9,253637,709695,963332,54.67,282.75,337.42
2024-01-27 12:00:00+08,2,7,9,253637,709695,963332,62.67,310.75,373.42
2024-01-27 16:00:00+08,2,7,9,253637,709695,963332,70.67,338.75,409.42
2024-01-27 20:00:00+08,2,6,8,253637,698643,952280,78.67,333.35,412.02
2024-01-28 00:00:00+08,2,3,5,253637,360785,614422,86.65,160.79,247.44
2024-01-28 04:00:00+08,3,2,5,362637,266411,629048,98.06,116.22,214.28
2024-01-28 08:00:00+08,3,5,8,362637,630524,993161,110.07,132.93,243
2024-01-28 12:00:00+08,3,5,8,362637,630524,993161,122.07,152.93,275
2024-01-28 16:00:00+08,3,6,9,362637,716204,1078841,134.07,173.74,307.81
2024-01-28 20:00:00+08,2,9,11,251023,903257,1154280,145.53,200.35,345.88
2024-01-29 00:00:00+08,2,9,11,251023,903257,1154280,153.53,236.35,389.88
2024-01-29 04:00:00+08,1,8,9,142023,776181,918204,134.1,241.11,375.21
2024-01-29 08:00:00+08,1,10,11,142023,989578,1131601,167.72,276.69,444.41
2024-01-29 12:00:00+08,0,9,9,0,927942,927942,68.16,299.78,367.94
2024-01-29 16:00:00+08,0,11,11,0,1026894,1026894,173.74,195.66,369.4
2024-01-29 20:00:00+08,0,8,8,0,886474,886474,173.74,171.04,344.78
2024-01-30 00:00:00+08,0,8,8,0,887290,887290,173.74,159.48,333.22
2024-01-30 04:00:00+08,0,8,8,0,887290,887290,173.74,191.48,365.22
2024-01-30 08:00:00+08,0,10,10,0,1018896,1018896,173.74,229.13,402.87
2024-01-30 12:00:00+08,0,10,10,0,1018896,1018896,173.74,269.13,442.87
2024-01-30 16:00:00+08,0,8,8,0,824216,824216,144.1,226.56,370.66
2024-01-30 20:00:00+08,0,7,7,0,630883,630883,144.1,158.55,302.65
2024-01-31 00:00:00+08,0,7,7,0,650965,650965,105.58,103.99,209.57
2024-01-31 04:00:00+08,1,9,10,139335,885534,1024869,107.98,138.6,246.58
2024-01-31 08:00:00+08,1,9,10,139335,989164,1128499,111.97,148.47,260.44
2024-01-31 12:00:00+08,1,11,12,139335,1055676,1195011,115.97,188.93,304.9
2024-01-31 16:00:00+08,1,11,12,139335,1055676,1195011,119.97,232.93,352.9
2024-01-31 20:00:00+08,1,7,8,139335,801015,940350,123.97,135.47,259.44
2024-02-01 00:00:00+08,1,10,11,139335,1119983,1259318,127.97,171.56,299.53
2024-02-01 04:00:00+08,2,11,13,284609,1178333,1462942,134.2,213.07,347.27
2024-02-01 08:00:00+08,2,12,14,284609,1213399,1498008,142.2,257.98,400.18
2024-02-01 12:00:00+08,2,10,12,284609,1052646,1337255,150.2,245.63,395.83
2024-02-01 16:00:00+08,2,7,9,284609,795441,1080050,158.2,207.84,366.04
2024-02-01 20:00:00+08,2,7,9,284609,704750,989359,166.2,201.86,368.06
2024-02-02 00:00:00+08,1,5,6,145274,492807,638081,127.8,166.68,294.48
2024-02-02 04:00:00+08,1,7,8,145274,695122,840396,76.22,106.18,182.4
2024-02-02 08:00:00+08,1,7,8,145274,775488,920762,80.22,122.33,202.55
2024-02-02 12:00:00+08,1,6,7,145274,606219,751493,84.22,95.82,180.04
2024-02-02 16:00:00+08,1,6,7,145274,613344,758618,88.22,58.5,146.72
2024-02-02 20:00:00+08,1,11,12,145274,925232,1070506,92.22,86.64,178.86
2024-02-03 00:00:00+08,1,11,12,145274,925232,1070506,96.22,130.64,226.86
2024-02-03 04:00:00+08,1,11,12,145274,937257,1082531,100.23,149.84,250.07
2024-02-03 08:00:00+08,1,12,13,145274,1005720,1150994,104.23,197.29,301.52
2024-02-03 12:00:00+08,1,9,10,145274,800753,946027,108.23,182.12,290.35
2024-02-03 16:00:00+08,1,6,7,145274,679775,825049,112.23,147.57,259.8
2024-02-03 20:00:00+08,1,10,11,145274,963511,1108785,116.23,178.72,294.95
2024-02-04 00:00:00+08,1,10,11,145274,963511,1108785,120.23,218.72,338.95
2024-02-04 04:00:00+08,0,10,10,0,963511,963511,50.02,258.72,308.74
2024-02-04 08:00:00+08,0,9,9,0,906813,906813,75.48,186.31,261.79
2024-02-04 12:00:00+08,0,8,8,0,843813,843813,75.48,205.5,280.98
2024-02-04 16:00:00+08,0,6,6,0,798306,798306,75.48,134.42,209.9
2024-02-04 20:00:00+08,0,9,9,0,970145,970145,75.48,160.78,236.26
2024-02-05 00:00:00+08,0,8,8,0,801154,801154,75.47,91.9,167.37
2024-02-05 04:00:00+08,1,7,8,145527,676543,822070,76.32,88.16,164.48
2024-02-05 08:00:00+08,1,9,10,145527,852229,997756,80.32,118.43,198.75
2024-02-05 12:00:00+08,1,7,8,145527,765225,910752,84.32,120.69,205.01
2024-02-05 16:00:00+08,1,7,8,145527,765225,910752,88.32,148.69,237.01
2024-02-05 20:00:00+08,1,8,9,145527,927703,1073230,92.33,153.78,246.11
2024-02-06 00:00:00+08,1,9,10,145527,994642,1140169,96.33,186.68,283.01
2024-02-06 04:00:00+08,1,11,12,145527,1240446,1385973,100.33,228.65,328.98
2024-02-06 08:00:00+08,1,10,11,145527,1116860,1262387,104.33,231.59,335.92
2024-02-06 12:00:00+08,1,8,9,145527,945574,1091101,108.33,188.33,296.66
2024-02-06 16:00:00+08,1,8,9,145527,945574,1091101,112.33,220.33,332.66
2024-02-06 20:00:00+08,1,6,7,145527,689091,834618,40.83,133.54,174.37
2024-02-07 00:00:00+08,1,7,8,145527,827998,973525,44.83,161.45,206.28
2024-02-07 04:00:00+08,1,8,9,145527,869581,1015108,48.83,193.09,241.92
2024-02-07 08:00:00+08,1,7,8,145527,738337,883864,52.83,168.45,221.28
2024-02-07 12:00:00+08,1,8,9,145527,772651,918178,56.83,196.79,253.62
2024-02-07 16:00:00+08,1,5,6,145527,498282,643809,60.83,124.11,184.94
2024-02-07 20:00:00+08,1,10,11,145527,999550,1145077,64.83,129.93,194.76
2024-02-08 00:00:00+08,1,10,11,145527,999550,1145077,68.83,169.93,238.76
2024-02-08 04:00:00+08,1,10,11,145527,999550,1145077,72.83,209.93,282.76
2024-02-08 08:00:00+08,1,9,10,145527,972525,1118052,76.83,237.14,313.97
2024-02-08 12:00:00+08,2,9,11,290099,1103633,1393732,84.38,251.5,335.88
2024-02-08 16:00:00+08,2,8,10,290099,909338,1199437,92.38,246.21,338.59
2024-02-08 20:00:00+08,1,12,13,144572,1121457,1266029,11.52,196.81,208.33
2024-02-09 00:00:00+08,1,12,13,144572,1128077,1272649,106.27,194.98,301.25
2024-02-09 04:00:00+08,0,11,11,0,1017690,1017690,90.75,210.58,301.33
2024-02-09 08:00:00+08,0,11,11,0,1140792,1140792,113.4,242.8,356.2
2024-02-09 12:00:00+08,0,12,12,0,1293136,1293136,113.4,290.19,403.59
2024-02-09 16:00:00+08,0,10,10,0,1204689,1204689,113.4,294.54,407.94
2024-02-09 20:00:00+08,0,10,10,0,1160897,1160897,113.4,285.52,398.92
2024-02-10 00:00:00+08,0,8,8,0,942962,942962,113.4,257.2,370.6
2024-02-10 04:00:00+08,0,9,9,0,1006112,1006112,113.4,291.99,405.39
2024-02-10 08:00:00+08,0,8,8,0,995060,995060,113.4,286.12,399.52
2024-02-10 12:00:00+08,0,6,6,0,825356,825356,113.4,259.27,372.67
2024-02-10 16:00:00+08,0,5,5,0,762206,762206,113.4,268.48,381.88
2024-02-10 20:00:00+08,0,10,10,0,1131541,1131541,113.4,292.03,405.43
2024-02-11 00:00:00+08,0,10,10,0,1131541,1131541,113.4,332.03,445.43
2024-02-11 04:00:00+08,0,9,9,0,979197,979197,113.4,328.64,442.04
2024-02-11 08:00:00+08,0,9,9,0,979197,979197,113.4,364.64,478.04
2024-02-11 12:00:00+08,0,7,7,0,773016,773016,90.76,330.63,421.39
2024-02-11 16:00:00+08,0,6,6,0,592588,592588,90.76,289.99,380.75
2024-02-11 20:00:00+08,0,6,6,0,662582,662582,90.76,266.51,357.27
2024-02-12 00:00:00+08,0,5,5,0,591557,591557,90.76,261.58,352.34
2024-02-12 04:00:00+08,0,5,5,0,591557,591557,90.76,281.58,372.34
2024-02-12 08:00:00+08,0,4,4,0,446030,446030,0,219.5,219.5
2024-02-12 12:00:00+08,0,4,4,0,471729,471729,0,197.1,197.1
2024-02-12 16:00:00+08,0,4,4,0,471729,471729,0,213.1,213.1
2024-02-12 20:00:00+08,0,6,6,0,523004,523004,0,206.4,206.4
2024-02-13 00:00:00+08,1,6,7,138907,523004,661911,2.4,230.4,232.8
2024-02-13 04:00:00+08,1,6,7,138907,523004,661911,6.4,254.4,260.8
2024-02-13 08:00:00+08,1,7,8,138907,628549,767456,10.4,279.95,290.35
2024-02-13 12:00:00+08,0,7,7,0,737810,737810,0,292.02,292.02
2024-02-13 16:00:00+08,0,5,5,0,609274,609274,16.6,91.2,107.8
2024-02-13 20:00:00+08,0,4,4,0,480714,480714,16.6,77.13,93.73
2024-02-14 00:00:00+08,0,4,4,0,480714,480714,16.6,93.13,109.73
2024-02-14 04:00:00+08,0,4,4,0,480714,480714,16.6,109.13,125.73
2024-02-14 08:00:00+08,0,5,5,0,510870,510870,16.6,126.62,143.22
2024-02-14 12:00:00+08,0,5,5,0,510870,510870,16.6,146.62,163.22
2024-02-14 16:00:00+08,0,6,6,0,637928,637928,16.59,168.6,185.19
2024-02-14 20:00:00+08,0,10,10,0,937782,937782,16.59,196.83,213.42
2024-02-15 00:00:00+08,0,10,10,0,937782,937782,16.59,236.83,253.42
2024-02-15 04:00:00+08,0,11,11,0,972486,972486,16.59,280.17,296.76
2024-02-15 08:00:00+08,0,12,12,0,986246,986246,16.59,326.27,342.86
2024-02-15 12:00:00+08,0,11,11,0,956090,956090,16.59,344.77,361.36
2024-02-15 16:00:00+08,0,8,8,0,753269,753269,16.59,288.8,305.39
2024-02-15 20:00:00+08,0,10,10,0,876707,876707,16.6,266.95,283.55
2024-02-16 00:00:00+08,0,10,10,0,876771,876771,16.6,286.58,303.18
2024-02-16 04:00:00+08,1,9,10,52783,737864,790647,0.32,264.8,265.12
2024-02-16 08:00:00+08,1,10,11,52783,789535,842318,4.33,302.39,306.72
2024-02-16 12:00:00+08,0,9,9,0,813708,813708,0,217.09,217.09
2024-02-16 16:00:00+08,0,8,8,0,724218,724218,11.52,187.06,198.58
2024-02-16 20:00:00+08,0,6,6,0,583400,583400,11.52,127,138.52
2024-02-17 00:00:00+08,0,4,4,0,429855,429855,11.52,104.91,116.43
2024-02-17 04:00:00+08,0,5,5,0,436739,436739,11.52,121.4,132.92
2024-02-17 08:00:00+08,1,5,6,49891,408824,458715,11.85,81.52,93.37
2024-02-17 12:00:00+08,2,6,8,113318,480163,593481,18.74,103.45,122.19
2024-02-17 16:00:00+08,3,6,9,251929,574152,826081,16.48,103.43,119.91
2024-02-17 20:00:00+08,4,7,11,274243,704971,979214,30.35,131.31,161.66
2024-02-18 00:00:00+08,2,6,8,202038,584707,786745,28.87,86.95,115.82
2024-02-18 04:00:00+08,2,8,10,202038,718664,920702,54.71,98.84,153.55
2024-02-18 08:00:00+08,2,10,12,202038,921899,1123937,62.65,136.67,199.32
2024-02-18 12:00:00+08,2,7,9,202038,788187,990225,65.99,125.85,191.84
2024-02-18 16:00:00+08,2,9,11,202038,1009863,1211901,73.99,156.77,230.76
2024-02-18 20:00:00+08,2,8,10,202038,962342,1164380,64.14,160.48,224.62
2024-02-19 00:00:00+08,2,10,12,202038,1201936,1403974,72.14,196.54,268.68
2024-02-19 04:00:00+08,2,11,13,202038,1220254,1422292,80.14,238.29,318.43
2024-02-19 08:00:00+08,2,10,12,202038,1154890,1356928,88.14,269.56,357.7
2024-02-19 12:00:00+08,2,8,10,202038,1005753,1207791,96.14,255.92,352.06
2024-02-19 16:00:00+08,1,8,9,63427,967549,1030976,54.87,211.56,266.43
2024-02-19 20:00:00+08,1,10,11,63427,1051206,1114633,111.41,176.06,287.47
2024-02-20 00:00:00+08,1,9,10,63427,938673,1002100,115.44,141.5,256.94
2024-02-20 04:00:00+08,0,10,10,0,1078008,1078008,52.56,179.58,232.14
2024-02-20 08:00:00+08,0,11,11,0,1141435,1141435,121.74,221.28,343.02
2024-02-20 12:00:00+08,0,10,10,0,994663,994663,121.74,196.5,318.24
2024-02-20 16:00:00+08,0,6,6,0,581532,581532,121.74,105.75,227.49
2024-02-20 20:00:00+08,0,4,4,0,449351,449351,121.72,79.94,201.66
2024-02-21 00:00:00+08,0,4,4,0,449351,449351,121.72,95.94,217.66
2024-02-21 04:00:00+08,0,4,4,0,449351,449351,121.72,111.94,233.66
2024-02-21 08:00:00+08,0,4,4,0,449351,449351,121.72,127.94,249.66
2024-02-21 12:00:00+08,0,3,3,0,310740,310740,69.16,103.23,172.39
2024-02-21 16:00:00+08,0,3,3,0,281475,281475,0,85.08,85.08
2024-02-21 20:00:00+08,0,5,5,0,457219,457219,0,51.75,51.75
2024-02-22 00:00:00+08,0,6,6,0,541907,541907,0,74.7,74.7
2024-02-22 04:00:00+08,0,6,6,0,541907,541907,0,98.7,98.7
2024-02-22 08:00:00+08,0,8,8,0,697842,697842,0,125.33,125.33
2024-02-22 12:00:00+08,0,7,7,0,663680,663680,0,133.77,133.77
2024-02-22 16:00:00+08,0,6,6,0,578992,578992,0,142.82,142.82
2024-02-22 20:00:00+08,1,8,9,139335,784686,924021,2.69,132.03,134.72
2024-02-23 00:00:00+08,1,8,9,139335,744966,884301,6.69,68.53,75.22
2024-02-23 04:00:00+08,1,10,11,139335,1031518,1170853,10.69,104.25,114.94
2024-02-23 08:00:00+08,1,11,12,139335,1082312,1221647,14.69,145.53,160.22
2024-02-23 12:00:00+08,1,12,13,139335,1116542,1255877,18.69,190.51,209.2
2024-02-23 16:00:00+08,1,12,13,139335,1116542,1255877,22.69,238.51,261.2
2024-02-23 20:00:00+08,1,9,10,139335,790305,929640,26.69,155.27,181.96
2024-02-24 00:00:00+08,1,8,9,139335,756075,895410,30.69,178.29,208.98
2024-02-24 04:00:00+08,1,11,12,139335,949974,1089309,34.69,187.83,222.52
2024-02-24 08:00:00+08,1,12,13,139335,1021313,1160648,38.69,234.8,273.49
2024-02-24 12:00:00+08,1,12,13,139335,1075171,1214506,42.69,256.66,299.35
2024-02-24 16:00:00+08,1,11,12,139335,919192,1058527,46.69,268.07,314.76
2024-02-24 20:00:00+08,1,11,12,139335,878427,1017762,50.68,182.33,233.01
2024-02-25 00:00:00+08,1,13,14,139335,950636,1089971,54.68,212.31,266.99
2024-02-25 04:00:00+08,1,12,13,139335,857071,996406,58.68,217.92,276.6
2024-02-25 08:00:00+08,1,14,15,139335,1128278,1267613,62.7,270.1,332.8
2024-02-25 12:00:00+08,1,15,16,139335,1240794,1380129,66.7,329.05,395.75
2024-02-25 16:00:00+08,1,10,11,139335,974326,1113661,70.7,277.79,348.49
2024-02-25 20:00:00+08,1,9,10,139335,973059,1112394,74.7,269,343.7
2024-02-26 00:00:00+08,1,8,9,139335,727961,867296,78.69,166.22,244.91
2024-02-26 04:00:00+08,1,8,9,139335,727961,867296,82.69,198.22,280.91
2024-02-26 08:00:00+08,0,8,8,0,727961,727961,0,230.22,230.22
2024-02-26 12:00:00+08,0,9,9,0,746178,746178,0,265.96,265.96
2024-02-26 16:00:00+08,0,9,9,0,867296,867296,90.76,298.15,388.91
2024-02-26 20:00:00+08,0,10,10,0,916520,916520,90.76,314.72,405.48
2024-02-27 00:00:00+08,0,9,9,0,835639,835639,90.76,301.62,392.38
2024-02-27 04:00:00+08,0,10,10,0,894732,894732,90.76,302.17,392.93
2024-02-27 08:00:00+08,0,9,9,0,767656,767656,90.75,292.99,383.74
2024-02-27 12:00:00+08,0,10,10,0,884733,884733,90.75,331.51,422.26
2024-02-27 16:00:00+08,0,8,8,0,678988,678988,90.74,291.4,382.14
2024-02-27 20:00:00+08,0,10,10,0,995305,995305,90.76,283.12,373.88
2024-02-28 00:00:00+08,0,10,10,0,971226,971226,90.76,298.96,389.72
2024-02-28 04:00:00+08,0,9,9,0,861226,861226,90.76,311.19,401.95
2024-02-28 08:00:00+08,0,10,10,0,900437,900437,0,305.36,305.36
2024-02-28 12:00:00+08,0,10,10,0,817674,817674,0,319.28,319.28
2024-02-28 16:00:00+08,0,9,9,0,803871,803871,0,343.12,343.12
2024-02-28 20:00:00+08,0,12,12,0,1183393,1183393,0,384.37,384.37
2024-02-29 00:00:00+08,0,12,12,0,1161976,1161976,0,403.02,403.02
2024-02-29 04:00:00+08,0,11,11,0,1073450,1073450,0,315.08,315.08
2024-02-29 08:00:00+08,0,10,10,0,1051980,1051980,0,334.12,334.12
2024-02-29 12:00:00+08,0,8,8,0,976076,976076,0,337.42,337.42
2024-02-29 16:00:00+08,0,8,8,0,976076,976076,0,369.42,369.42
2024-02-29 20:00:00+08,0,8,8,0,976076,976076,0,401.42,401.42
2024-03-01 00:00:00+08,0,8,8,0,908407,908407,0,404.68,404.68
2024-03-01 04:00:00+08,0,8,8,0,908407,908407,0,436.68,436.68
2024-03-01 08:00:00+08,1,7,8,65364,598601,663965,3.28,358.27,361.55
2024-03-01 12:00:00+08,1,8,9,65364,688115,753479,7.28,326.27,333.55
2024-03-01 16:00:00+08,0,8,8,0,800639,800639,0,343.14,343.14
2024-03-01 20:00:00+08,1,11,12,63395,981235,1044630,18.36,377.66,396.02
2024-03-02 00:00:00+08,1,12,13,63395,1137382,1200777,22.36,374.15,396.51
2024-03-02 04:00:00+08,1,12,13,63395,1109008,1172403,26.36,373.97,400.33
2024-03-02 08:00:00+08,1,11,12,63395,918340,981735,30.36,359.1,389.46
2024-03-02 12:00:00+08,1,11,12,63395,1005001,1068396,34.36,378.26,412.62
2024-03-02 16:00:00+08,1,8,9,63395,824405,887800,23.85,359.74,383.59
2024-03-02 20:00:00+08,0,10,10,0,969991,969991,0,393.22,393.22
2024-03-03 00:00:00+08,0,10,10,0,969991,969991,0,433.22,433.22
2024-03-03 04:00:00+08,0,9,9,0,895569,895569,0,411.1,411.1
2024-03-03 08:00:00+08,0,9,9,0,853436,853436,39.48,400.37,439.85
2024-03-03 12:00:00+08,1,9,10,50382,853436,903818,43.43,436.37,479.8
2024-03-03 16:00:00+08,1,9,10,50382,853436,903818,47.43,472.37,519.8
2024-03-03 20:00:00+08,1,8,9,50382,694236,744618,11.94,437.82,449.76
2024-03-04 00:00:00+08,1,4,5,50382,423749,474131,15.94,106.92,122.86
2024-03-04 04:00:00+08,1,4,5,50382,460847,511229,19.94,91.85,111.79
2024-03-04 08:00:00+08,1,6,7,50382,724441,774823,23.95,101.94,125.89
2024-03-04 12:00:00+08,1,6,7,50382,724441,774823,27.95,125.94,153.89
2024-03-04 16:00:00+08,1,6,7,50382,724441,774823,31.95,149.94,181.89
2024-03-04 20:00:00+08,1,8,9,50382,846328,896710,35.96,176.09,212.05
2024-03-05 00:00:00+08,1,7,8,50382,707421,757803,39.96,132.68,172.64
2024-03-05 04:00:00+08,1,7,8,50382,706597,756979,43.96,113.78,157.74
2024-03-05 08:00:00+08,1,9,10,50382,867522,917904,47.96,145.64,193.6
2024-03-05 12:00:00+08,1,9,10,50382,934680,985062,51.93,152.77,204.7
2024-03-05 16:00:00+08,1,6,7,50382,705809,756191,55.94,112.61,168.55
2024-03-05 20:00:00+08,1,9,10,50382,1158000,1208382,59.94,143.42,203.36
2024-03-06 00:00:00+08,1,9,10,50382,1164129,1214511,63.94,125.64,189.58
2024-03-06 04:00:00+08,1,11,12,50382,1333280,1383662,67.95,167.05,235
2024-03-06 08:00:00+08,1,14,15,50382,1475789,1526171,71.95,218.15,290.1
2024-03-06 12:00:00+08,1,15,16,50382,1510493,1560875,75.95,274.63,350.58
2024-03-06 16:00:00+08,1,15,16,50382,1510493,1560875,79.95,334.63,414.58
2024-03-06 20:00:00+08,1,13,14,50382,1424544,1474926,83.95,347.34,431.29
2024-03-07 00:00:00+08,1,13,14,50382,1424544,1474926,87.95,399.34,487.29
2024-03-07 04:00:00+08,1,13,14,50382,1442785,1493167,91.94,428.25,520.19
2024-03-07 08:00:00+08,1,12,13,50382,1355404,1405786,95.94,410.01,505.95
2024-03-07 12:00:00+08,1,10,11,50382,1180035,1230417,99.94,351.74,451.68
2024-03-07 16:00:00+08,1,8,9,50382,1034410,1084792,103.94,330.51,434.45
2024-03-07 20:00:00+08,1,8,9,50382,793919,844301,107.94,266.57,374.51
2024-03-08 00:00:00+08,1,9,10,50382,824536,874918,111.94,210.84,322.78
2024-03-08 04:00:00+08,1,10,11,50382,831420,881802,115.94,250.41,366.35
2024-03-08 08:00:00+08,1,10,11,50382,831420,881802,119.94,290.41,410.35
2024-03-08 12:00:00+08,1,9,10,50382,796963,847345,123.94,317.72,441.66
2024-03-08 16:00:00+08,1,6,7,50382,543359,593741,127.94,240.61,368.55
2024-03-08 20:00:00+08,1,7,8,50382,651337,701719,131.94,265.07,397.01
2024-03-09 00:00:00+08,1,7,8,50382,592129,642511,135.94,203.5,339.44
2024-03-09 04:00:00+08,1,8,9,50382,673703,724085,139.94,234.84,374.78
2024-03-09 08:00:00+08,1,8,9,50382,694137,744519,143.94,233.03,376.97
2024-03-09 12:00:00+08,1,6,7,50382,588479,638861,147.94,174.87,322.81
2024-03-09 16:00:00+08,1,6,7,50382,588479,638861,151.94,198.87,350.81
2024-03-09 20:00:00+08,1,9,10,50382,834437,884819,155.95,181.31,337.26
2024-03-10 00:00:00+08,1,9,10,50382,834437,884819,159.95,217.31,377.26
2024-03-10 04:00:00+08,1,9,10,50382,834437,884819,163.95,253.31,417.26
2024-03-10 08:00:00+08,1,8,9,50382,796508,846890,167.95,277.2,445.15
2024-03-10 12:00:00+08,1,7,8,50382,707839,758221,171.95,195.55,367.5
2024-03-10 16:00:00+08,1,6,7,50382,644639,695021,175.94,202.76,378.7
2024-03-10 20:00:00+08,0,4,4,0,451232,451232,0,144.06,144.06
2024-03-11 00:00:00+08,0,6,6,0,592095,592095,183.8,137.76,321.56
2024-03-11 04:00:00+08,0,4,4,0,402543,402543,183.8,53.98,237.78
2024-03-11 08:00:00+08,0,6,6,0,526585,526585,183.8,74.94,258.74
2024-03-11 12:00:00+08,0,6,6,0,526585,526585,183.8,98.94,282.74
2024-03-11 16:00:00+08,0,6,6,0,526585,526585,183.8,122.94,306.74
2024-03-11 20:00:00+08,0,3,3,0,361142,361142,0,89.3,89.3
2024-03-12 00:00:00+08,0,4,4,0,426147,426147,0,102.24,102.24
2024-03-12 04:00:00+08,0,4,4,0,426147,426147,0,118.24,118.24
2024-03-12 08:00:00+08,0,4,4,0,426147,426147,0,134.24,134.24
2024-03-12 12:00:00+08,0,4,4,0,426147,426147,0,150.24,150.24
2024-03-12 16:00:00+08,0,3,3,0,355557,355557,0,132.2,132.2
2024-03-12 20:00:00+08,0,7,7,0,648509,648509,0,149.43,149.43
2024-03-13 00:00:00+08,0,9,9,0,860446,860446,0,180.47,180.47
2024-03-13 04:00:00+08,0,9,9,0,860446,860446,0,216.47,216.47
2024-03-13 08:00:00+08,0,8,8,0,767572,767572,0,206.53,206.53
2024-03-13 12:00:00+08,0,7,7,0,623000,623000,0,175.13,175.13
2024-03-13 16:00:00+08,0,6,6,0,531222,531222,0,88.38,88.38
2024-03-13 20:00:00+08,0,5,5,0,561364,561364,0,75.9,75.9
2024-03-14 00:00:00+08,0,4,4,0,509621,509621,0,70.75,70.75
2024-03-14 04:00:00+08,0,5,5,0,543783,543783,0,90.14,90.14
2024-03-14 08:00:00+08,0,9,9,0,939675,939675,0,120.36,120.36
2024-03-14 12:00:00+08,0,8,8,0,834317,834317,0,115.12,115.12
2024-03-14 16:00:00+08,0,7,7,0,674123,674123,0,105.23,105.23
2024-03-14 20:00:00+08,0,11,11,0,932867,932867,0,139.3,139.3
2024-03-15 00:00:00+08,0,11,11,0,1024758,1024758,0,160.66,160.66
2024-03-15 04:00:00+08,0,10,10,0,885851,885851,0,166.34,166.34
2024-03-15 08:00:00+08,0,9,9,0,780689,780689,0,169.03,169.03
2024-03-15 12:00:00+08,0,8,8,0,723458,723458,0,144.83,144.83
2024-03-15 16:00:00+08,0,8,8,0,814053,814053,0,158.15,158.15
2024-03-15 20:00:00+08,0,10,10,0,887709,887709,0,175.24,175.24
2024-03-16 00:00:00+08,0,9,9,0,757254,757254,0,185.63,185.63
2024-03-16 04:00:00+08,0,8,8,0,704925,704925,0,174.67,174.67
2024-03-16 08:00:00+08,1,10,11,50869,818608,869477,1.52,161.45,162.97
2024-03-16 12:00:00+08,1,10,11,50869,915372,966241,5.52,178.3,183.82
2024-03-16 16:00:00+08,1,9,10,50869,803810,854679,9.51,139.37,148.88
2024-03-16 20:00:00+08,1,9,10,50869,829687,880556,13.52,138.69,152.21
2024-03-17 00:00:00+08,1,9,10,50869,911284,962153,17.52,157.62,175.14
2024-03-17 04:00:00+08,2,9,11,84952,915992,1000944,25.36,151.38,176.74
2024-03-17 08:00:00+08,1,8,9,34083,805992,840075,7.84,150.37,158.21
2024-03-17 12:00:00+08,1,8,9,34083,805992,840075,11.84,182.37,194.21
2024-03-17 16:00:00+08,1,6,7,34083,650855,684938,15.84,142.38,158.22
2024-03-17 20:00:00+08,1,9,10,34083,811900,845983,19.85,143.37,163.22
2024-03-18 00:00:00+08,1,7,8,34083,642511,676594,23.85,109.67,133.52
2024-03-18 04:00:00+08,1,7,8,34083,642511,676594,27.85,137.67,165.52
2024-03-18 08:00:00+08,1,7,8,34083,630380,664463,79.61,153.65,233.26
2024-03-18 12:00:00+08,1,6,7,34083,605142,639225,83.6,164.54,248.14
2024-03-18 16:00:00+08,1,4,5,34083,501490,535573,39.84,157.22,197.06
2024-03-18 20:00:00+08,0,8,8,0,700416,700416,0,119.31,119.31
2024-03-19 00:00:00+08,0,9,9,0,628861,628861,44.88,104.22,149.1
2024-03-19 04:00:00+08,0,11,11,0,922896,922896,44.88,147.09,191.97
2024-03-19 08:00:00+08,1,11,12,153520,974099,1127619,47.67,155.74,203.41
2024-03-19 12:00:00+08,1,9,10,153520,808586,962106,51.66,125.38,177.04
2024-03-19 16:00:00+08,2,6,8,292855,669868,962723,57.01,101.37,158.38
2024-03-19 20:00:00+08,2,6,8,292855,651244,944099,65.01,78.7,143.71
2024-03-20 00:00:00+08,2,8,10,292855,928869,1221724,73.01,104.33,177.34
2024-03-20 04:00:00+08,2,9,11,292855,1041040,1333895,81.01,140.13,221.14
2024-03-20 08:00:00+08,2,10,12,292855,1135640,1428495,89.01,179.13,268.14
2024-03-20 12:00:00+08,2,11,13,292855,1170136,1462991,97.02,220.58,317.6
2024-03-20 16:00:00+08,2,10,12,292855,1109544,1402399,105.02,243.42,348.44
2024-03-20 20:00:00+08,2,13,15,292855,1389179,1682034,113.02,287.17,400.19
2024-03-21 00:00:00+08,2,14,16,292855,1470949,1763804,121.02,340.13,461.15
2024-03-21 04:00:00+08,2,14,16,292855,1470949,1763804,129.02,396.13,525.15
2024-03-21 08:00:00+08,2,14,16,292855,1470949,1763804,137.02,452.13,589.15
2024-03-21 12:00:00+08,1,14,15,153520,1470949,1624469,99.67,508.13,607.8
2024-03-21 16:00:00+08,1,11,12,153520,1207431,1360951,103.66,449.2,552.86
2024-03-21 20:00:00+08,1,11,12,153520,1207754,1361274,107.66,470.28,577.94
2024-03-22 00:00:00+08,1,10,11,153520,1076720,1230240,111.66,464.95,576.61
2024-03-22 04:00:00+08,1,9,10,153520,950597,1104117,115.66,470.88,586.54
2024-03-22 08:00:00+08,1,6,7,153520,554706,708226,119.64,319.97,439.61
2024-03-22 12:00:00+08,0,4,4,0,319637,319637,112.34,173.36,285.7
2024-03-22 16:00:00+08,0,5,5,0,473157,473157,193.41,191.07,384.48
2024-03-22 20:00:00+08,0,10,10,0,954964,954964,193.41,219.23,412.64
2024-03-23 00:00:00+08,0,12,12,0,1190317,1190317,148.52,165.18,313.7
2024-03-23 04:00:00+08,0,12,12,0,1190317,1190317,148.52,213.18,361.7
2024-03-23 08:00:00+08,1,11,12,159614,1165317,1324931,151.41,246.04,397.45
2024-03-23 12:00:00+08,1,9,10,159614,1063804,1223418,155.41,251.84,407.25
2024-03-23 16:00:00+08,1,7,8,159614,861069,1020683,91.96,237.72,329.68
2024-03-23 20:00:00+08,1,9,10,159614,1073174,1232788,95.96,251.33,347.29
2024-03-24 00:00:00+08,1,11,12,159614,1263354,1422968,99.96,290.71,390.67
2024-03-24 04:00:00+08,2,11,13,212127,1263354,1475481,107.44,334.71,442.15
2024-03-24 08:00:00+08,2,11,13,212127,1263354,1475481,115.44,378.71,494.15
2024-03-24 12:00:00+08,2,11,13,212127,1263354,1475481,123.44,422.71,546.15
2024-03-24 16:00:00+08,1,10,11,52513,1195722,1248235,96.54,445.07,541.61
2024-03-24 20:00:00+08,1,7,8,52513,777067,829580,100.54,339.28,439.82
2024-03-25 00:00:00+08,2,7,9,197085,817357,1014442,148.17,314.59,462.76
2024-03-25 04:00:00+08,3,6,9,343781,663837,1007618,77.92,280.88,358.8
2024-03-25 08:00:00+08,3,5,8,227422,574038,801460,86.82,236.66,323.48
2024-03-25 12:00:00+08,2,5,7,82850,581399,664249,94.66,102.1,196.76
2024-03-25 16:00:00+08,0,5,5,0,612387,612387,51.51,75.23,126.74
2024-03-25 20:00:00+08,0,10,10,0,1013934,1013934,126.52,105.34,231.86
2024-03-26 00:00:00+08,0,10,10,0,1013934,1013934,126.52,145.34,271.86
2024-03-26 04:00:00+08,0,10,10,0,1013934,1013934,126.52,185.34,311.86
2024-03-26 08:00:00+08,0,8,8,0,953410,953410,112.7,184.74,297.44
2024-03-26 12:00:00+08,0,6,6,0,759971,759971,112.71,136.73,249.44
2024-03-26 16:00:00+08,0,7,7,0,887418,887418,112.71,162.33,275.04
2024-03-26 20:00:00+08,0,5,5,0,595449,595449,10.06,93.06,103.12
2024-03-27 00:00:00+08,0,6,6,0,690114,690114,10.06,114.27,124.33
2024-03-27 04:00:00+08,0,6,6,0,690114,690114,10.06,138.27,148.33
2024-03-27 08:00:00+08,1,9,10,26811,789909,816720,13.91,169.89,183.8
2024-03-27 12:00:00+08,1,8,9,26811,552623,579434,17.91,140.95,158.86
2024-03-27 16:00:00+08,0,6,6,0,474830,474830,10.08,141.42,151.5
2024-03-27 20:00:00+08,0,8,8,0,618081,618081,22.89,170.47,193.36
2024-03-28 00:00:00+08,0,8,8,0,708357,708357,22.9,185.62,208.52
2024-03-28 04:00:00+08,0,8,8,0,708357,708357,22.9,217.62,240.52
2024-03-28 08:00:00+08,0,8,8,0,723701,723701,22.9,166.03,188.93
2024-03-28 12:00:00+08,0,8,8,0,821515,821515,22.9,175.25,198.15
2024-03-28 16:00:00+08,0,7,7,0,794704,794704,10.08,184.23,194.31
2024-03-28 20:00:00+08,1,7,8,88669,704497,793166,2.59,88.61,91.2
2024-03-29 00:00:00+08,2,7,9,212255,704497,916752,8.92,116.61,125.53
2024-03-29 04:00:00+08,2,8,10,212255,843108,1055363,16.92,148.21,165.13
2024-03-29 08:00:00+08,2,9,11,212255,849992,1062247,24.92,182.16,207.08
2024-03-29 12:00:00+08,2,8,10,212255,815771,1028026,32.92,200.54,233.46
2024-03-29 16:00:00+08,2,6,8,212255,621431,833686,40.92,151.92,192.84
2024-03-29 20:00:00+08,2,7,9,212255,529115,741370,48.92,108.91,157.83
2024-03-30 00:00:00+08,2,12,14,212255,1057549,1269804,56.94,143.71,200.65
2024-03-30 04:00:00+08,2,12,14,212255,1057549,1269804,64.94,191.73,256.67
2024-03-30 08:00:00+08,2,10,12,212255,909928,1122183,72.93,168.74,241.67
2024-03-30 12:00:00+08,1,8,9,123586,868749,992335,38.35,161.18,199.53
2024-03-30 16:00:00+08,1,6,7,123586,645367,768953,42.35,131.54,173.89
2024-03-30 20:00:00+08,1,4,5,123586,502232,625818,96.26,63.8,160.06
2024-03-31 00:00:00+08,2,4,6,176369,502232,678601,103.96,79.8,183.76
2024-03-31 04:00:00+08,3,7,10,241733,780681,1022414,113.71,102.19,215.9
2024-03-31 08:00:00+08,3,7,10,241733,780681,1022414,125.71,130.19,255.9
2024-03-31 12:00:00+08,4,7,11,276501,780681,1057182,137.81,158.19,296
2024-03-31 16:00:00+08,4,6,10,276501,666792,943293,153.8,144.62,298.42
2024-03-31 20:00:00+08,4,4,8,276501,418595,695096,119.9,98.86,218.76
2024-04-01 00:00:00+08,4,3,7,276501,333890,610391,135.9,91.06,226.96
2024-04-01 04:00:00+08,5,3,8,354442,333890,688332,155.44,103.06,258.5
2024-04-01 08:00:00+08,5,3,8,354442,333890,688332,175.44,115.06,290.5
2024-04-01 12:00:00+08,4,3,7,301659,333890,635549,155.76,127.06,282.82
2024-04-01 16:00:00+08,2,4,6,143305,490966,634271,53.32,141.38,194.7
2024-04-01 20:00:00+08,2,10,12,143305,1005840,1149145,227.66,170.74,398.4
2024-04-02 00:00:00+08,2,12,14,143305,1090899,1234204,235.69,214,449.69
2024-04-02 04:00:00+08,1,11,12,77941,967313,1045254,101.3,252.29,353.59
2024-04-02 08:00:00+08,2,10,12,201527,945396,1146923,127.91,232.47,360.38
2024-04-02 12:00:00+08,2,9,11,201527,805250,1006777,135.91,187.97,323.88
2024-04-02 16:00:00+08,1,7,8,77941,649606,727547,90.42,178.49,268.91
2024-04-02 20:00:00+08,1,8,9,77941,768357,846298,94.42,185.08,279.5
2024-04-03 00:00:00+08,1,9,10,77941,892968,970909,98.42,217.6,316.02
2024-04-03 04:00:00+08,0,8,8,0,821712,821712,50.88,223.5,274.38
2024-04-03 08:00:00+08,0,7,7,0,754579,754579,0,195.23,195.23
2024-04-03 12:00:00+08,0,7,7,0,754579,754579,0,223.23,223.23
2024-04-03 16:00:00+08,0,6,6,0,597503,597503,0,200.91,200.91
2024-04-03 20:00:00+08,0,10,10,0,907623,907623,0,208.46,208.46
2024-04-04 00:00:00+08,0,12,12,0,1054557,1054557,0,251.67,251.67
2024-04-04 04:00:00+08,0,12,12,0,1054557,1054557,0,299.67,299.67
2024-04-04 08:00:00+08,0,12,12,0,1054557,1054557,0,347.67,347.67
2024-04-04 12:00:00+08,0,12,12,0,1054557,1054557,0,395.67,395.67
2024-04-04 16:00:00+08,0,12,12,0,1054557,1054557,0,443.67,443.67
2024-04-04 20:00:00+08,0,8,8,0,677950,677950,0,282.36,282.36
2024-04-05 00:00:00+08,0,5,5,0,518818,518818,0,230.55,230.55
2024-04-05 04:00:00+08,0,12,12,0,1074647,1074647,96.73,267.13,363.86
2024-04-05 08:00:00+08,0,13,13,0,1081531,1081531,96.73,316.96,413.69
2024-04-05 12:00:00+08,0,13,13,0,1081531,1081531,96.73,368.96,465.69
2024-04-05 16:00:00+08,0,13,13,0,1081531,1081531,96.73,420.96,517.69
2024-04-05 20:00:00+08,0,11,11,0,818999,818999,96.73,350.43,447.16
2024-04-06 00:00:00+08,0,9,9,0,647625,647625,96.73,317.28,414.01
2024-04-06 04:00:00+08,0,11,11,0,882003,882003,96.74,358.95,455.69
2024-04-06 08:00:00+08,0,9,9,0,690010,690010,96.74,299.06,395.8
2024-04-06 12:00:00+08,0,6,6,0,563965,563965,96.74,161.45,258.19
2024-04-06 16:00:00+08,0,4,4,0,349593,349593,96.74,108.21,204.95
2024-04-06 20:00:00+08,0,7,7,0,506016,506016,96.74,129,225.74
2024-04-07 00:00:00+08,0,9,9,0,639166,639166,96.74,161.98,258.72
2024-04-07 04:00:00+08,0,9,9,0,639166,639166,96.74,197.98,294.72
2024-04-07 08:00:00+08,0,9,9,0,639166,639166,96.74,233.98,330.72
2024-04-07 12:00:00+08,0,7,7,0,677934,677934,96.74,182.46,279.2
2024-04-07 16:00:00+08,0,5,5,0,532385,532385,96.73,110.9,207.63
2024-04-07 20:00:00+08,0,6,6,0,597980,597980,96.73,110.1,206.83
2024-04-08 00:00:00+08,0,9,9,0,978738,978738,96.73,141.44,238.17
2024-04-08 04:00:00+08,0,10,10,0,1110006,1110006,96.73,177.52,274.25
2024-04-08 08:00:00+08,0,10,10,0,1110006,1110006,96.73,217.52,314.25
2024-04-08 12:00:00+08,0,10,10,0,1110006,1110006,96.73,257.52,354.25
2024-04-08 16:00:00+08,0,6,6,0,747957,747957,0,125.34,125.34
2024-04-08 20:00:00+08,0,11,11,0,1078490,1078490,0,156.41,156.41
2024-04-09 00:00:00+08,0,11,11,0,1078490,1078490,0,200.41,200.41
2024-04-09 04:00:00+08,0,11,11,0,1078490,1078490,0,244.41,244.41
2024-04-09 08:00:00+08,1,11,12,126591,1078490,1205081,0.29,244.01,244.3
2024-04-09 12:00:00+08,1,10,11,126591,1044260,1170851,4.29,271.01,275.3
2024-04-09 16:00:00+08,1,5,6,126591,632512,759103,8.29,151.76,160.05
2024-04-09 20:00:00+08,1,8,9,126591,830443,957034,12.29,153.99,166.28
2024-04-10 00:00:00+08,1,9,10,126591,915226,1041817,16.29,188.94,205.23
2024-04-10 04:00:00+08,1,9,10,126591,915226,1041817,20.29,224.94,245.23
2024-04-10 08:00:00+08,1,10,11,126591,1055467,1182058,24.29,264.72,289.01
2024-04-10 12:00:00+08,1,9,10,126591,891702,1018293,28.29,230.42,258.71
2024-04-10 16:00:00+08,1,5,6,126591,499518,626109,32.3,94.04,126.34
2024-04-10 20:00:00+08,1,7,8,126591,599901,726492,36.3,69.78,106.08
2024-04-11 00:00:00+08,1,7,8,126591,599901,726492,40.3,97.78,138.08
2024-04-11 04:00:00+08,1,8,9,126591,661510,788101,44.3,126.21,170.51
2024-04-11 08:00:00+08,1,8,9,126591,661510,788101,48.3,158.21,206.51
2024-04-11 12:00:00+08,1,6,7,126591,500705,627296,52.3,117.57,169.87
2024-04-11 16:00:00+08,1,3,4,126591,264359,390950,56.3,64.08,120.38
2024-04-11 20:00:00+08,1,8,9,126591,561370,687961,60.3,59.1,119.4
2024-04-12 00:00:00+08,0,10,10,0,739951,739951,0,92.34,92.34
2024-04-12 04:00:00+08,0,10,10,0,784986,784986,67.04,100.1,167.14
2024-04-12 08:00:00+08,0,11,11,0,822466,822466,67.04,131.88,198.92
2024-04-12 12:00:00+08,0,9,9,0,724259,724259,67.04,140.12,207.16
2024-04-12 16:00:00+08,0,8,8,0,672203,672203,67.04,154.73,221.77
2024-04-12 20:00:00+08,0,8,8,0,741584,741584,67.04,163.21,230.25
2024-04-13 00:00:00+08,1,7,8,30231,633234,663465,70.3,141.87,212.17
2024-04-13 04:00:00+08,1,7,8,115414,633234,748648,69.74,169.87,239.61
2024-04-13 08:00:00+08,1,9,10,115414,780640,896054,84.38,201.35,285.73
2024-04-13 12:00:00+08,1,6,7,115414,595175,710589,88.38,134.07,222.45
2024-04-13 16:00:00+08,0,4,4,0,403220,403220,10.68,86.26,96.94
2024-04-13 20:00:00+08,0,7,7,0,661363,661363,27.78,109.05,136.83
2024-04-14 00:00:00+08,1,6,7,141458,546186,687644,28.11,84.41,112.52
2024-04-14 04:00:00+08,1,6,7,141458,546186,687644,32.11,108.41,140.52
2024-04-14 08:00:00+08,1,4,5,141458,476872,618330,25.45,92.03,117.48
2024-04-14 12:00:00+08,0,4,4,0,476872,476872,17.1,108.03,125.13
2024-04-14 16:00:00+08,0,5,5,0,618330,618330,32.42,125.06,157.48
2024-04-14 20:00:00+08,0,6,6,0,770673,770673,32.43,145.2,177.63
2024-04-15 00:00:00+08,0,7,7,0,843641,843641,32.43,171.94,204.37
2024-04-15 04:00:00+08,0,7,7,0,878606,878606,32.44,166.8,199.24
2024-04-15 08:00:00+08,0,8,8,0,983258,983258,32.42,196.55,228.97
2024-04-15 12:00:00+08,0,8,8,0,983258,983258,32.42,228.55,260.97
2024-04-15 16:00:00+08,0,7,7,0,780669,780669,15.33,145.2,160.53
2024-04-15 20:00:00+08,0,10,10,0,923740,923740,15.32,118.47,133.79
2024-04-16 00:00:00+08,0,11,11,0,1025614,1025614,15.32,162.15,177.47
2024-04-16 04:00:00+08,0,11,11,0,1025614,1025614,15.32,206.15,221.47
2024-04-16 08:00:00+08,0,10,10,0,873271,873271,15.3,214.02,229.32
2024-04-16 12:00:00+08,0,6,6,0,711819,711819,15.3,159.22,174.52
2024-04-16 16:00:00+08,0,4,4,0,522396,522396,15.3,128.06,143.36
2024-04-16 20:00:00+08,0,9,9,0,921421,921421,15.3,156.37,171.67
2024-04-17 00:00:00+08,0,9,9,0,921421,921421,15.3,192.37,207.67
2024-04-17 04:00:00+08,0,9,9,0,921421,921421,15.3,228.37,243.67
2024-04-17 08:00:00+08,0,9,9,0,921421,921421,15.3,264.37,279.67
2024-04-17 12:00:00+08,0,8,8,0,819547,819547,15.3,260.69,275.99
2024-04-17 16:00:00+08,0,7,7,0,768940,768940,15.3,271.04,286.34
2024-04-17 20:00:00+08,0,6,6,0,658379,658379,0,169.34,169.34
2024-04-18 00:00:00+08,0,7,7,0,684399,684399,0,193.7,193.7
2024-04-18 04:00:00+08,0,7,7,0,684399,684399,0,221.7,221.7
2024-04-18 08:00:00+08,0,7,7,0,682822,682822,0,214.95,214.95
2024-04-18 12:00:00+08,0,7,7,0,576590,576590,0,179.86,179.86
2024-04-18 16:00:00+08,0,6,6,0,550570,550570,0,191.5,191.5
2024-04-18 20:00:00+08,0,12,12,0,975409,975409,0,200.22,200.22
2024-04-19 00:00:00+08,0,13,13,0,997478,997478,0,166.51,166.51
2024-04-19 04:00:00+08,0,13,13,0,997478,997478,0,218.51,218.51
2024-04-19 08:00:00+08,0,15,15,0,1224154,1224154,0,275.35,275.35
2024-04-19 12:00:00+08,1,15,16,113964,1224154,1338118,0.55,335.35,335.9
2024-04-19 16:00:00+08,1,10,11,113964,1017740,1131704,4.55,279.9,284.45
2024-04-19 20:00:00+08,1,10,11,113964,1083798,1197762,8.55,185.58,194.13
2024-04-20 00:00:00+08,1,10,11,113964,1083798,1197762,12.55,225.58,238.13
2024-04-20 04:00:00+08,1,11,12,127076,1148311,1275387,3.94,268.13,272.07
2024-04-20 08:00:00+08,1,8,9,127076,950798,1077874,7.94,201.64,209.58
2024-04-20 12:00:00+08,1,8,9,127076,934189,1061265,33.34,206.64,239.98
2024-04-20 16:00:00+08,1,5,6,127076,567751,694827,37.34,113.07,150.41
2024-04-20 20:00:00+08,1,6,7,127076,590742,717818,41.35,86.16,127.51
2024-04-21 00:00:00+08,1,8,9,127076,866351,993427,45.35,89.24,134.59
2024-04-21 04:00:00+08,1,9,10,127076,1012864,1139940,49.35,123.69,173.04
2024-04-21 08:00:00+08,1,9,10,127076,991170,1118246,53.35,122.35,175.7
2024-04-21 12:00:00+08,1,9,10,127076,991170,1118246,57.35,158.35,215.7
2024-04-21 16:00:00+08,2,9,11,258320,991170,1249490,62.64,194.35,256.99
2024-04-21 20:00:00+08,2,9,11,258320,938815,1197135,49.23,196.84,246.07
2024-04-22 00:00:00+08,1,10,11,131244,976697,1107941,9.28,233.59,242.87
2024-04-22 04:00:00+08,1,8,9,131244,794096,925340,13.28,153.43,166.71
2024-04-22 08:00:00+08,1,10,11,131244,972041,1103285,70.77,188.18,258.95
2024-04-22 12:00:00+08,1,8,9,131244,801069,932313,74.74,157.21,231.95
2024-04-22 16:00:00+08,1,8,9,131244,801069,932313,78.74,189.21,267.95
2024-04-22 20:00:00+08,1,6,7,131244,599946,731190,82.76,132.43,215.19
2024-04-23 00:00:00+08,1,8,9,131244,779742,910986,86.75,158.96,245.71
2024-04-23 04:00:00+08,1,8,9,131244,779742,910986,90.75,190.96,281.71
2024-04-23 08:00:00+08,1,8,9,131244,818069,949313,94.75,211.95,306.7
2024-04-23 12:00:00+08,0,7,7,0,767200,767200,53.48,215.66,269.14
2024-04-23 16:00:00+08,0,3,3,0,346772,346772,0,65.19,65.19
2024-04-23 20:00:00+08,0,7,7,0,754102,754102,49.82,86.03,135.85
2024-04-24 00:00:00+08,0,9,9,0,851940,851940,49.82,116.1,165.92
2024-04-24 04:00:00+08,0,10,10,0,987634,987634,49.83,152.66,202.49
2024-04-24 08:00:00+08,0,11,11,0,1106469,1106469,49.8,195.34,245.14
2024-04-24 12:00:00+08,0,9,9,0,1031770,1031770,49.8,195.47,245.27
2024-04-24 16:00:00+08,0,10,10,0,1065932,1065932,49.8,234.8,284.6
2024-04-24 20:00:00+08,0,7,7,0,705570,705570,49.83,157.72,207.55
2024-04-25 00:00:00+08,0,11,11,0,1180319,1180319,49.83,190.96,240.79
2024-04-25 04:00:00+08,0,10,10,0,1061484,1061484,49.84,212.31,262.15
2024-04-25 08:00:00+08,0,9,9,0,978611,978611,49.84,140.1,189.94
2024-04-25 12:00:00+08,0,10,10,0,1073211,1073211,49.83,179.06,228.89
2024-04-25 16:00:00+08,0,8,8,0,975622,975622,49.83,169.85,219.68
2024-04-25 20:00:00+08,0,10,10,0,1035760,1035760,49.83,185.28,235.11
2024-04-26 00:00:00+08,0,12,12,0,1084234,1084234,49.83,227.22,277.05
2024-04-26 04:00:00+08,0,12,12,0,1084234,1084234,49.83,275.22,325.05
2024-04-26 08:00:00+08,0,13,13,0,1211681,1211681,49.84,324.22,374.06
2024-04-26 12:00:00+08,0,12,12,0,1080437,1080437,0,308.79,308.79
2024-04-26 16:00:00+08,0,9,9,0,888836,888836,0,277.09,277.09
2024-04-26 20:00:00+08,0,8,8,0,784538,784538,0,209.05,209.05
2024-04-27 00:00:00+08,0,7,7,0,637747,637747,0,192,192
2024-04-27 04:00:00+08,0,6,6,0,594647,594647,0,118.71,118.71
2024-04-27 08:00:00+08,0,5,5,0,587763,587763,0,109.75,109.75
2024-04-27 12:00:00+08,0,3,3,0,320981,320981,0,47.08,47.08
2024-04-27 16:00:00+08,0,3,3,0,351293,351293,0,39.17,39.17
2024-04-27 20:00:00+08,0,7,7,0,701537,701537,0,58.16,58.16
2024-04-28 00:00:00+08,0,7,7,0,701537,701537,0,86.16,86.16
2024-04-28 04:00:00+08,0,6,6,0,635647,635647,0,81.91,81.91
2024-04-28 08:00:00+08,0,8,8,0,738767,738767,0,111.57,111.57
2024-04-28 12:00:00+08,0,7,7,0,713529,713529,0,126.31,126.31
2024-04-28 16:00:00+08,0,6,6,0,660746,660746,0,143.79,143.79
2024-04-28 20:00:00+08,0,6,6,0,594224,594224,0,126.31,126.31
2024-04-29 00:00:00+08,1,6,7,109000,594224,703224,1.71,150.31,152.02
2024-04-29 04:00:00+08,1,3,4,109000,303429,412429,5.72,77.6,83.32
2024-04-29 08:00:00+08,1,4,5,109000,430505,539505,9.72,92.15,101.87
2024-04-29 12:00:00+08,1,4,5,109000,430505,539505,13.72,108.15,121.87
2024-04-29 16:00:00+08,1,4,5,109000,430505,539505,17.72,124.15,141.87
2024-04-29 20:00:00+08,1,7,8,109000,756200,865200,21.71,97.51,119.22
2024-04-30 00:00:00+08,1,8,9,109000,909714,1018714,25.71,128.61,154.32
2024-04-30 04:00:00+08,1,8,9,109000,909714,1018714,29.71,160.61,190.32
2024-04-30 08:00:00+08,1,8,9,109000,909714,1018714,33.71,192.61,226.32
2024-04-30 12:00:00+08,1,8,9,109000,909714,1018714,37.71,224.61,262.32
2024-04-30 16:00:00+08,0,5,5,0,587187,587187,0,105.56,105.56
2024-04-30 20:00:00+08,0,6,6,0,681994,681994,42.98,105.58,148.56
2024-05-01 00:00:00+08,0,10,10,0,920211,920211,42.98,132.8,175.78
2024-05-01 04:00:00+08,0,10,10,0,920211,920211,42.98,172.8,215.78
2024-05-01 08:00:00+08,0,9,9,0,842265,842265,42.98,174.89,217.87
2024-05-01 12:00:00+08,0,10,10,0,876761,876761,42.98,211.46,254.44
2024-05-01 16:00:00+08,0,6,6,0,558465,558465,0,144.3,144.3
2024-05-01 20:00:00+08,0,9,9,0,690086,690086,1.74,152.39,154.13
2024-05-02 00:00:00+08,0,9,9,0,770605,770605,1.74,164.54,166.28
2024-05-02 04:00:00+08,0,8,8,0,688993,688993,1.74,172.46,174.2
2024-05-02 08:00:00+08,0,8,8,0,573214,573214,1.72,146.16,147.88
2024-05-02 12:00:00+08,0,7,7,0,567210,567210,0,145.3,145.3
2024-05-02 16:00:00+08,0,6,6,0,532714,532714,0,144.74,144.74
2024-05-02 20:00:00+08,0,6,6,0,509592,509592,0,136.04,136.04
2024-05-03 00:00:00+08,1,6,7,85437,509592,595029,3.19,160.04,163.23
2024-05-03 04:00:00+08,1,7,8,85437,493535,578972,7.19,110.09,117.28
2024-05-03 08:00:00+08,1,7,8,85437,583526,668963,11.18,84.6,95.78
2024-05-03 12:00:00+08,1,7,8,85437,583526,668963,15.18,112.6,127.78
2024-05-03 16:00:00+08,0,6,6,0,531470,531470,0,118.84,118.84
2024-05-03 20:00:00+08,0,10,10,0,863889,863889,21.84,149.72,171.56
2024-05-04 00:00:00+08,0,10,10,0,875750,875750,21.84,159.8,181.64
2024-05-04 04:00:00+08,1,11,12,156055,939145,1095200,24.12,203.64,227.76
2024-05-04 08:00:00+08,1,10,11,156055,921021,1077076,28.12,203.22,231.34
2024-05-04 12:00:00+08,1,9,10,156055,824918,980973,32.12,212.02,244.14
2024-05-04 16:00:00+08,0,7,7,0,630950,630950,21.84,194.29,216.13
2024-05-04 20:00:00+08,0,10,10,0,927153,927153,38.56,190.47,229.03
2024-05-05 00:00:00+08,1,9,10,104600,841716,946316,17.81,201.13,218.94
2024-05-05 04:00:00+08,1,8,9,104600,727712,832312,21.81,203.3,225.11
2024-05-05 08:00:00+08,2,6,8,256944,608521,865465,27.88,178.53,206.41
2024-05-05 12:00:00+08,2,5,7,256944,546912,803856,35.88,185.25,221.13
2024-05-05 16:00:00+08,2,5,7,256944,546912,803856,43.88,205.25,249.13
2024-05-05 20:00:00+08,2,9,11,256944,949871,1206815,51.89,207.42,259.31
2024-05-06 00:00:00+08,2,8,10,256944,841893,1098837,59.88,189.37,249.25
2024-05-06 04:00:00+08,2,8,10,256944,841893,1098837,67.88,221.37,289.25
2024-05-06 08:00:00+08,2,7,9,256944,722675,979619,59.16,205.27,264.43
2024-05-06 12:00:00+08,2,7,9,256944,722675,979619,67.16,233.27,300.43
2024-05-06 16:00:00+08,0,5,5,0,457437,457437,0,193.15,193.15
2024-05-06 20:00:00+08,0,7,7,0,586203,586203,42.36,195.33,237.69
2024-05-07 00:00:00+08,0,7,7,0,586203,586203,42.36,223.33,265.69
2024-05-07 04:00:00+08,0,9,9,0,809660,809660,85.4,255.42,340.82
2024-05-07 08:00:00+08,0,9,9,0,946192,946192,85.41,277.69,363.1
2024-05-07 12:00:00+08,0,7,7,0,818330,818330,85.41,144.51,229.92
2024-05-07 16:00:00+08,0,6,6,0,714682,714682,85.41,127.43,212.84
2024-05-07 20:00:00+08,0,7,7,0,731745,731745,85.41,128.91,214.32
2024-05-08 00:00:00+08,0,8,8,0,825297,825297,85.41,159.73,245.14
2024-05-08 04:00:00+08,0,8,8,0,825297,825297,85.41,191.73,277.14
2024-05-08 08:00:00+08,0,6,6,0,719118,719118,85.41,181.14,266.55
2024-05-08 12:00:00+08,0,5,5,0,574975,574975,85.4,139.11,224.51
2024-05-08 16:00:00+08,0,6,6,0,721566,721566,85.41,159.6,245.01
2024-05-08 20:00:00+08,0,9,9,0,859404,859404,42.36,150.14,192.5
2024-05-09 00:00:00+08,0,10,10,0,1006154,1006154,42.36,132.04,174.4
2024-05-09 04:00:00+08,0,10,10,0,1006154,1006154,42.36,172.04,214.4
2024-05-09 08:00:00+08,0,12,12,0,1149889,1149889,42.36,218.21,260.57
2024-05-09 12:00:00+08,0,12,12,0,1149889,1149889,42.36,266.21,308.57
2024-05-09 16:00:00+08,1,9,10,52783,1005435,1058218,42.66,258.09,300.75
2024-05-09 20:00:00+08,1,10,11,52783,1021283,1074066,4.3,222.76,227.06
2024-05-10 00:00:00+08,1,11,12,52783,993218,1046001,8.31,148.64,156.95
2024-05-10 04:00:00+08,1,12,13,52783,1044889,1097672,12.31,194.97,207.28
2024-05-10 08:00:00+08,1,11,12,52783,1010121,1062904,16.31,229.55,245.86
2024-05-10 12:00:00+08,1,12,13,52783,1163859,1216642,20.31,275.43,295.74
2024-05-10 16:00:00+08,1,11,12,99500,1078179,1177679,3.23,301.43,304.66
2024-05-10 20:00:00+08,1,12,13,99500,1144566,1244066,32.7,305.07,337.77
2024-05-11 00:00:00+08,1,12,13,99500,1117024,1216524,36.66,332.49,369.15
2024-05-11 04:00:00+08,1,12,13,99500,1117024,1216524,40.66,380.49,421.15
2024-05-11 08:00:00+08,1,10,11,99500,1079846,1179346,44.68,332.85,377.53
2024-05-11 12:00:00+08,1,9,10,99500,985402,1084902,23.21,302.09,325.3
2024-05-11 16:00:00+08,1,7,8,99500,815999,915499,27.21,249.02,276.23
2024-05-11 20:00:00+08,1,8,9,99500,838930,938430,31.21,203.03,234.24
2024-05-12 00:00:00+08,1,7,8,99500,606406,705906,35.21,127.39,162.6
2024-05-12 04:00:00+08,1,7,8,99500,593700,693200,39.22,88.32,127.54
2024-05-12 08:00:00+08,1,7,8,99500,679550,779050,43.22,92.33,135.55
2024-05-12 12:00:00+08,1,5,6,99500,583999,683499,47.22,86.2,133.42
2024-05-12 16:00:00+08,1,6,7,99500,710122,809622,51.21,109.15,160.36
2024-05-12 20:00:00+08,1,9,10,99500,1083845,1183345,55.23,119.35,174.58
2024-05-13 00:00:00+08,1,8,9,99500,975867,1075367,59.2,101.6,160.8
2024-05-13 04:00:00+08,1,8,9,99500,938311,1037811,63.19,103.65,166.84
2024-05-13 08:00:00+08,1,8,9,99500,938311,1037811,67.19,135.65,202.84
2024-05-13 12:00:00+08,1,8,9,99500,938311,1037811,71.19,167.65,238.84
2024-05-13 16:00:00+08,1,7,8,99500,879961,979461,75.19,177.69,252.88
2024-05-13 20:00:00+08,1,9,10,99500,955003,1054503,79.19,210.11,289.3
2024-05-14 00:00:00+08,1,8,9,99500,838903,938403,83.21,217.6,300.81
2024-05-14 04:00:00+08,1,9,10,99500,983475,1082975,87.21,252.65,339.86
2024-05-14 08:00:00+08,1,9,10,99500,983475,1082975,91.21,288.65,379.86
2024-05-14 12:00:00+08,1,8,9,99500,946814,1046314,95.22,268.08,363.3
2024-05-14 16:00:00+08,1,5,6,99500,643789,743289,99.21,181.68,280.89
2024-05-14 20:00:00+08,0,4,4,0,456381,456381,0,34.82,34.82
2024-05-15 00:00:00+08,0,8,8,0,930241,930241,104.48,58.02,162.5
2024-05-15 04:00:00+08,1,8,9,61609,930241,991850,107.07,90.02,197.09
2024-05-15 08:00:00+08,1,9,10,61609,957266,1018875,111.07,124.44,235.51
2024-05-15 12:00:00+08,1,8,9,61609,872578,934187,115.07,141.67,256.74
2024-05-15 16:00:00+08,1,8,9,61609,872578,934187,119.07,173.67,292.74
2024-05-15 20:00:00+08,2,8,10,126339,824932,951271,126.47,169.48,295.95
2024-05-16 00:00:00+08,2,10,12,126339,1107603,1233942,134.47,204.12,338.59
2024-05-16 04:00:00+08,2,10,12,126339,1107603,1233942,142.47,244.12,386.59
2024-05-16 08:00:00+08,1,11,12,61609,1226417,1288026,135.07,287.05,422.12
2024-05-16 12:00:00+08,1,11,12,61609,1191647,1253256,52.93,293.35,346.28
2024-05-16 16:00:00+08,0,9,9,0,963874,963874,18.37,254.59,272.96
2024-05-16 20:00:00+08,0,12,12,0,1159920,1159920,58.89,271.29,330.18
2024-05-17 00:00:00+08,1,12,13,34083,1132642,1166725,61.39,289.51,350.9
2024-05-17 04:00:00+08,1,12,13,34083,1051246,1085329,65.38,262.76,328.14
2024-05-17 08:00:00+08,1,11,12,34083,905719,939802,69.38,239.91,309.29
2024-05-17 12:00:00+08,1,10,11,34083,759132,793215,73.38,222.22,295.6
2024-05-17 16:00:00+08,1,8,9,34083,575654,609737,77.39,198.89,276.28
2024-05-17 20:00:00+08,1,9,10,34083,728376,762459,40.87,170.45,211.32
2024-05-18 00:00:00+08,1,12,13,34083,916661,950744,44.87,213.05,257.92
2024-05-18 04:00:00+08,1,12,13,34083,916661,950744,48.87,261.05,309.92
2024-05-18 08:00:00+08,1,9,10,34083,652352,686435,52.85,168.65,221.5
2024-05-18 12:00:00+08,1,7,8,34083,592448,626531,56.87,130.38,187.25
2024-05-18 16:00:00+08,1,6,7,34083,566412,600495,60.86,139.05,199.91
2024-05-18 20:00:00+08,1,8,9,34083,786330,820413,64.86,120.39,185.25
2024-05-19 00:00:00+08,1,9,10,34083,918365,952448,68.86,152.76,221.62
2024-05-19 04:00:00+08,1,9,10,34083,918365,952448,72.86,188.76,261.62
2024-05-19 08:00:00+08,1,9,10,34083,998207,1032290,58.5,158.34,216.84
2024-05-19 12:00:00+08,1,8,9,34083,957729,991812,62.5,176.37,238.87
2024-05-19 16:00:00+08,1,7,8,34083,880315,914398,66.5,167.46,233.96
2024-05-19 20:00:00+08,2,8,10,146314,1024196,1170510,70.97,164.59,235.56
2024-05-20 00:00:00+08,2,8,10,146314,1024196,1170510,78.97,196.59,275.56
2024-05-20 04:00:00+08,2,7,9,146314,933470,1079784,86.97,137.08,224.05
2024-05-20 08:00:00+08,2,6,8,146314,794135,940449,94.97,128.2,223.17
2024-05-20 12:00:00+08,2,6,8,146314,794135,940449,102.97,152.2,255.17
2024-05-20 16:00:00+08,2,5,7,146314,685561,831875,110.97,152.89,263.86
2024-05-20 20:00:00+08,2,8,10,146314,789852,936166,118.97,134.47,253.44
2024-05-21 00:00:00+08,1,8,9,112231,789852,902083,28.47,166.47,194.94
2024-05-21 04:00:00+08,0,9,9,0,823935,823935,101.52,199.45,300.97
2024-05-21 08:00:00+08,0,9,9,0,1006481,1006481,135.19,213.32,348.51
2024-05-21 12:00:00+08,0,10,10,0,1094318,1094318,135.19,250.24,385.43
2024-05-21 16:00:00+08,0,9,9,0,953087,953087,135.19,221.58,356.77
2024-05-21 20:00:00+08,0,9,9,0,953087,953087,135.19,257.58,392.77
2024-05-22 00:00:00+08,1,8,9,101661,868984,970645,135.22,221.29,356.51
2024-05-22 04:00:00+08,2,9,11,167025,940240,1107265,141.38,255.85,397.23
2024-05-22 08:00:00+08,2,9,11,167025,918627,1085652,149.41,220.5,369.91
2024-05-22 12:00:00+08,2,11,13,167025,983279,1150304,157.43,259.38,416.81
2024-05-22 16:00:00+08,2,11,13,167025,913950,1080975,165.43,234.71,400.14
2024-05-22 20:00:00+08,2,13,15,167025,1100148,1267173,173.4,285.52,458.92
2024-05-23 00:00:00+08,2,13,15,169255,1100148,1269403,161.36,337.52,498.88
2024-05-23 04:00:00+08,2,12,14,169255,1100397,1269652,194.74,348.35,543.09
2024-05-23 08:00:00+08,2,12,14,169255,1100397,1269652,202.74,396.35,599.09
2024-05-23 12:00:00+08,2,11,13,169255,978354,1147609,210.71,343.61,554.32
2024-05-23 16:00:00+08,1,9,10,65364,813285,878649,198.67,317.46,516.13
2024-05-23 20:00:00+08,1,12,13,65364,924436,989800,225.32,258.1,483.42
2024-05-24 00:00:00+08,1,11,12,65364,696130,761494,195.65,197.25,392.9
2024-05-24 04:00:00+08,1,10,11,65364,656704,722068,199.66,206.12,405.78
2024-05-24 08:00:00+08,0,10,10,0,656704,656704,149.5,246.12,395.62
2024-05-24 12:00:00+08,0,6,6,0,466191,466191,149.48,206.03,355.51
2024-05-24 16:00:00+08,0,6,6,0,466191,466191,149.48,230.03,379.51
2024-05-24 20:00:00+08,0,10,10,0,834718,834718,213.44,263.08,476.52
2024-05-25 00:00:00+08,0,10,10,0,887025,887025,190.84,275.78,466.62
2024-05-25 04:00:00+08,0,11,11,0,1013225,1013225,190.87,287.81,478.68
2024-05-25 08:00:00+08,0,11,11,0,1074388,1074388,190.83,300.75,491.58
2024-05-25 12:00:00+08,0,11,11,0,1074388,1074388,190.83,344.75,535.58
2024-05-25 16:00:00+08,0,8,8,0,762555,762555,165.52,231.94,397.46
2024-05-25 20:00:00+08,0,11,11,0,1048928,1048928,101.52,242.1,343.62
2024-05-26 00:00:00+08,0,14,14,0,1348604,1348604,101.52,289.57,391.09
2024-05-26 04:00:00+08,0,13,13,0,1254078,1254078,101.52,311.56,413.08
2024-05-26 08:00:00+08,0,13,13,0,1254078,1254078,101.52,363.56,465.08
2024-05-26 12:00:00+08,0,13,13,0,1340900,1340900,101.52,380.06,481.58
2024-05-26 16:00:00+08,0,11,11,0,1233689,1233689,101.53,376.81,478.34
2024-05-26 20:00:00+08,0,9,9,0,1074247,1074247,101.53,373.83,475.36
2024-05-27 00:00:00+08,0,9,9,0,952344,952344,101.52,360.82,462.34
2024-05-27 04:00:00+08,0,10,10,0,1051410,1051410,101.52,400.04,501.56
2024-05-27 08:00:00+08,0,9,9,0,942389,942389,101.52,403.38,504.9
2024-05-27 12:00:00+08,0,9,9,0,942389,942389,101.52,439.38,540.9
2024-05-27 16:00:00+08,2,9,11,48209,942389,990598,103.52,475.38,578.9
2024-05-27 20:00:00+08,2,9,11,48209,942389,990598,111.52,511.38,622.9
2024-05-28 00:00:00+08,0,5,5,0,511266,511266,101.53,350.87,452.4
2024-05-28 04:00:00+08,0,7,7,0,549231,549231,124.68,295.52,420.2
2024-05-28 08:00:00+08,0,8,8,0,586006,586006,124.68,242.27,366.95
2024-05-28 12:00:00+08,0,7,7,0,559059,559059,113.5,264.29,377.79
2024-05-28 16:00:00+08,0,6,6,0,537797,537797,101.53,279.46,380.99
2024-05-28 20:00:00+08,0,7,7,0,628318,628318,101.53,291.48,393.01
2024-05-29 00:00:00+08,0,7,7,0,628318,628318,101.53,319.48,421.01
2024-05-29 04:00:00+08,0,8,8,0,662539,662539,101.52,350.95,452.47
2024-05-29 08:00:00+08,0,8,8,0,662539,662539,101.52,382.95,484.47
2024-05-29 12:00:00+08,0,8,8,0,662539,662539,101.52,414.95,516.47
2024-05-29 16:00:00+08,0,6,6,0,520530,520530,101.52,388.5,490.02
2024-05-29 20:00:00+08,0,10,10,0,775708,775708,101.52,424.02,525.54
2024-05-30 00:00:00+08,0,10,10,0,775708,775708,101.52,464.02,565.54
2024-05-30 04:00:00+08,0,9,9,0,748659,748659,101.52,390.45,491.97
2024-05-30 08:00:00+08,0,9,9,0,822720,822720,101.52,393.54,495.06
2024-05-30 12:00:00+08,0,9,9,0,822720,822720,101.52,429.54,531.06
2024-05-30 16:00:00+08,0,7,7,0,582546,582546,101.52,345.87,447.39
2024-05-30 20:00:00+08,0,9,9,0,717498,717498,101.52,352.77,454.29
2024-05-31 00:00:00+08,0,10,10,0,714320,714320,101.55,359.6,461.15
2024-05-31 04:00:00+08,0,12,12,0,927246,927246,101.55,402.13,503.68
2024-05-31 08:00:00+08,0,13,13,0,951973,951973,101.52,415.12,516.64
2024-05-31 12:00:00+08,0,11,11,0,870071,870071,101.55,406.6,508.15
2024-05-31 16:00:00+08,0,11,11,0,870071,870071,101.55,450.6,552.15
2024-05-31 20:00:00+08,0,11,11,0,913152,913152,101.55,452.51,554.06
2024-06-01 00:00:00+08,0,12,12,0,1094239,1094239,101.52,480.29,581.81
2024-06-01 04:00:00+08,1,11,12,85890,1029720,1115610,104.82,503.44,608.26
2024-06-01 08:00:00+08,1,10,11,85890,1069205,1155095,108.83,492.5,601.33
2024-06-01 12:00:00+08,1,9,10,85890,984517,1070407,112.82,513.83,626.65
2024-06-01 16:00:00+08,1,7,8,85890,754536,840426,116.82,466.45,583.27
2024-06-01 20:00:00+08,1,8,9,85890,838409,924299,120.82,477.34,598.16
2024-06-02 00:00:00+08,2,8,10,189558,839624,1029182,24.76,154.56,179.32
2024-06-02 04:00:00+08,2,8,10,189558,840630,1030188,32.76,156.8,189.56
2024-06-02 08:00:00+08,2,7,9,189558,778994,968552,40.76,174.74,215.5
2024-06-02 12:00:00+08,3,7,10,328465,778994,1107459,51.21,202.74,253.95
2024-06-02 16:00:00+08,2,5,7,242575,561103,803678,23.93,131.32,155.25
2024-06-02 20:00:00+08,2,7,9,242575,797674,1040249,73.23,117.77,191
2024-06-03 00:00:00+08,2,6,8,289682,645330,935012,56.07,95.37,151.44
2024-06-03 04:00:00+08,2,6,8,289682,645330,935012,64.07,119.37,183.44
2024-06-03 08:00:00+08,2,5,7,289682,558909,848591,101.55,77.31,178.86
2024-06-03 12:00:00+08,2,4,6,289682,448217,737899,109.56,61.18,170.74
2024-06-03 16:00:00+08,2,3,5,289682,362327,652009,76.29,55.16,131.45
2024-06-03 20:00:00+08,2,7,9,289682,717884,1007566,84.29,73.37,157.66
2024-06-04 00:00:00+08,2,7,9,289682,717884,1007566,92.29,101.37,193.66
2024-06-04 04:00:00+08,2,7,9,289682,717884,1007566,100.29,129.37,229.66
2024-06-04 08:00:00+08,2,8,10,289682,768618,1058300,108.29,145.84,254.13
2024-06-04 12:00:00+08,2,8,10,289682,768618,1058300,116.29,177.84,294.13
2024-06-04 16:00:00+08,2,6,8,289682,614156,903838,94.8,151.48,246.28
2024-06-04 20:00:00+08,2,7,9,290110,759280,1049390,44.52,165.24,209.76
2024-06-05 00:00:00+08,2,8,10,290110,771915,1062025,112.36,143.95,256.31
2024-06-05 04:00:00+08,2,6,8,290110,536512,826622,120.36,85.44,205.8
2024-06-05 08:00:00+08,2,9,11,290110,947160,1237270,128.36,95.19,223.55
2024-06-05 12:00:00+08,2,10,12,290110,981322,1271432,136.36,132.12,268.48
2024-06-05 16:00:00+08,2,8,10,290110,802884,1092994,144.36,109.97,254.33
2024-06-05 20:00:00+08,2,11,13,290110,981062,1271172,152.36,149.63,301.99
2024-06-06 00:00:00+08,1,10,11,150775,890261,1041036,132.15,146.91,279.06
2024-06-06 04:00:00+08,1,11,12,150775,1029596,1180371,168.21,187.06,355.27
2024-06-06 08:00:00+08,1,12,13,150775,1131470,1282245,172.21,233.16,405.37
2024-06-06 12:00:00+08,1,10,11,150775,987582,1138357,176.21,220.54,396.75
2024-06-06 16:00:00+08,1,8,9,150775,887679,1038454,180.21,209.35,389.56
2024-06-06 20:00:00+08,1,8,9,150775,829621,980396,184.21,185.23,369.44
2024-06-07 00:00:00+08,1,9,10,150775,877955,1028730,188.18,189.99,378.17
2024-06-07 04:00:00+08,1,10,11,150775,1021998,1172773,192.18,227.17,419.35
2024-06-07 08:00:00+08,1,10,11,150775,1021998,1172773,196.18,267.17,463.35
2024-06-07 12:00:00+08,1,9,10,150775,967800,1118575,200.18,289.14,489.32
2024-06-07 16:00:00+08,1,8,9,150775,841747,992522,204.18,266.27,470.45
2024-06-07 20:00:00+08,1,10,11,150775,927461,1078236,148.4,233.67,382.07
2024-06-08 00:00:00+08,1,10,11,150775,842369,993144,152.4,165.88,318.28
2024-06-08 04:00:00+08,1,10,11,150775,842369,993144,156.4,205.88,362.28
2024-06-08 08:00:00+08,1,10,11,150775,949449,1100224,160.4,214.89,375.29
2024-06-08 12:00:00+08,1,10,11,150775,1048823,1199598,164.38,215.07,379.45
2024-06-08 16:00:00+08,1,8,9,150775,911820,1062595,168.38,212.01,380.39
2024-06-08 20:00:00+08,1,8,9,150775,942175,1092950,172.38,198.18,370.56
2024-06-09 00:00:00+08,0,8,8,0,859120,859120,0,115.35,115.35
2024-06-09 04:00:00+08,0,10,10,0,1078494,1078494,145.26,152.55,297.81
2024-06-09 08:00:00+08,0,10,10,0,1078494,1078494,145.26,192.55,337.81
2024-06-09 12:00:00+08,0,8,8,0,962561,962561,145.26,201.97,347.23
2024-06-09 16:00:00+08,1,7,8,113072,848597,961669,145.67,199.87,345.54
2024-06-09 20:00:00+08,1,8,9,113072,998694,1111766,149.67,204.66,354.33
2024-06-10 00:00:00+08,1,6,7,113072,786052,899124,153.65,145.36,299.01
2024-06-10 04:00:00+08,1,6,7,113072,786052,899124,157.65,169.36,327.01
2024-06-10 08:00:00+08,1,6,7,113072,786052,899124,161.65,193.36,355.01
2024-06-10 12:00:00+08,1,5,6,113072,655479,768551,165.68,180.64,346.32
2024-06-10 16:00:00+08,1,5,6,113072,655479,768551,169.68,200.64,370.32
2024-06-10 20:00:00+08,0,7,7,0,648314,648314,145.24,158.15,303.39
2024-06-11 00:00:00+08,0,5,5,0,387052,387052,145.25,93.72,238.97
2024-06-11 04:00:00+08,1,6,7,35036,500124,535160,180.94,115.92,296.86
2024-06-11 08:00:00+08,0,6,6,0,549945,549945,179.47,128.75,308.22
2024-06-11 12:00:00+08,0,6,6,0,571221,571221,186.57,137.41,323.98
2024-06-11 16:00:00+08,0,6,6,0,516217,516217,186.57,118.87,305.44
2024-06-11 20:00:00+08,0,10,10,0,906739,906739,186.58,148.33,334.91
2024-06-12 00:00:00+08,1,10,11,138907,906739,1045646,186.59,188.33,374.92
2024-06-12 04:00:00+08,1,9,10,138907,871703,1010610,183.49,209.95,393.44
2024-06-12 08:00:00+08,1,9,10,138907,925719,1064626,187.5,221.88,409.38
2024-06-12 12:00:00+08,1,9,10,138907,885759,1024666,191.5,217.63,409.13
2024-06-12 16:00:00+08,1,8,9,138907,847877,986784,195.5,232.77,428.27
2024-06-12 20:00:00+08,1,11,12,138907,948865,1087772,199.5,241.53,441.03
2024-06-13 00:00:00+08,0,11,11,0,900951,900951,34.2,191.03,225.23
2024-06-13 04:00:00+08,0,11,11,0,900951,900951,34.2,235.03,269.23
2024-06-13 08:00:00+08,0,12,12,0,1073858,1073858,62.64,246.33,308.97
2024-06-13 12:00:00+08,0,11,11,0,948917,948917,62.68,252.65,315.33
2024-06-13 16:00:00+08,0,9,9,0,915137,915137,28.47,181.67,210.14
2024-06-13 20:00:00+08,0,11,11,0,1028829,1028829,28.47,220.51,248.98
2024-06-14 00:00:00+08,0,10,10,0,774014,774014,28.46,195.09,223.55
2024-06-14 04:00:00+08,0,11,11,0,889714,889714,28.46,235.87,264.33
2024-06-14 08:00:00+08,0,12,12,0,986693,986693,28.46,248.73,277.19
2024-06-14 12:00:00+08,0,12,12,0,986693,986693,28.46,296.73,325.19
2024-06-14 16:00:00+08,0,8,8,0,713894,713894,28.46,198.58,227.04
2024-06-14 20:00:00+08,1,8,9,41590,661606,703196,0.65,150.72,151.37
2024-06-15 00:00:00+08,2,8,10,104584,661606,766190,5.99,182.72,188.71
2024-06-15 04:00:00+08,2,9,11,104584,821800,926384,13.99,216.11,230.1
2024-06-15 08:00:00+08,2,11,13,104584,1013864,1118448,21.99,229.02,251.01
2024-06-15 12:00:00+08,2,10,12,104584,898164,1002748,29.99,240.25,270.24
2024-06-15 16:00:00+08,1,8,9,41590,815164,856754,20.65,175.09,195.74
2024-06-15 20:00:00+08,1,7,8,41590,820918,862508,43.2,132.31,175.51
2024-06-16 00:00:00+08,1,8,9,41590,882527,924117,47.19,161.21,208.4
2024-06-16 04:00:00+08,1,8,9,41590,882527,924117,51.19,193.21,244.4
2024-06-16 08:00:00+08,1,8,9,41590,889599,931189,55.19,188.01,243.2
2024-06-16 12:00:00+08,2,6,8,114397,764996,879393,44.63,188.33,232.96
2024-06-16 16:00:00+08,1,5,6,72807,685713,758520,7.98,176.97,184.95
2024-06-16 20:00:00+08,1,5,6,72807,586704,659511,58.49,123.08,181.57
2024-06-17 00:00:00+08,2,5,7,186696,543782,730478,65.17,101.5,166.67
2024-06-17 04:00:00+08,2,5,7,186696,543782,730478,73.17,121.5,194.67
2024-06-17 08:00:00+08,2,4,6,186696,502192,688888,34.66,127.36,162.02
2024-06-17 12:00:00+08,2,4,6,186696,502192,688888,42.66,143.36,186.02
2024-06-17 16:00:00+08,2,3,5,186696,341998,528694,50.66,97.97,148.63
2024-06-17 20:00:00+08,1,6,7,113889,557894,671783,22.68,65.68,88.36
2024-06-18 00:00:00+08,1,8,9,113889,762064,875953,65.59,70.45,136.04
2024-06-18 04:00:00+08,1,8,9,113889,762064,875953,69.59,102.45,172.04
2024-06-18 08:00:00+08,1,10,11,113889,946114,1060003,73.59,138.3,211.89
2024-06-18 12:00:00+08,1,10,11,113889,946114,1060003,77.59,178.3,255.89
2024-06-18 16:00:00+08,1,9,10,113889,883055,996944,81.59,196.96,278.55
2024-06-18 20:00:00+08,1,7,8,113889,829428,943317,85.58,170.15,255.73
2024-06-19 00:00:00+08,1,9,10,113889,935395,1049284,89.58,200.83,290.41
2024-06-19 04:00:00+08,2,9,11,186871,935395,1122266,94.59,236.83,331.42
2024-06-19 08:00:00+08,2,7,9,186871,716905,903776,63.69,166.34,230.03
2024-06-19 12:00:00+08,1,9,10,72982,935323,1008305,9.01,200.16,209.17
2024-06-19 16:00:00+08,1,5,6,72982,646250,719232,13,116.49,129.49
2024-06-19 20:00:00+08,1,7,8,72982,688384,761366,84.76,105.9,190.66
2024-06-20 00:00:00+08,2,8,10,99632,805235,904867,89.79,135.55,225.34
2024-06-20 04:00:00+08,2,8,10,99632,805235,904867,97.79,167.55,265.34
2024-06-20 08:00:00+08,2,8,10,99632,798306,897938,105.79,136.53,242.32
2024-06-20 12:00:00+08,2,8,10,99632,798306,897938,113.79,168.53,282.32
2024-06-20 16:00:00+08,2,8,10,204229,798306,1002535,107.61,200.53,308.14
2024-06-20 20:00:00+08,2,10,12,204229,894915,1099144,133.31,132.3,265.61
2024-06-21 00:00:00+08,2,11,13,204229,903334,1107563,141.3,137.25,278.55
2024-06-21 04:00:00+08,2,11,13,204229,903334,1107563,149.3,181.25,330.55
2024-06-21 08:00:00+08,2,12,14,204229,970966,1175195,157.31,228.54,385.85
2024-06-21 12:00:00+08,2,11,13,204229,936745,1140974,165.32,234.67,399.99
2024-06-21 16:00:00+08,2,9,11,204229,770073,974302,105.58,209.5,315.08
2024-06-21 20:00:00+08,2,10,12,204229,804841,1009070,113.6,247.61,361.21
2024-06-22 00:00:00+08,3,10,13,298709,804841,1103550,124.32,287.61,411.93
2024-06-22 04:00:00+08,3,10,13,298709,804841,1103550,136.32,327.61,463.93
2024-06-22 08:00:00+08,3,7,10,298709,633423,932132,130.56,278.06,408.62
2024-06-22 12:00:00+08,3,6,9,298709,637862,936571,142.56,228.26,370.82
2024-06-22 16:00:00+08,2,5,7,167462,534214,701676,103.73,206.35,310.08
2024-06-22 20:00:00+08,2,7,9,167462,641113,808575,111.72,125.19,236.91
2024-06-23 00:00:00+08,2,9,11,167462,835541,1003003,175.5,157.33,332.83
2024-06-23 04:00:00+08,2,7,9,167462,625956,793418,183.5,106.93,290.43
2024-06-23 08:00:00+08,2,7,9,167462,684178,851640,191.49,122.96,314.45
2024-06-23 12:00:00+08,2,7,9,167462,684178,851640,199.49,150.96,350.45
2024-06-23 16:00:00+08,2,6,8,167462,620997,788459,207.49,161.87,369.36
2024-06-23 20:00:00+08,2,7,9,167462,666324,833786,215.49,164.72,380.21
2024-06-24 00:00:00+08,2,8,10,167462,717040,884502,223.49,193.56,417.05
2024-06-24 04:00:00+08,1,7,8,72982,644128,717110,176.77,190.98,367.75
2024-06-24 08:00:00+08,1,7,8,72982,598462,671444,236.68,138.77,375.45
2024-06-24 12:00:00+08,1,7,8,72982,598462,671444,240.68,166.77,407.45
2024-06-24 16:00:00+08,1,5,6,72982,424018,497000,188.91,129.69,318.6
2024-06-24 20:00:00+08,1,8,9,72982,529458,602440,192.9,50.32,243.22
2024-06-25 00:00:00+08,1,7,8,72982,489399,562381,196.9,52.2,249.1
2024-06-25 04:00:00+08,1,7,8,72982,489399,562381,200.9,80.2,281.1
2024-06-25 08:00:00+08,1,7,8,72982,533722,606704,204.93,97.83,302.76
2024-06-25 12:00:00+08,1,6,7,72982,439242,512224,153.01,95.02,248.03
2024-06-25 16:00:00+08,1,6,7,72982,439242,512224,157.01,119.02,276.03
2024-06-25 20:00:00+08,1,7,8,72982,481856,554838,161.01,144.86,305.87
2024-06-26 00:00:00+08,1,5,6,72982,463348,536330,165,88.12,253.12
2024-06-26 04:00:00+08,1,7,8,72982,661382,734364,169,113.96,282.96
2024-06-26 08:00:00+08,1,8,9,72982,769478,842460,173.02,120.2,293.22
2024-06-26 12:00:00+08,1,8,9,72982,706621,779603,176.99,112.3,289.29
2024-06-26 16:00:00+08,1,7,8,72982,664007,736989,180.99,122.46,303.45
2024-06-26 20:00:00+08,1,10,11,72982,902415,975397,184.99,155.65,340.64
2024-06-27 00:00:00+08,1,10,11,72982,902415,975397,188.99,195.65,384.64
2024-06-27 04:00:00+08,1,9,10,72982,848953,921935,192.99,208.53,401.52
2024-06-27 08:00:00+08,1,11,12,72982,998023,1071005,196.99,250.27,447.26
2024-06-27 12:00:00+08,1,9,10,72982,937841,1010823,200.99,250.21,451.2
2024-06-27 16:00:00+08,1,7,8,72982,777247,850229,205,229.95,434.95
2024-06-27 20:00:00+08,1,11,12,72982,1054425,1127407,209,265.74,474.74
2024-06-28 00:00:00+08,1,13,14,72982,1106224,1179206,213,269.12,482.12
2024-06-28 04:00:00+08,1,12,13,72982,967317,1040299,217,265.17,482.17
2024-06-28 08:00:00+08,3,12,15,346038,971210,1317248,222.44,301.83,524.27
2024-06-28 12:00:00+08,2,12,14,200058,1054190,1254248,231.48,340.05,571.53
2024-06-28 16:00:00+08,2,12,14,200058,1094360,1294418,239.48,367.38,606.86
2024-06-28 20:00:00+08,2,10,12,200058,946949,1147007,247.48,278.85,526.33
2024-06-29 00:00:00+08,2,10,12,200058,946949,1147007,258.38,318.85,577.23
2024-06-29 04:00:00+08,2,10,12,200058,1066766,1266824,266.38,336.81,603.19
2024-06-29 08:00:00+08,2,8,10,200058,878320,1078378,274.38,258.5,532.88
2024-06-29 12:00:00+08,2,6,8,200058,761108,961166,282.38,211.75,494.13
2024-06-29 16:00:00+08,1,6,7,72982,707582,780564,257.19,82.8,339.99
2024-06-29 20:00:00+08,2,11,13,134591,1179040,1313631,300.04,116.06,416.1
2024-06-30 00:00:00+08,2,10,12,134591,1077261,1211852,308.04,126.71,434.75
2024-06-30 04:00:00+08,2,9,11,134591,1008954,1143545,316.03,144.29,460.32
2024-06-30 08:00:00+08,2,9,11,134591,1008954,1143545,324.03,180.29,504.32
2024-06-30 12:00:00+08,2,9,11,134591,1008954,1143545,332.03,216.29,548.32
2024-06-30 16:00:00+08,2,8,10,134591,978767,1113358,340.03,230.49,570.52
2024-06-30 20:00:00+08,2,8,10,134591,960105,1094696,348.03,235.58,583.61
2024-07-01 00:00:00+08,2,9,11,134591,1032465,1167056,356.02,239.7,595.72
2024-07-01 04:00:00+08,2,8,10,134591,878418,1013009,364.02,226.68,590.7
2024-07-01 08:00:00+08,2,8,10,134591,895914,1030505,336.29,223.55,559.84
2024-07-01 12:00:00+08,2,7,9,134591,786179,920770,344.29,212.5,556.79
2024-07-01 16:00:00+08,1,5,6,61609,575194,636803,47.12,139,186.12
2024-07-01 20:00:00+08,1,11,12,61609,1039765,1101374,357.84,169.41,527.25
2024-07-02 00:00:00+08,1,11,12,61609,1039765,1101374,361.84,213.41,575.25
2024-07-02 04:00:00+08,1,10,11,61609,989465,1051074,365.83,228.05,593.88
2024-07-02 08:00:00+08,0,9,9,0,975705,975705,306.72,254.13,560.85
2024-07-02 12:00:00+08,1,7,8,61609,707899,769508,309.49,155.48,464.97
2024-07-02 16:00:00+08,1,4,5,61609,527734,589343,6.77,118.38,125.15
2024-07-02 20:00:00+08,1,7,8,61609,828619,890228,10.77,93.68,104.45
2024-07-03 00:00:00+08,1,7,8,61609,828619,890228,14.77,121.68,136.45
2024-07-03 04:00:00+08,2,7,9,119959,790674,910633,20.68,119.04,139.72
2024-07-03 08:00:00+08,2,11,13,119959,1009276,1129235,28.68,157.28,185.96
2024-07-03 12:00:00+08,1,12,13,58350,1043772,1102122,9.92,202.94,212.86
2024-07-03 16:00:00+08,1,11,12,58350,962164,1020514,13.92,185.32,199.24
2024-07-03 20:00:00+08,1,11,12,58350,993611,1051961,17.92,216.82,234.74
2024-07-04 00:00:00+08,2,11,13,123714,993611,1117325,24.22,260.82,285.04
2024-07-04 04:00:00+08,2,12,14,123714,1114014,1237728,32.2,275.94,308.14
2024-07-04 08:00:00+08,2,12,14,123714,1048285,1171999,40.2,262.54,302.74
2024-07-04 12:00:00+08,1,11,12,65364,962605,1027969,14.32,275.11,289.43
2024-07-04 16:00:00+08,1,11,12,65364,970041,1035405,54.01,286.14,340.15
2024-07-04 20:00:00+08,1,7,8,65364,592313,657677,58.01,148.08,206.09
2024-07-05 00:00:00+08,1,8,9,65364,728007,793371,62.01,179.73,241.74
2024-07-05 04:00:00+08,2,8,10,203975,728007,931982,67.51,211.73,279.24
2024-07-05 08:00:00+08,1,8,9,138611,728007,866618,41.2,243.73,284.93
2024-07-05 12:00:00+08,1,8,9,138611,728007,866618,45.2,275.73,320.93
2024-07-05 16:00:00+08,1,9,10,138611,836843,975454,49.2,309.48,358.68
2024-07-05 20:00:00+08,1,12,13,138611,1085499,1224110,96.45,354.33,450.78
2024-07-06 00:00:00+08,1,12,13,138611,1085499,1224110,100.45,402.33,502.78
2024-07-06 04:00:00+08,2,11,13,202006,1019021,1221027,107.57,392.46,500.03
2024-07-06 08:00:00+08,2,12,14,202006,1294808,1496814,115.57,389.96,505.53
2024-07-06 12:00:00+08,2,11,13,202006,1226345,1428351,123.56,380.82,504.38
2024-07-06 16:00:00+08,1,11,12,138611,1226345,1364956,116.46,424.82,541.28
2024-07-06 20:00:00+08,1,12,13,138611,1330456,1469067,101.35,418.68,520.03
2024-07-07 00:00:00+08,1,12,13,138611,1330456,1469067,105.35,466.68,572.03
2024-07-07 04:00:00+08,1,11,12,138611,1265092,1403703,66.06,479.65,545.71
2024-07-07 08:00:00+08,1,11,12,138611,1265092,1403703,70.06,523.65,593.71
2024-07-07 12:00:00+08,1,9,10,138611,1010573,1149184,74.05,429.44,503.49
2024-07-07 16:00:00+08,1,6,7,138611,763886,902497,61.49,349.14,410.63
2024-07-07 20:00:00+08,1,8,9,138611,864544,1003155,65.49,376.18,441.67
2024-07-08 00:00:00+08,0,8,8,0,769567,769567,0,162.68,162.68
2024-07-08 04:00:00+08,1,7,8,130573,734799,865372,2.19,184.91,187.1
2024-07-08 08:00:00+08,1,10,11,130573,1084238,1214811,81.64,220.42,302.06
2024-07-08 12:00:00+08,1,10,11,130573,1165140,1295713,85.63,245.83,331.46
2024-07-08 16:00:00+08,1,10,11,130573,1165140,1295713,89.63,285.83,375.46
2024-07-08 20:00:00+08,1,9,10,130573,1064988,1195561,93.63,256.06,349.69
2024-07-09 00:00:00+08,1,9,10,130573,1009568,1140141,97.64,193.52,291.16
2024-07-09 04:00:00+08,2,8,10,295995,919180,1215175,103.22,200.86,304.08
2024-07-09 08:00:00+08,2,12,14,295995,1256669,1552664,111.22,243.8,355.02
2024-07-09 12:00:00+08,2,11,13,295995,1171964,1467959,119.22,261.28,380.5
2024-07-09 16:00:00+08,2,10,12,295995,1145093,1441088,127.22,295.04,422.26
2024-07-09 20:00:00+08,2,9,11,295995,1048600,1344595,135.2,222.97,358.17
2024-07-10 00:00:00+08,4,18,22,591990,2097200,2689190,286.4,517.94,804.34
2024-07-10 04:00:00+08,2,16,18,261146,1844954,2106100,251.24,496.02,747.26
2024-07-10 08:00:00+08,1,9,10,130573,995683,1126256,156.49,258.32,414.81
2024-07-10 12:00:00+08,2,10,12,182306,1112616,1294922,164.18,297.33,461.51
2024-07-10 16:00:00+08,2,10,12,182306,1112616,1294922,172.18,337.33,509.51
2024-07-10 20:00:00+08,2,9,11,182306,873852,1056158,180.21,235.75,415.96
2024-07-11 00:00:00+08,2,10,12,157091,977520,1134611,118.56,273.52,392.08
2024-07-11 04:00:00+08,2,7,9,214358,729192,943550,110.36,171.77,282.13
2024-07-11 08:00:00+08,2,9,11,214358,911498,1125856,213.56,206.51,420.07
2024-07-11 12:00:00+08,2,9,11,214358,911498,1125856,221.56,242.51,464.07
2024-07-11 16:00:00+08,1,7,8,109000,766823,875823,137.55,129.25,266.8
2024-07-11 20:00:00+08,1,8,9,109000,864265,973265,160.35,135.84,296.19
2024-07-12 00:00:00+08,1,9,10,109000,871149,980149,164.35,169.06,333.41
2024-07-12 04:00:00+08,2,8,10,203629,705727,909356,142.08,158.36,300.44
2024-07-12 08:00:00+08,2,9,11,203629,774099,977728,150.09,193.92,344.01
2024-07-12 12:00:00+08,2,9,11,203629,774099,977728,158.09,229.92,388.01
2024-07-12 16:00:00+08,2,8,10,203629,737530,941159,166.11,191.52,357.63
2024-07-12 20:00:00+08,2,8,10,203629,727002,930631,99.23,140.25,239.48
2024-07-13 00:00:00+08,2,11,13,203629,1098610,1302239,86.9,136.98,223.88
2024-07-13 04:00:00+08,2,11,13,203629,1098610,1302239,94.9,180.98,275.88
2024-07-13 08:00:00+08,2,10,12,203629,1091726,1295355,102.9,191.76,294.66
2024-07-13 12:00:00+08,2,8,10,203629,917996,1121625,92.12,158.46,250.58
2024-07-13 16:00:00+08,1,5,6,109000,607590,716590,63.54,100.03,163.57
2024-07-13 20:00:00+08,0,9,9,0,917071,917071,38.32,129.7,168.02
2024-07-14 00:00:00+08,0,11,11,0,1134898,1134898,106.62,170.01,276.63
2024-07-14 04:00:00+08,0,11,11,0,1055376,1055376,106.6,177,283.6
2024-07-14 08:00:00+08,1,12,13,140453,1192275,1332728,108.15,223.46,331.61
2024-07-14 12:00:00+08,1,12,13,140453,1192275,1332728,112.15,271.46,383.61
2024-07-14 16:00:00+08,1,13,14,140453,1218295,1358748,116.15,323.43,439.58
2024-07-14 20:00:00+08,1,10,11,140453,980209,1120662,13.53,299.93,313.46
2024-07-15 00:00:00+08,2,9,11,267529,933774,1201303,17.84,215.65,233.49
2024-07-15 04:00:00+08,2,9,11,267529,933774,1201303,25.84,251.65,277.49
2024-07-15 08:00:00+08,3,7,10,280592,694374,974966,34.9,198.03,232.93
2024-07-15 12:00:00+08,2,6,8,140139,668354,808493,17.37,202.05,219.42
2024-07-15 16:00:00+08,2,6,8,140139,756294,896433,58.5,188.09,246.59
2024-07-15 20:00:00+08,1,10,11,127076,1163463,1290539,53.44,220.41,273.85
2024-07-16 00:00:00+08,0,12,12,0,1198790,1198790,48.24,188.71,236.95
2024-07-16 04:00:00+08,0,11,11,0,1085312,1085312,48.24,204.95,253.19
2024-07-16 08:00:00+08,1,13,14,65890,1269974,1335864,51.9,251.47,303.37
2024-07-16 12:00:00+08,1,14,15,65890,1397050,1462940,88.45,307.23,395.68
2024-07-16 16:00:00+08,1,13,14,65890,1268489,1334379,92.45,342.33,434.78
2024-07-16 20:00:00+08,1,8,9,65890,924841,990731,81.31,192.43,273.74
2024-07-17 00:00:00+08,1,10,11,65890,1072800,1138690,85.3,228.55,313.85
2024-07-17 04:00:00+08,1,11,12,65890,1107296,1173186,89.3,272.51,361.81
2024-07-17 08:00:00+08,1,11,12,65890,1136553,1202443,93.3,304.33,397.63
2024-07-17 12:00:00+08,1,10,11,65890,1033015,1098905,97.3,311.21,408.51
2024-07-17 16:00:00+08,1,8,9,65890,885056,950946,101.31,315.07,416.38
2024-07-17 20:00:00+08,2,8,10,168751,848026,1016777,106.34,194.25,300.59
2024-07-18 00:00:00+08,2,9,11,168751,887109,1055860,114.34,227.18,341.52
2024-07-18 04:00:00+08,2,9,11,168751,887109,1055860,122.34,263.18,385.52
2024-07-18 08:00:00+08,2,10,12,168751,890845,1059596,97.79,255.64,353.43
2024-07-18 12:00:00+08,1,10,11,102861,890845,993706,50.13,295.64,345.77
2024-07-18 16:00:00+08,2,9,11,220036,809674,1029710,116.75,249.47,366.22
2024-07-18 20:00:00+08,2,8,10,220036,786365,1006401,124.75,271.24,395.99
2024-07-19 00:00:00+08,2,9,11,220036,793249,1013285,132.75,304.27,437.02
2024-07-19 04:00:00+08,2,8,10,220036,728478,948514,107.67,211.38,319.05
2024-07-19 08:00:00+08,2,9,11,220036,953110,1173146,115.66,208.47,324.13
2024-07-19 12:00:00+08,2,10,12,220036,1092445,1312481,123.66,248.1,371.76
2024-07-19 16:00:00+08,1,9,10,117175,934651,1051826,86.63,206.83,293.46
2024-07-19 20:00:00+08,1,13,14,117175,1287120,1404295,136.93,249.12,386.05
2024-07-20 00:00:00+08,1,12,13,117175,1221230,1338405,81.38,269.02,350.4
2024-07-20 04:00:00+08,1,13,14,117175,1302873,1420048,85.38,320.87,406.25
2024-07-20 08:00:00+08,1,13,14,117175,1368706,1485881,89.38,342.68,432.06
2024-07-20 12:00:00+08,1,13,14,117175,1368706,1485881,93.38,394.68,488.06
2024-07-20 16:00:00+08,0,10,10,0,1054020,1054020,0,334.5,334.5
2024-07-20 20:00:00+08,0,12,12,0,1290531,1290531,52.52,308.97,361.49
2024-07-21 00:00:00+08,0,11,11,0,1183028,1183028,52.53,290.94,343.47
2024-07-21 04:00:00+08,0,9,9,0,939041,939041,52.52,258.56,311.08
2024-07-21 08:00:00+08,0,9,9,0,939041,939041,52.52,294.56,347.08
2024-07-21 12:00:00+08,0,9,9,0,939041,939041,52.52,330.56,383.08
2024-07-21 16:00:00+08,0,8,8,0,857398,857398,52.52,326.71,379.23
2024-07-21 20:00:00+08,0,7,7,0,698439,698439,52.53,270.21,322.74
2024-07-22 00:00:00+08,0,8,8,0,811809,811809,52.52,178.5,231.02
2024-07-22 04:00:00+08,0,9,9,0,864592,864592,52.52,214.49,267.01
2024-07-22 08:00:00+08,0,8,8,0,718079,718079,52.52,176.93,229.45
2024-07-22 12:00:00+08,0,7,7,0,665296,665296,52.52,196.94,249.46
2024-07-22 16:00:00+08,0,6,6,0,631134,631134,52.52,203.42,255.94
2024-07-22 20:00:00+08,0,7,7,0,770578,770578,52.5,211.56,264.06
2024-07-23 00:00:00+08,0,9,9,0,868538,868538,52.5,150.66,203.16
2024-07-23 04:00:00+08,0,10,10,0,1007149,1007149,52.5,189.57,242.07
2024-07-23 08:00:00+08,0,12,12,0,1200375,1200375,52.5,235.58,288.08
2024-07-23 12:00:00+08,1,12,13,46305,1200375,1246680,53.06,283.58,336.64
2024-07-23 16:00:00+08,1,10,11,46305,1047809,1094114,4.56,243.79,248.35
2024-07-23 20:00:00+08,1,10,11,46305,1077490,1123795,8.56,221.61,230.17
2024-07-24 00:00:00+08,1,10,11,46305,1077490,1123795,12.56,261.61,274.17
2024-07-24 04:00:00+08,2,9,11,178340,1023292,1201632,16.94,267.57,284.51
2024-07-24 08:00:00+08,2,11,13,178340,1129450,1307790,24.94,308.93,333.87
2024-07-24 12:00:00+08,2,10,12,178340,990839,1169179,32.94,318.02,350.96
2024-07-24 16:00:00+08,2,11,13,178340,1132070,1310410,40.94,360.73,401.67
2024-07-24 20:00:00+08,2,11,13,178340,1013512,1191852,48.96,287.75,336.71
2024-07-25 00:00:00+08,2,11,13,178340,1013512,1191852,56.96,331.75,388.71
2024-07-25 04:00:00+08,2,10,12,178340,1012555,1190895,64.96,279,343.96
2024-07-25 08:00:00+08,2,11,13,178340,1099567,1277907,72.94,284.25,357.19
2024-07-25 12:00:00+08,2,11,13,178340,1086135,1264475,80.93,297.41,378.34
2024-07-25 16:00:00+08,2,9,11,178340,977712,1156052,88.93,259.76,348.69
2024-07-25 20:00:00+08,2,11,13,178340,1082047,1260387,96.93,275.78,372.71
2024-07-26 00:00:00+08,2,8,10,178340,788877,967217,104.93,160.59,265.52
2024-07-26 04:00:00+08,2,10,12,178340,829982,1008322,112.93,197.91,310.84
2024-07-26 08:00:00+08,3,10,13,325089,881904,1206993,121.98,178.28,300.26
2024-07-26 12:00:00+08,4,12,16,428757,1045811,1474568,134.96,225.09,360.05
2024-07-26 16:00:00+08,4,11,15,428757,974555,1403312,150.96,244.47,395.43
2024-07-26 20:00:00+08,3,14,17,382452,1151841,1534293,163.64,272.57,436.21
2024-07-27 00:00:00+08,3,13,16,382452,1117620,1500072,175.64,307.02,482.66
2024-07-27 04:00:00+08,3,12,15,382452,1049042,1431494,187.67,324.83,512.5
2024-07-27 08:00:00+08,3,11,14,382452,1125136,1507588,199.68,320.49,520.17
2024-07-27 12:00:00+08,3,11,14,382452,1125136,1507588,211.68,364.49,576.17
2024-07-27 16:00:00+08,3,8,11,382452,966866,1349318,223.67,318.22,541.89
2024-07-27 20:00:00+08,4,11,15,526595,1111971,1638566,236.82,290.6,527.42
2024-07-28 00:00:00+08,4,11,15,526595,1111971,1638566,252.82,334.6,587.42
2024-07-28 04:00:00+08,4,11,15,526595,982508,1509103,268.83,293.93,562.76
2024-07-28 08:00:00+08,3,10,13,382452,828800,1211252,271.65,263.39,535.04
2024-07-28 12:00:00+08,3,9,12,382452,839965,1222417,298.69,244.46,543.15
2024-07-28 16:00:00+08,3,9,12,382452,911903,1294355,310.69,267.41,578.1
2024-07-28 20:00:00+08,3,11,14,382452,982897,1365349,322.67,281.23,603.9
2024-07-29 00:00:00+08,3,11,14,382452,996115,1378567,334.65,297.12,631.77
2024-07-29 04:00:00+08,3,11,14,382452,996115,1378567,346.65,341.12,687.77
2024-07-29 08:00:00+08,2,9,11,278784,874377,1153161,289.67,320.28,609.95
2024-07-29 12:00:00+08,2,6,8,278784,608732,887516,297.67,219.52,517.19
2024-07-29 16:00:00+08,2,6,8,278784,661300,940084,378.86,230.11,608.97
2024-07-29 20:00:00+08,2,7,9,241035,673382,914417,303.41,229.49,532.9
2024-07-30 00:00:00+08,2,9,11,241035,851132,1092167,400.43,172.26,572.69
2024-07-30 04:00:00+08,1,9,10,109000,851132,960132,264.04,208.26,472.3
2024-07-30 08:00:00+08,1,11,12,109000,1086734,1195734,413.88,249.12,663
2024-07-30 12:00:00+08,1,9,10,109000,1003863,1112863,417.9,262.49,680.39
2024-07-30 16:00:00+08,1,9,10,109000,1003863,1112863,421.9,298.49,720.39
2024-07-30 20:00:00+08,1,11,12,109000,1138872,1247872,425.88,317.35,743.23
2024-07-31 00:00:00+08,1,11,12,109000,1138872,1247872,429.88,361.35,791.23
2024-07-31 04:00:00+08,0,11,11,0,1138872,1138872,400.28,405.35,805.63
2024-07-31 08:00:00+08,0,12,12,0,1247872,1247872,436.18,451.05,887.23
2024-07-31 12:00:00+08,0,12,12,0,1207842,1207842,436.16,458.89,895.05
2024-07-31 16:00:00+08,0,10,10,0,1041167,1041167,363,433.96,796.96
2024-07-31 20:00:00+08,0,13,13,0,1219329,1219329,363.01,482.48,845.49
2024-08-01 00:00:00+08,0,13,13,0,1166631,1166631,363.02,492.75,855.77
2024-08-01 04:00:00+08,0,12,12,0,1120326,1120326,285.78,413.44,699.22
2024-08-01 08:00:00+08,0,12,12,0,1118864,1118864,139.92,411.4,551.32
2024-08-01 12:00:00+08,0,11,11,0,1057377,1057377,139.92,417.23,557.15
2024-08-01 16:00:00+08,0,9,9,0,768663,768663,124.93,266.74,391.67
2024-08-01 20:00:00+08,0,10,10,0,1024781,1024781,89.04,185.32,274.36
2024-08-02 00:00:00+08,0,10,10,0,975946,975946,89.04,147.7,236.74
2024-08-02 04:00:00+08,0,9,9,0,814677,814677,0,80.47,80.47
2024-08-02 08:00:00+08,0,12,12,0,1006641,1006641,0,125.18,125.18
2024-08-02 12:00:00+08,0,12,12,0,1093193,1093193,0,159.16,159.16
2024-08-02 16:00:00+08,0,10,10,0,970266,970266,0,165.07,165.07
2024-08-02 20:00:00+08,0,11,11,0,1128663,1128663,0,175.89,175.89
2024-08-03 00:00:00+08,0,11,11,0,1128663,1128663,0,219.89,219.89
2024-08-03 04:00:00+08,0,10,10,0,1057550,1057550,0,240.89,240.89
2024-08-03 08:00:00+08,0,9,9,0,990683,990683,0,202.46,202.46
2024-08-03 12:00:00+08,0,9,9,0,990683,990683,0,238.46,238.46
2024-08-03 16:00:00+08,0,10,10,0,1121256,1121256,0,278.41,278.41
2024-08-03 20:00:00+08,0,11,11,0,1086992,1086992,0,249.43,249.43
2024-08-04 00:00:00+08,0,10,10,0,947657,947657,0,254.31,254.31
2024-08-04 04:00:00+08,0,9,9,0,800865,800865,0,236.09,236.09
2024-08-04 08:00:00+08,0,9,9,0,708485,708485,0,198.5,198.5
2024-08-04 12:00:00+08,0,7,7,0,508895,508895,0,118.95,118.95
2024-08-04 16:00:00+08,0,3,3,0,319956,319956,0,58.77,58.77
2024-08-04 20:00:00+08,0,7,7,0,745510,745510,0,55.43,55.43
2024-08-05 00:00:00+08,1,8,9,13063,812196,825259,1.66,85.64,87.3
2024-08-05 04:00:00+08,1,8,9,13063,812196,825259,5.66,117.64,123.3
2024-08-05 08:00:00+08,1,7,8,13063,770606,783669,9.65,134.44,144.09
2024-08-05 12:00:00+08,1,7,8,13063,770606,783669,13.65,162.44,176.09
2024-08-05 16:00:00+08,0,5,5,0,527599,527599,0,117.57,117.57
2024-08-05 20:00:00+08,0,6,6,0,454971,454971,19.56,116.03,135.59
2024-08-06 00:00:00+08,0,6,6,0,545980,545980,19.56,115.02,134.58
2024-08-06 04:00:00+08,0,8,8,0,720026,720026,19.56,143.28,162.84
2024-08-06 08:00:00+08,0,7,7,0,706963,706963,0,161.19,161.19
2024-08-06 12:00:00+08,0,6,6,0,683654,683654,0,170.96,170.96
2024-08-06 16:00:00+08,0,6,6,0,683654,683654,0,194.96,194.96
2024-08-06 20:00:00+08,0,6,6,0,619113,619113,0,160.04,160.04
2024-08-07 00:00:00+08,0,7,7,0,689554,689554,0,131.2,131.2
2024-08-07 04:00:00+08,1,8,9,107820,723716,831536,3.36,162.9,166.26
2024-08-07 08:00:00+08,1,9,10,107820,869399,977219,7.36,196.49,203.85
2024-08-07 12:00:00+08,1,9,10,107820,869399,977219,11.36,232.49,243.85
2024-08-07 16:00:00+08,1,9,10,107820,869399,977219,15.36,268.49,283.85
2024-08-07 20:00:00+08,0,9,9,0,712940,712940,0,148.18,148.18
2024-08-08 00:00:00+08,0,11,11,0,892051,892051,22.46,186.01,208.47
2024-08-08 04:00:00+08,0,11,11,0,892051,892051,22.46,230.01,252.47
2024-08-08 08:00:00+08,0,10,10,0,881454,881454,22.46,231.18,253.64
2024-08-08 12:00:00+08,0,9,9,0,819967,819967,22.46,254.15,276.61
2024-08-08 16:00:00+08,0,9,9,0,819967,819967,22.46,290.15,312.61
2024-08-08 20:00:00+08,0,8,8,0,810050,810050,22.46,279.84,302.3
2024-08-09 00:00:00+08,0,8,8,0,768865,768865,22.46,247.39,269.85
2024-08-09 04:00:00+08,0,9,9,0,909530,909530,22.46,283.15,305.61
2024-08-09 08:00:00+08,0,9,9,0,909530,909530,22.46,319.15,341.61
2024-08-09 12:00:00+08,0,9,9,0,909530,909530,22.46,355.15,377.61
2024-08-09 16:00:00+08,0,8,8,0,828431,828431,22.46,345.32,367.78
2024-08-09 20:00:00+08,0,9,9,0,789654,789654,22.46,286.98,309.44
2024-08-10 00:00:00+08,0,10,10,0,852804,852804,22.46,324.46,346.92
2024-08-10 04:00:00+08,0,9,9,0,764780,764780,22.46,330.62,353.08
2024-08-10 08:00:00+08,0,8,8,0,730550,730550,22.46,352.96,375.42
2024-08-10 12:00:00+08,0,7,7,0,723666,723666,22.46,347.42,369.88
2024-08-10 16:00:00+08,1,6,7,102861,577983,680844,23.11,293.84,316.95
2024-08-10 20:00:00+08,1,5,6,102861,514833,617694,27.11,296.33,323.44
2024-08-11 00:00:00+08,1,10,11,102861,842360,945221,31.12,324.42,355.54
2024-08-11 04:00:00+08,1,11,12,102861,977643,1080504,35.12,337.02,372.14
2024-08-11 08:00:00+08,1,11,12,102861,977643,1080504,39.12,381.02,420.14
2024-08-11 12:00:00+08,1,10,11,102861,847070,949931,43.13,363.08,406.21
2024-08-11 16:00:00+08,0,9,9,0,783949,783949,22.46,384.77,407.23
2024-08-11 20:00:00+08,0,10,10,0,876832,876832,48.39,406.53,454.92
2024-08-12 00:00:00+08,0,11,11,0,1015443,1015443,48.39,449.59,497.98
2024-08-12 04:00:00+08,0,8,8,0,836703,836703,25.92,257.67,283.59
2024-08-12 08:00:00+08,0,6,6,0,688741,688741,25.92,243.39,269.31
2024-08-12 12:00:00+08,0,5,5,0,585093,585093,25.93,230.26,256.19
2024-08-12 16:00:00+08,0,5,5,0,585093,585093,25.93,250.26,276.19
2024-08-12 20:00:00+08,0,7,7,0,549225,549225,25.93,235.07,261
2024-08-13 00:00:00+08,0,12,12,0,775960,775960,25.93,270.12,296.05
2024-08-13 04:00:00+08,0,12,12,0,835090,835090,25.93,307.85,333.78
2024-08-13 08:00:00+08,0,12,12,0,835090,835090,25.93,355.85,381.78
2024-08-13 12:00:00+08,0,11,11,0,800024,800024,25.93,390.58,416.51
2024-08-13 16:00:00+08,0,11,11,0,800024,800024,25.93,434.58,460.51
2024-08-13 20:00:00+08,1,9,10,61609,759397,821006,29.65,410.95,440.6
2024-08-14 00:00:00+08,1,9,10,61609,726669,788278,33.65,422.56,456.21
2024-08-14 04:00:00+08,1,11,12,61609,976365,1037974,37.65,460.19,497.84
2024-08-14 08:00:00+08,1,10,11,61609,926028,987637,41.65,470.89,512.54
2024-08-14 12:00:00+08,1,9,10,61609,718777,780386,19.72,382.83,402.55
2024-08-14 16:00:00+08,1,7,8,61609,632318,693927,23.73,355,378.73
2024-08-14 20:00:00+08,1,10,11,61609,944885,1006494,27.73,353.27,381
2024-08-15 00:00:00+08,1,12,13,61609,1087284,1148893,31.75,395.49,427.24
2024-08-15 04:00:00+08,1,12,13,61609,1087284,1148893,35.75,443.49,479.24
2024-08-15 08:00:00+08,1,12,13,61609,1087284,1148893,39.75,491.49,531.24
2024-08-15 12:00:00+08,1,10,11,61609,849582,911191,43.75,439.97,483.72
2024-08-15 16:00:00+08,1,10,11,61609,964411,1026020,47.75,453.98,501.73
2024-08-15 20:00:00+08,1,9,10,61609,935134,996743,51.74,421.13,472.87
2024-08-16 00:00:00+08,1,11,12,61609,1005012,1066621,55.75,459.14,514.89
2024-08-16 04:00:00+08,1,9,10,61609,857822,919431,59.72,214.44,274.16
2024-08-16 08:00:00+08,1,9,10,61609,857822,919431,63.72,250.44,314.16
2024-08-16 12:00:00+08,1,9,10,61609,857822,919431,67.72,286.44,354.16
2024-08-16 16:00:00+08,0,7,7,0,696413,696413,0,234.52,234.52
2024-08-16 20:00:00+08,0,8,8,0,774771,774771,74,180.83,254.83
2024-08-17 00:00:00+08,0,10,10,0,962257,962257,74,213.41,287.41
2024-08-17 04:00:00+08,0,10,10,0,962257,962257,74,253.41,327.41
2024-08-17 08:00:00+08,0,10,10,0,962257,962257,74,293.41,367.41
2024-08-17 12:00:00+08,0,11,11,0,1049866,1049866,74,335.08,409.08
2024-08-17 16:00:00+08,0,8,8,0,872604,872604,74,225.51,299.51
2024-08-17 20:00:00+08,0,7,7,0,765746,765746,0,190.44,190.44
2024-08-18 00:00:00+08,0,9,9,0,895270,895270,0,222.94,222.94
2024-08-18 04:00:00+08,0,9,9,0,889199,889199,0,176.23,176.23
2024-08-18 08:00:00+08,0,11,11,0,1081761,1081761,0,216.33,216.33
2024-08-18 12:00:00+08,0,10,10,0,964525,964525,0,218.92,218.92
2024-08-18 16:00:00+08,0,10,10,0,985438,985438,0,236.89,236.89
2024-08-18 20:00:00+08,0,9,9,0,914868,914868,0,157.45,157.45
2024-08-19 00:00:00+08,0,8,8,0,864795,864795,0,138.56,138.56
2024-08-19 04:00:00+08,0,9,9,0,930685,930685,0,174.49,174.49
2024-08-19 08:00:00+08,1,9,10,65364,930685,996049,3.53,210.49,214.02
2024-08-19 12:00:00+08,1,7,8,65364,797942,863306,7.52,183.96,191.48
2024-08-19 16:00:00+08,1,6,7,65364,732052,797416,11.51,196.05,207.56
2024-08-19 20:00:00+08,1,7,8,65364,759077,824441,15.51,222.18,237.69
2024-08-20 00:00:00+08,1,11,12,65364,1051604,1116968,19.51,216.78,236.29
2024-08-20 04:00:00+08,1,10,11,65364,905097,970461,23.51,184.41,207.92
2024-08-20 08:00:00+08,1,10,11,65364,956053,1021417,27.5,217.06,244.56
2024-08-20 12:00:00+08,1,9,10,65364,929028,994392,31.5,238.93,270.43
2024-08-20 16:00:00+08,0,7,7,0,762198,762198,0,187.73,187.73
2024-08-20 20:00:00+08,0,12,12,0,1144430,1144430,37.47,228.18,265.65
2024-08-21 00:00:00+08,0,12,12,0,1144430,1144430,37.47,276.18,313.65
2024-08-21 04:00:00+08,0,12,12,0,1144430,1144430,37.47,324.18,361.65
2024-08-21 08:00:00+08,0,12,12,0,1224287,1224287,37.46,342.41,379.87
2024-08-21 12:00:00+08,0,11,11,0,1157419,1157419,37.46,335.94,373.4
2024-08-21 16:00:00+08,1,7,8,72982,727981,800963,39.73,168,207.73
2024-08-21 20:00:00+08,1,11,12,72982,1130324,1203306,43.72,203.27,246.99
2024-08-22 00:00:00+08,1,12,13,72982,1289938,1362920,47.72,249.7,297.42
2024-08-22 04:00:00+08,1,12,13,72982,1289938,1362920,51.72,297.7,349.42
2024-08-22 08:00:00+08,1,12,13,72982,1295327,1368309,18.25,308.76,327.01
2024-08-22 12:00:00+08,1,8,9,72982,1004418,1077400,22.27,253.21,275.48
2024-08-22 16:00:00+08,0,7,7,0,860358,860358,0,237.86,237.86
2024-08-22 20:00:00+08,0,9,9,0,990544,990544,28.72,200.53,229.25
2024-08-23 00:00:00+08,0,12,12,0,1145859,1145859,28.71,239.52,268.23
2024-08-23 04:00:00+08,0,13,13,0,1292631,1292631,28.71,291.43,320.14
2024-08-23 08:00:00+08,1,12,13,39359,1162058,1201417,28.8,291.99,320.79
2024-08-23 12:00:00+08,1,12,13,39359,1162058,1201417,32.8,339.99,372.79
2024-08-23 16:00:00+08,0,9,9,0,856529,856529,28.72,220.68,249.4
2024-08-23 20:00:00+08,0,11,11,0,967998,967998,11.91,186.66,198.57
2024-08-24 00:00:00+08,1,12,13,61609,1079612,1141221,15.14,233.51,248.65
2024-08-24 04:00:00+08,1,12,13,61609,1079612,1141221,19.14,281.51,300.65
2024-08-24 08:00:00+08,1,11,12,61609,1015975,1077584,23.15,238.84,261.99
2024-08-24 12:00:00+08,1,11,12,61609,1015975,1077584,27.15,282.84,309.99
2024-08-24 16:00:00+08,1,8,9,61609,898134,959743,19.24,265.02,284.26
2024-08-24 20:00:00+08,1,9,10,61609,910335,971944,23.23,255.68,278.91
2024-08-25 00:00:00+08,1,12,13,61609,1159065,1220674,27.24,296.41,323.65
2024-08-25 04:00:00+08,1,12,13,61609,1159065,1220674,31.24,344.41,375.65
2024-08-25 08:00:00+08,1,11,12,61609,1107978,1169587,35.23,355.29,390.52
2024-08-25 12:00:00+08,1,8,9,61609,787414,849023,39.23,231.75,270.98
2024-08-25 16:00:00+08,0,8,8,0,795452,795452,0,220.36,220.36
2024-08-25 20:00:00+08,0,7,7,0,602646,602646,46.5,119.29,165.79
2024-08-26 00:00:00+08,0,9,9,0,779069,779069,46.48,149.15,195.63
2024-08-26 04:00:00+08,0,8,8,0,702569,702569,46.48,128.96,175.44
2024-08-26 08:00:00+08,1,8,9,144572,710847,855419,48.37,149.44,197.81
2024-08-26 12:00:00+08,1,7,8,144572,599233,743805,52.37,118.57,170.94
2024-08-26 16:00:00+08,1,6,7,144572,493688,638260,56.37,105.51,161.88
2024-08-26 20:00:00+08,1,6,7,144572,579616,724188,13.89,87.31,101.2
2024-08-27 00:00:00+08,2,6,8,298794,579616,878410,19.24,111.31,130.55
2024-08-27 04:00:00+08,2,5,7,298794,441005,739799,27.24,98.1,125.34
2024-08-27 08:00:00+08,2,7,9,298794,477377,776171,35.24,125,160.24
2024-08-27 12:00:00+08,2,6,8,298794,427017,725811,43.24,122.72,165.96
2024-08-27 16:00:00+08,3,5,8,349154,360332,709486,54.05,107.28,161.33
2024-08-27 20:00:00+08,3,3,6,349154,343364,692518,66.06,54.7,120.76
2024-08-28 00:00:00+08,1,4,5,144572,354963,499535,41.9,40.79,82.69
2024-08-28 04:00:00+08,1,6,7,144572,641220,785792,74.75,58.47,133.22
2024-08-28 08:00:00+08,1,6,7,144572,641220,785792,78.75,82.47,161.22
2024-08-28 12:00:00+08,1,6,7,144572,781746,926318,82.73,94.76,177.49
2024-08-28 16:00:00+08,1,6,7,144572,781746,926318,86.73,118.76,205.49
2024-08-28 20:00:00+08,1,9,10,144572,964087,1108659,90.73,148.23,238.96
2024-08-29 00:00:00+08,1,11,12,144572,1079545,1224117,94.73,185.85,280.58
2024-08-29 04:00:00+08,1,11,12,144572,1079545,1224117,98.73,229.85,328.58
2024-08-29 08:00:00+08,1,12,13,144572,1226132,1370704,102.73,276.03,378.76
2024-08-29 12:00:00+08,0,11,11,0,1116132,1116132,28.85,258.26,287.11
2024-08-29 16:00:00+08,0,9,9,0,994352,994352,28.85,238.7,267.55
2024-08-29 20:00:00+08,0,10,10,0,1109978,1109978,111.49,255.02,366.51
2024-08-30 00:00:00+08,1,11,12,63000,1127143,1190143,111.74,275.57,387.31
2024-08-30 04:00:00+08,2,11,13,128890,1127143,1256033,117.51,319.57,437.08
2024-08-30 08:00:00+08,1,11,12,63000,1120415,1183415,119.74,311.95,431.69
2024-08-30 12:00:00+08,1,11,12,63000,1106498,1169498,133.14,314.45,447.59
2024-08-30 16:00:00+08,1,11,12,63000,1106498,1169498,137.14,358.45,495.59
2024-08-30 20:00:00+08,1,11,12,63000,1131161,1194161,141.16,356.43,497.59
2024-08-31 00:00:00+08,1,11,12,63000,1060400,1123400,145.2,339.27,484.47
2024-08-31 04:00:00+08,2,9,11,207572,760651,968223,121.3,227.44,348.74
2024-08-31 08:00:00+08,2,7,9,207572,714349,921921,129.3,192.42,321.72
2024-08-31 12:00:00+08,2,8,10,207572,853684,1061256,137.29,224,361.29
2024-08-31 16:00:00+08,1,5,6,144572,576477,721049,95.64,148.62,244.26
2024-08-31 20:00:00+08,1,10,11,144572,1091527,1236099,140.87,179.01,319.88
2024-09-01 00:00:00+08,1,10,11,144572,1091527,1236099,144.87,219.01,363.88
2024-09-01 04:00:00+08,1,10,11,144572,1091527,1236099,148.87,259.01,407.88
2024-09-01 08:00:00+08,1,9,10,144572,966220,1110792,152.87,249.46,402.33
2024-09-01 12:00:00+08,1,7,8,144572,817540,962112,115.62,203.15,318.77
2024-09-01 16:00:00+08,1,6,7,144572,684937,829509,36.96,120.51,157.47
2024-09-01 20:00:00+08,1,11,12,144572,1091238,1235810,40.96,155.4,196.36
2024-09-02 00:00:00+08,1,11,12,144572,1091238,1235810,44.96,199.4,244.36
2024-09-02 04:00:00+08,1,9,10,144572,912739,1057311,48.96,165.3,214.26
2024-09-02 08:00:00+08,1,9,10,144572,912739,1057311,52.96,201.32,254.28
2024-09-02 12:00:00+08,1,10,11,144572,1057976,1202548,56.96,239.58,296.54
2024-09-02 16:00:00+08,1,7,8,144572,807533,952105,60.96,211.96,272.92
2024-09-02 20:00:00+08,1,4,5,144572,547402,691974,64.96,132.9,197.86
2024-09-03 00:00:00+08,1,4,5,144572,547402,691974,68.96,148.9,217.86
2024-09-03 04:00:00+08,1,4,5,144572,547402,691974,72.96,164.9,237.86
2024-09-03 08:00:00+08,1,4,5,144572,547402,691974,76.96,180.9,257.86
2024-09-03 12:00:00+08,1,4,5,144572,547402,691974,80.96,196.9,277.86
2024-09-03 16:00:00+08,1,5,6,144572,656423,800995,84.96,213.18,298.14
2024-09-03 20:00:00+08,1,11,12,144572,996790,1141362,88.96,246.18,335.14
2024-09-04 00:00:00+08,1,12,13,144572,1145278,1289850,92.98,293.44,386.42
2024-09-04 04:00:00+08,1,13,14,144572,1218643,1363215,96.98,344.31,441.29
2024-09-04 08:00:00+08,1,14,15,144572,1252864,1397436,100.98,396.53,497.51
2024-09-04 12:00:00+08,1,13,14,144572,1225917,1370489,104.98,434.54,539.52
2024-09-04 16:00:00+08,1,10,11,144572,1004124,1148696,108.98,351.65,460.63
2024-09-04 20:00:00+08,2,11,13,283907,1004124,1288031,114.62,370.49,485.11
2024-09-05 00:00:00+08,2,12,14,283907,1128435,1412342,122.64,339.72,462.36
2024-09-05 04:00:00+08,2,12,14,283907,1128435,1412342,130.64,387.72,518.36
2024-09-05 08:00:00+08,2,13,15,283907,1222185,1506092,138.64,401.02,539.66
2024-09-05 12:00:00+08,2,11,13,283907,1140415,1424322,146.61,295.33,441.94
2024-09-05 16:00:00+08,2,10,12,283907,1118945,1402852,154.61,317.2,471.81
2024-09-05 20:00:00+08,1,8,9,139335,897092,1036427,25.67,267.09,292.76
2024-09-06 00:00:00+08,1,9,10,139335,1063216,1202551,170.41,244.54,414.95
2024-09-06 04:00:00+08,1,9,10,139335,1015902,1155237,174.41,260.79,435.2
2024-09-06 08:00:00+08,1,11,12,139335,1182171,1321506,178.41,301.61,480.02
2024-09-06 12:00:00+08,1,11,12,139335,1182171,1321506,182.41,345.61,528.02
2024-09-06 16:00:00+08,1,10,11,139335,1065320,1204655,186.41,318.74,505.15
2024-09-06 20:00:00+08,1,11,12,139335,1197355,1336690,190.41,360.49,550.9
2024-09-07 00:00:00+08,0,10,10,0,1111729,1111729,140.76,355.7,496.46
2024-09-07 04:00:00+08,0,11,11,0,1158340,1158340,195.75,286.38,482.13
2024-09-07 08:00:00+08,0,11,11,0,1193538,1193538,195.75,303.33,499.08
2024-09-07 12:00:00+08,0,9,9,0,951422,951422,195.75,242.35,438.1
2024-09-07 16:00:00+08,1,8,9,113072,857870,970942,198.3,244.5,442.8
2024-09-07 20:00:00+08,1,9,10,113072,862031,975103,202.31,235.85,438.16
2024-09-08 00:00:00+08,1,11,12,113072,1112268,1225340,206.33,273.32,479.65
2024-09-08 04:00:00+08,1,9,10,113072,997469,1110541,210.33,246.88,457.21
2024-09-08 08:00:00+08,1,7,8,113072,800913,913985,214.32,170.99,385.31
2024-09-08 12:00:00+08,1,5,6,51733,605483,657216,196.81,138.39,335.2
2024-09-08 16:00:00+08,1,5,6,51733,680260,731993,200.82,139.78,340.6
2024-09-08 20:00:00+08,1,6,7,51733,709696,761429,36.75,53.75,90.5
2024-09-09 00:00:00+08,2,6,8,191068,709696,900764,42.96,77.75,120.71
2024-09-09 04:00:00+08,2,7,9,191068,791466,982534,50.96,102.62,153.58
2024-09-09 08:00:00+08,2,8,10,191068,844918,1035986,58.97,133.73,192.7
2024-09-09 12:00:00+08,2,8,10,191068,888715,1079783,66.96,131.84,198.8
2024-09-09 16:00:00+08,1,7,8,139335,804027,943362,45.89,142.92,188.81
2024-09-09 20:00:00+08,1,8,9,139335,855760,995095,80.79,173.09,253.88
2024-09-10 00:00:00+08,1,8,9,139335,855760,995095,84.79,205.09,289.88
2024-09-10 04:00:00+08,1,9,10,139335,1012836,1152171,88.79,240.79,329.58
2024-09-10 08:00:00+08,1,9,10,139335,1012836,1152171,92.79,276.79,369.58
2024-09-10 12:00:00+08,1,10,11,139335,1047796,1187131,96.79,316.13,412.92
2024-09-10 16:00:00+08,1,8,9,139335,912574,1051909,100.78,284.14,384.92
2024-09-10 20:00:00+08,1,5,6,139335,599142,738477,73.89,185.53,259.42
2024-09-11 00:00:00+08,1,6,7,139335,688859,828194,77.9,119.77,197.67
2024-09-11 04:00:00+08,1,7,8,139335,845161,984496,81.9,145.89,227.79
2024-09-11 08:00:00+08,1,7,8,139335,845161,984496,85.9,173.89,259.79
2024-09-11 12:00:00+08,0,6,6,0,594523,594523,0,75.23,75.23
2024-09-11 16:00:00+08,0,8,8,0,828338,828338,66.15,99.55,165.7
2024-09-11 20:00:00+08,0,12,12,0,1007887,1007887,66.15,140.89,207.04
2024-09-12 00:00:00+08,0,13,13,0,1076465,1076465,66.15,189.83,255.98
2024-09-12 04:00:00+08,0,12,12,0,1039475,1039475,66.15,223.75,289.9
2024-09-12 08:00:00+08,0,10,10,0,967705,967705,66.15,236.13,302.28
2024-09-12 12:00:00+08,0,9,9,0,808644,808644,66.15,202.47,268.62
2024-09-12 16:00:00+08,0,7,7,0,662200,662200,66.16,133.6,199.76
2024-09-12 20:00:00+08,0,8,8,0,714256,714256,66.16,164.72,230.88
2024-09-13 00:00:00+08,0,10,10,0,792396,792396,66.16,199.13,265.29
2024-09-13 04:00:00+08,0,9,9,0,723818,723818,66.16,210.18,276.34
2024-09-13 08:00:00+08,0,11,11,0,798781,798781,66.16,252.29,318.45
2024-09-13 12:00:00+08,0,8,8,0,658491,658491,66.16,182.87,249.03
2024-09-13 16:00:00+08,0,5,5,0,310798,310798,0,81.58,81.58
2024-09-13 20:00:00+08,0,8,8,0,586826,586826,0,94.36,94.36
2024-09-14 00:00:00+08,0,8,8,0,609616,609616,0,108.87,108.87
2024-09-14 04:00:00+08,0,8,8,0,637500,637500,0,113.68,113.68
2024-09-14 08:00:00+08,0,9,9,0,764576,764576,0,148.25,148.25
2024-09-14 12:00:00+08,1,9,10,65364,816553,881917,0.25,168.18,168.43
2024-09-14 16:00:00+08,1,6,7,65364,657067,722431,4.23,127.28,131.51
2024-09-14 20:00:00+08,1,9,10,65364,950035,1015399,8.25,132.42,140.67
2024-09-15 00:00:00+08,1,9,10,65364,950035,1015399,12.25,168.42,180.67
2024-09-15 04:00:00+08,0,10,10,0,1022482,1022482,0,208.12,208.12
2024-09-15 08:00:00+08,0,11,11,0,1142659,1142659,17.28,220.99,238.27
2024-09-15 12:00:00+08,0,11,11,0,1142659,1142659,17.28,264.99,282.27
2024-09-15 16:00:00+08,0,9,9,0,1000064,1000064,17.29,264.25,281.54
2024-09-15 20:00:00+08,0,9,9,0,1022318,1022318,0,286.07,286.07
2024-09-16 00:00:00+08,0,10,10,0,1095683,1095683,0,323.19,323.19
2024-09-16 04:00:00+08,0,9,9,0,968607,968607,0,316.62,316.62
2024-09-16 08:00:00+08,0,8,8,0,854790,854790,0,261.36,261.36
2024-09-16 12:00:00+08,0,8,8,0,920332,920332,0,283.24,283.24
2024-09-16 16:00:00+08,0,8,8,0,944490,944490,0,260.71,260.71
2024-09-16 20:00:00+08,0,11,11,0,1144383,1144383,0,299.14,299.14
2024-09-17 00:00:00+08,2,10,12,228239,1056765,1285004,4.22,314.38,318.6
2024-09-17 04:00:00+08,2,11,13,228239,1210285,1438524,12.19,357.27,369.46
2024-09-17 08:00:00+08,2,14,16,228239,1479461,1707700,20.19,409.25,429.44
2024-09-17 12:00:00+08,2,13,15,228239,1441579,1669818,28.19,447,475.19
2024-09-17 16:00:00+08,2,11,13,228239,1144977,1373216,36.21,346.92,383.13
2024-09-17 20:00:00+08,2,11,13,157635,1108180,1265815,23.71,259.33,283.04
2024-09-18 00:00:00+08,2,11,13,157635,1210293,1367928,53.1,261.83,314.93
2024-09-18 04:00:00+08,2,11,13,157635,1210293,1367928,61.1,305.83,366.93
2024-09-18 08:00:00+08,2,11,13,157635,1134312,1291947,69.1,302.19,371.29
2024-09-18 12:00:00+08,3,11,14,184446,1105120,1289566,78.99,304.05,383.04
2024-09-18 16:00:00+08,3,11,14,184446,1105120,1289566,90.99,348.05,439.04
2024-09-18 20:00:00+08,3,11,14,184446,1067469,1251915,103,260.16,363.16
2024-09-19 00:00:00+08,3,12,15,184446,1170330,1354776,115,305.53,420.53
2024-09-19 04:00:00+08,3,12,15,229213,1170330,1399543,96.77,353.53,450.3
2024-09-19 08:00:00+08,3,11,14,229213,949253,1178466,141.65,303.08,444.73
2024-09-19 12:00:00+08,3,12,15,229213,1048155,1277368,153.65,350.45,504.1
2024-09-19 16:00:00+08,2,10,12,202402,868615,1071017,135.75,313.27,449.02
2024-09-19 20:00:00+08,1,10,11,57830,767127,824957,83.14,214.59,297.73
2024-09-20 00:00:00+08,1,10,11,57830,937000,994830,127.69,95.64,223.33
2024-09-20 04:00:00+08,1,10,11,57830,937000,994830,131.69,135.64,267.33
2024-09-20 08:00:00+08,1,12,13,57830,1117979,1175809,135.63,177.87,313.5
2024-09-20 12:00:00+08,1,12,13,57830,1171442,1229272,107.26,211.59,318.85
2024-09-20 16:00:00+08,1,10,11,57830,1024120,1081950,111.26,191.94,303.2
2024-09-20 20:00:00+08,1,11,12,57830,1091290,1149120,115.27,234.89,350.16
2024-09-21 00:00:00+08,1,11,12,57830,1091290,1149120,119.27,278.89,398.16
2024-09-21 04:00:00+08,1,9,10,57830,958158,1015988,123.27,258.92,382.19
2024-09-21 08:00:00+08,1,9,10,57830,1021864,1079694,127.25,264.41,391.66
2024-09-21 12:00:00+08,1,8,9,57830,890253,948083,131.25,203.36,334.61
2024-09-21 16:00:00+08,0,7,7,0,823083,823083,73.36,212.4,285.76
2024-09-21 20:00:00+08,1,10,11,113889,1005922,1119811,136.11,248.64,384.75
2024-09-22 00:00:00+08,1,11,12,113889,1044209,1158098,140.14,234.92,375.06
2024-09-22 04:00:00+08,1,9,10,113889,912010,1025899,144.12,245.97,390.09
2024-09-22 08:00:00+08,1,10,11,113889,968966,1082855,148.14,240.15,388.29
2024-09-22 12:00:00+08,1,8,9,113889,684248,798137,78.76,157.77,236.53
2024-09-22 16:00:00+08,2,7,9,223889,620848,844737,85.01,166.97,251.98
2024-09-22 20:00:00+08,2,10,12,223889,996027,1219916,93.04,185.54,278.58
2024-09-23 00:00:00+08,2,11,13,223889,1056460,1280349,101,210.39,311.39
2024-09-23 04:00:00+08,2,11,13,223889,1056460,1280349,109,254.39,363.39
2024-09-23 08:00:00+08,2,9,11,223889,1018069,1241958,54.56,200.91,255.47
2024-09-23 12:00:00+08,2,9,11,223889,1018069,1241958,62.56,236.91,299.47
2024-09-23 16:00:00+08,2,7,9,223889,735626,959515,70.58,151.02,221.6
2024-09-23 20:00:00+08,2,7,9,223889,760643,984532,78.58,156.8,235.38
2024-09-24 00:00:00+08,2,7,9,223889,760643,984532,86.58,184.8,271.38
2024-09-24 04:00:00+08,2,8,10,223889,902661,1126550,94.58,213.79,308.37
2024-09-24 08:00:00+08,2,9,11,223889,929635,1153524,102.58,248.14,350.72
2024-09-24 12:00:00+08,2,11,13,223889,1155323,1379212,110.58,289.8,400.38
2024-09-24 16:00:00+08,3,11,14,308594,1155323,1463917,122.19,333.8,455.99
2024-09-24 20:00:00+08,3,9,12,308594,1001273,1309867,134.19,314.07,448.26
2024-09-25 00:00:00+08,0,8,8,0,887587,887587,0,256.95,256.95
2024-09-25 04:00:00+08,0,9,9,0,1018281,1018281,15.46,237.87,253.33
2024-09-25 08:00:00+08,0,11,11,0,1219996,1219996,161.22,198.58,359.8
2024-09-25 12:00:00+08,0,11,11,0,1120949,1120949,161.22,179.15,340.37
2024-09-25 16:00:00+08,0,11,11,0,1120949,1120949,161.22,223.15,384.37
2024-09-25 20:00:00+08,0,13,13,0,1283556,1283556,161.23,215.63,376.86
2024-09-26 00:00:00+08,0,14,14,0,1446082,1446082,161.23,231.67,392.9
2024-09-26 04:00:00+08,1,14,15,65364,1446082,1511446,164.28,287.67,451.95
2024-09-26 08:00:00+08,1,14,15,65364,1446082,1511446,168.28,343.67,511.95
2024-09-26 12:00:00+08,1,12,13,65364,1314612,1379976,108.69,351.41,460.1
2024-09-26 16:00:00+08,1,9,10,65364,1100003,1165367,112.69,306.62,419.31
2024-09-26 20:00:00+08,1,10,11,65364,1233791,1299155,101.22,306.12,407.34
2024-09-27 00:00:00+08,1,11,12,65364,1239652,1305016,105.21,299.31,404.52
2024-09-27 04:00:00+08,1,11,12,65364,1239652,1305016,109.21,343.31,452.52
2024-09-27 08:00:00+08,1,10,11,65364,1125763,1191127,31.05,337.16,368.21
2024-09-27 12:00:00+08,1,8,9,65364,846218,911582,35.05,298.69,333.74
2024-09-27 16:00:00+08,1,8,9,65364,846218,911582,39.05,330.69,369.74
2024-09-27 20:00:00+08,1,12,13,65364,1009647,1075011,43.06,349.01,392.07
2024-09-28 00:00:00+08,1,14,15,65364,1186606,1251970,47.03,400.88,447.91
2024-09-28 04:00:00+08,2,12,14,179253,985504,1164757,54.83,275.1,329.93
2024-09-28 08:00:00+08,2,12,14,179253,991474,1170727,62.83,261.54,324.37
2024-09-28 12:00:00+08,2,10,12,179253,1042466,1221719,70.85,239.52,310.37
2024-09-28 16:00:00+08,1,9,10,113889,918002,1031891,15.83,218.69,234.52
2024-09-28 20:00:00+08,1,12,13,113889,1056026,1169915,86.69,214.3,300.99
2024-09-29 00:00:00+08,1,12,13,113889,1083820,1197709,90.68,233.52,324.2
2024-09-29 04:00:00+08,1,13,14,113889,1102037,1215926,94.68,284.28,378.96
2024-09-29 08:00:00+08,1,12,13,113889,1181454,1295343,98.67,307.6,406.27
2024-09-29 12:00:00+08,1,12,13,113889,1181454,1295343,102.67,355.6,458.27
2024-09-29 16:00:00+08,1,11,12,113889,1019830,1133719,106.67,218.74,325.41
2024-09-29 20:00:00+08,1,9,10,113889,929487,1043376,110.7,186.11,296.81
2024-09-30 00:00:00+08,1,9,10,113889,937923,1051812,47.82,197.79,245.61
2024-09-30 04:00:00+08,1,10,11,113889,1066483,1180372,51.8,237.51,289.31
2024-09-30 08:00:00+08,1,10,11,113889,1066483,1180372,55.8,277.51,333.31
2024-09-30 12:00:00+08,1,8,9,113889,870020,983909,59.8,237.25,297.05
2024-09-30 16:00:00+08,1,8,9,113889,870020,983909,63.8,269.25,333.05
2024-09-30 20:00:00+08,1,9,10,113889,900176,1014065,67.8,303.56,371.36
2024-10-01 00:00:00+08,2,5,7,199326,483719,683045,72.09,141.63,213.72
2024-10-01 04:00:00+08,2,1,3,199326,30156,229482,80.07,10.31,90.38
2024-10-01 08:00:00+08,2,0,2,199326,0,199326,88.07,0,88.07
2024-10-01 12:00:00+08,3,0,3,313235,0,313235,98.18,0,98.18
2024-10-01 16:00:00+08,3,0,3,313235,0,313235,110.18,0,110.18
2024-10-01 20:00:00+08,4,0,4,363572,0,363572,123.53,0,123.53
2024-10-02 00:00:00+08,5,0,5,435159,0,435159,139.96,0,139.96
2024-10-02 04:00:00+08,6,0,6,529942,0,529942,163.92,0,163.92
2024-10-02 08:00:00+08,4,0,4,344446,0,344446,157.38,0,157.38
2024-10-02 12:00:00+08,5,0,5,416033,0,416033,173.85,0,173.85
2024-10-02 16:00:00+08,5,0,5,416033,0,416033,193.85,0,193.85
2024-10-02 20:00:00+08,6,0,6,457012,0,457012,213.95,0,213.95
2024-10-03 00:00:00+08,7,0,7,483032,0,483032,252.45,0,252.45
2024-10-03 04:00:00+08,7,0,7,483032,0,483032,280.45,0,280.45
2024-10-03 08:00:00+08,7,0,7,483032,0,483032,308.45,0,308.45
2024-10-03 12:00:00+08,7,0,7,603603,0,603603,323.8,0,323.8
2024-10-03 16:00:00+08,8,0,8,629623,0,629623,354.34,0,354.34
2024-10-03 20:00:00+08,9,0,9,773683,0,773683,388.47,0,388.47
2024-10-04 00:00:00+08,9,0,9,773683,0,773683,424.47,0,424.47
2024-10-04 04:00:00+08,9,0,9,773683,0,773683,460.47,0,460.47
2024-10-04 08:00:00+08,10,0,10,780567,0,780567,498.02,0,498.02
2024-10-04 12:00:00+08,10,0,10,780567,0,780567,538.02,0,538.02
2024-10-04 16:00:00+08,11,0,11,926613,0,926613,579.28,0,579.28
2024-10-04 20:00:00+08,9,0,9,762387,0,762387,386.12,0,386.12
2024-10-05 00:00:00+08,8,1,9,712450,138907,851357,369.58,0.24,369.82
2024-10-05 04:00:00+08,6,4,10,576688,342719,919407,408.38,10.18,418.56
2024-10-05 08:00:00+08,7,8,15,715299,687139,1402438,743.57,36.8,780.37
2024-10-05 12:00:00+08,6,9,15,643712,827748,1471460,687.21,71.16,758.37
2024-10-05 16:00:00+08,5,9,14,558275,827748,1386023,598.96,107.16,706.12
2024-10-05 20:00:00+08,5,11,16,558275,1057702,1615977,869.66,135.16,1004.82
2024-10-06 00:00:00+08,5,11,16,558275,1057702,1615977,905.64,179.16,1084.8
2024-10-06 04:00:00+08,6,10,16,600357,962919,1563276,849.38,200.69,1050.07
2024-10-06 08:00:00+08,7,11,18,730930,1048679,1779609,875.18,243.4,1118.58
2024-10-06 12:00:00+08,7,10,17,730930,953910,1684840,903.19,257.27,1160.46
2024-10-06 16:00:00+08,7,9,16,730930,882323,1613253,842.16,273.88,1116.04
2024-10-06 20:00:00+08,6,8,14,586870,810315,1397185,717.99,224.38,942.37
2024-10-07 00:00:00+08,5,8,13,448259,833305,1281564,594.08,226.86,820.94
2024-10-07 04:00:00+08,6,8,14,586870,743884,1330754,441.73,215.76,657.49
2024-10-07 08:00:00+08,6,8,14,586870,741353,1328223,507.03,198.74,705.77
2024-10-07 12:00:00+08,6,6,12,586870,576276,1163146,530.99,168.63,699.62
2024-10-07 16:00:00+08,5,5,10,544788,490839,1035627,403.25,146.89,550.14
2024-10-07 20:00:00+08,4,8,12,414215,666475,1080690,424.55,173.43,597.98
2024-10-08 00:00:00+08,3,9,12,268169,797048,1065217,400.47,206.11,606.58
2024-10-08 04:00:00+08,3,9,12,268169,857334,1125503,495.11,198.03,693.14
2024-10-08 08:00:00+08,3,10,13,268169,956400,1224569,507.11,235.05,742.16
2024-10-08 12:00:00+08,4,7,11,347976,743630,1091606,482.1,197.01,679.11
2024-10-08 16:00:00+08,3,7,10,321956,743630,1065586,359.57,225.01,584.58
2024-10-08 20:00:00+08,3,9,12,321956,792027,1113983,511.99,215.43,727.42
2024-10-09 00:00:00+08,3,10,13,321956,844083,1166039,523.97,254.86,778.83
2024-10-09 04:00:00+08,3,10,13,321956,815724,1137680,535.97,261.65,797.62
2024-10-09 08:00:00+08,3,9,12,321956,685151,1007107,506.83,268.97,775.8
2024-10-09 12:00:00+08,3,9,12,321956,575253,897209,435.77,253.66,689.43
2024-10-09 16:00:00+08,3,7,10,321956,438426,760382,447.77,247.17,694.94
2024-10-09 20:00:00+08,2,7,9,218418,448269,666687,200.48,229.38,429.86
2024-10-10 00:00:00+08,1,8,9,79807,551807,631614,261.58,258.58,520.16
2024-10-10 04:00:00+08,1,9,10,79807,800250,880057,265.59,272.54,538.13
2024-10-10 08:00:00+08,2,9,11,218418,772475,990893,270.79,262.65,533.44